Model,Date,Forecast_CY,Forecast_NCY,State,Country,Forecast,cumForecast
OUTLANDER 1000,2019-01-07,8,3,AL,US,11,11
OUTLANDER 850,2019-01-07,12,5,AL,US,17,17
OUTLANDER 450,2019-01-07,13,4,AL,US,17,17
OUTLANDER 1000,2019-01-14,4,12,AL,US,16,27
OUTLANDER 850,2019-01-14,7,4,AL,US,11,28
OUTLANDER 450,2019-01-14,10,9,AL,US,19,36
OUTLANDER 1000,2019-01-21,4,0,AL,US,4,31
OUTLANDER 850,2019-01-21,4,9,AL,US,13,41
OUTLANDER 450,2019-01-21,3,14,AL,US,17,53
OUTLANDER 1000,2019-01-28,12,11,AL,US,23,54
OUTLANDER 850,2019-01-28,12,4,AL,US,16,57
OUTLANDER 450,2019-01-28,9,15,AL,US,24,77
OUTLANDER 1000,2019-02-04,0,5,AL,US,5,59
OUTLANDER 850,2019-02-04,5,1,AL,US,6,63
OUTLANDER 450,2019-02-04,7,4,AL,US,11,88
OUTLANDER 1000,2019-02-11,8,3,AL,US,11,70
OUTLANDER 850,2019-02-11,3,6,AL,US,9,72
OUTLANDER 450,2019-02-11,13,15,AL,US,28,116
OUTLANDER 1000,2019-02-18,11,14,AL,US,25,95
OUTLANDER 850,2019-02-18,2,6,AL,US,8,80
OUTLANDER 450,2019-02-18,14,5,AL,US,19,135
OUTLANDER 1000,2019-02-25,11,4,AL,US,15,110
OUTLANDER 850,2019-02-25,8,8,AL,US,16,96
OUTLANDER 450,2019-02-25,5,9,AL,US,14,149
OUTLANDER 1000,2019-03-04,7,13,AL,US,20,130
OUTLANDER 850,2019-03-04,12,15,AL,US,27,123
OUTLANDER 450,2019-03-04,15,1,AL,US,16,165
OUTLANDER 1000,2019-03-11,5,14,AL,US,19,149
OUTLANDER 850,2019-03-11,2,14,AL,US,16,139
OUTLANDER 450,2019-03-11,7,5,AL,US,12,177
OUTLANDER 1000,2019-03-18,6,4,AL,US,10,159
OUTLANDER 850,2019-03-18,15,0,AL,US,15,154
OUTLANDER 450,2019-03-18,6,6,AL,US,12,189
OUTLANDER 1000,2019-03-25,9,5,AL,US,14,173
OUTLANDER 850,2019-03-25,4,8,AL,US,12,166
OUTLANDER 450,2019-03-25,14,11,AL,US,25,214
OUTLANDER 1000,2019-04-01,13,6,AL,US,19,192
OUTLANDER 850,2019-04-01,14,12,AL,US,26,192
OUTLANDER 450,2019-04-01,10,1,AL,US,11,225
OUTLANDER 1000,2019-04-08,0,14,AL,US,14,206
OUTLANDER 850,2019-04-08,13,1,AL,US,14,206
OUTLANDER 450,2019-04-08,5,5,AL,US,10,235
OUTLANDER 1000,2019-04-15,9,3,AL,US,12,218
OUTLANDER 850,2019-04-15,6,11,AL,US,17,223
OUTLANDER 450,2019-04-15,10,12,AL,US,22,257
OUTLANDER 1000,2019-04-22,12,4,AL,US,16,234
OUTLANDER 850,2019-04-22,3,9,AL,US,12,235
OUTLANDER 450,2019-04-22,10,5,AL,US,15,272
OUTLANDER 1000,2019-04-29,15,3,AL,US,18,252
OUTLANDER 850,2019-04-29,0,10,AL,US,10,245
OUTLANDER 450,2019-04-29,0,6,AL,US,6,278
OUTLANDER 1000,2019-05-06,1,0,AL,US,1,253
OUTLANDER 850,2019-05-06,11,8,AL,US,19,264
OUTLANDER 450,2019-05-06,2,15,AL,US,17,295
OUTLANDER 1000,2019-05-13,7,13,AL,US,20,273
OUTLANDER 850,2019-05-13,0,1,AL,US,1,265
OUTLANDER 450,2019-05-13,4,7,AL,US,11,306
OUTLANDER 1000,2019-05-20,4,14,AL,US,18,291
OUTLANDER 850,2019-05-20,7,6,AL,US,13,278
OUTLANDER 450,2019-05-20,14,13,AL,US,27,333
OUTLANDER 1000,2019-05-27,6,1,AL,US,7,298
OUTLANDER 850,2019-05-27,12,10,AL,US,22,300
OUTLANDER 450,2019-05-27,9,11,AL,US,20,353
OUTLANDER 1000,2019-06-03,9,13,AL,US,22,320
OUTLANDER 850,2019-06-03,4,8,AL,US,12,312
OUTLANDER 450,2019-06-03,6,3,AL,US,9,362
OUTLANDER 1000,2019-06-10,7,1,AL,US,8,328
OUTLANDER 850,2019-06-10,15,7,AL,US,22,334
OUTLANDER 450,2019-06-10,13,2,AL,US,15,377
OUTLANDER 1000,2019-06-17,10,9,AL,US,19,347
OUTLANDER 850,2019-06-17,9,5,AL,US,14,348
OUTLANDER 450,2019-06-17,6,5,AL,US,11,388
OUTLANDER 1000,2019-06-24,12,2,AL,US,14,361
OUTLANDER 850,2019-06-24,13,7,AL,US,20,368
OUTLANDER 450,2019-06-24,7,12,AL,US,19,407
OUTLANDER 1000,2019-07-01,13,4,AL,US,17,378
OUTLANDER 850,2019-07-01,11,1,AL,US,12,380
OUTLANDER 450,2019-07-01,14,13,AL,US,27,434
OUTLANDER 1000,2019-07-08,5,11,AL,US,16,394
OUTLANDER 850,2019-07-08,7,10,AL,US,17,397
OUTLANDER 450,2019-07-08,6,8,AL,US,14,448
OUTLANDER 1000,2019-07-15,10,12,AL,US,22,416
OUTLANDER 850,2019-07-15,7,11,AL,US,18,415
OUTLANDER 450,2019-07-15,14,12,AL,US,26,474
OUTLANDER 1000,2019-07-22,13,6,AL,US,19,435
OUTLANDER 850,2019-07-22,10,2,AL,US,12,427
OUTLANDER 450,2019-07-22,2,5,AL,US,7,481
OUTLANDER 1000,2019-07-29,13,2,AL,US,15,450
OUTLANDER 850,2019-07-29,5,13,AL,US,18,445
OUTLANDER 450,2019-07-29,11,14,AL,US,25,506
OUTLANDER 1000,2019-08-05,4,0,AL,US,4,454
OUTLANDER 850,2019-08-05,12,8,AL,US,20,465
OUTLANDER 450,2019-08-05,1,0,AL,US,1,507
OUTLANDER 1000,2019-08-12,14,8,AL,US,22,476
OUTLANDER 850,2019-08-12,10,14,AL,US,24,489
OUTLANDER 450,2019-08-12,3,9,AL,US,12,519
OUTLANDER 1000,2019-08-19,15,7,AL,US,22,498
OUTLANDER 850,2019-08-19,5,14,AL,US,19,508
OUTLANDER 450,2019-08-19,3,4,AL,US,7,526
OUTLANDER 1000,2019-08-26,8,2,AL,US,10,508
OUTLANDER 850,2019-08-26,3,9,AL,US,12,520
OUTLANDER 450,2019-08-26,6,10,AL,US,16,542
OUTLANDER 1000,2019-09-02,3,12,AL,US,15,523
OUTLANDER 850,2019-09-02,12,9,AL,US,21,541
OUTLANDER 450,2019-09-02,1,10,AL,US,11,553
OUTLANDER 1000,2019-09-09,3,1,AL,US,4,527
OUTLANDER 850,2019-09-09,1,4,AL,US,5,546
OUTLANDER 450,2019-09-09,12,8,AL,US,20,573
OUTLANDER 1000,2019-09-16,10,5,AL,US,15,542
OUTLANDER 850,2019-09-16,9,13,AL,US,22,568
OUTLANDER 450,2019-09-16,13,11,AL,US,24,597
OUTLANDER 1000,2019-09-23,12,0,AL,US,12,554
OUTLANDER 850,2019-09-23,6,0,AL,US,6,574
OUTLANDER 450,2019-09-23,7,12,AL,US,19,616
OUTLANDER 1000,2019-09-30,2,12,AL,US,14,568
OUTLANDER 850,2019-09-30,14,9,AL,US,23,597
OUTLANDER 450,2019-09-30,12,4,AL,US,16,632
OUTLANDER 1000,2019-10-07,8,2,AL,US,10,578
OUTLANDER 850,2019-10-07,15,6,AL,US,21,618
OUTLANDER 450,2019-10-07,12,3,AL,US,15,647
OUTLANDER 1000,2019-10-14,11,5,AL,US,16,594
OUTLANDER 850,2019-10-14,4,1,AL,US,5,623
OUTLANDER 450,2019-10-14,8,7,AL,US,15,662
OUTLANDER 1000,2019-10-21,13,13,AL,US,26,620
OUTLANDER 850,2019-10-21,8,10,AL,US,18,641
OUTLANDER 450,2019-10-21,11,0,AL,US,11,673
OUTLANDER 1000,2019-10-28,13,9,AL,US,22,642
OUTLANDER 850,2019-10-28,7,2,AL,US,9,650
OUTLANDER 450,2019-10-28,2,10,AL,US,12,685
OUTLANDER 1000,2019-11-04,10,2,AL,US,12,654
OUTLANDER 850,2019-11-04,3,1,AL,US,4,654
OUTLANDER 450,2019-11-04,2,7,AL,US,9,694
OUTLANDER 1000,2019-11-11,10,12,AL,US,22,676
OUTLANDER 850,2019-11-11,7,8,AL,US,15,669
OUTLANDER 450,2019-11-11,1,0,AL,US,1,695
OUTLANDER 1000,2019-11-18,12,12,AL,US,24,700
OUTLANDER 850,2019-11-18,2,12,AL,US,14,683
OUTLANDER 450,2019-11-18,1,12,AL,US,13,708
OUTLANDER 1000,2019-11-25,2,4,AL,US,6,706
OUTLANDER 850,2019-11-25,12,10,AL,US,22,705
OUTLANDER 450,2019-11-25,6,15,AL,US,21,729
OUTLANDER 1000,2019-12-02,6,5,AL,US,11,717
OUTLANDER 850,2019-12-02,4,10,AL,US,14,719
OUTLANDER 450,2019-12-02,13,3,AL,US,16,745
OUTLANDER 1000,2019-12-09,11,4,AL,US,15,732
OUTLANDER 850,2019-12-09,2,1,AL,US,3,722
OUTLANDER 450,2019-12-09,12,3,AL,US,15,760
OUTLANDER 1000,2019-12-16,10,9,AL,US,19,751
OUTLANDER 850,2019-12-16,1,8,AL,US,9,731
OUTLANDER 450,2019-12-16,8,10,AL,US,18,778
OUTLANDER 1000,2019-12-23,4,12,AL,US,16,767
OUTLANDER 850,2019-12-23,8,6,AL,US,14,745
OUTLANDER 450,2019-12-23,12,0,AL,US,12,790
OUTLANDER 1000,2019-12-30,9,6,AL,US,15,782
OUTLANDER 850,2019-12-30,10,12,AL,US,22,767
OUTLANDER 450,2019-12-30,11,8,AL,US,19,809
OUTLANDER 1000,2020-01-06,1,10,AL,US,11,793
OUTLANDER 850,2020-01-06,3,3,AL,US,6,773
OUTLANDER 450,2020-01-06,0,7,AL,US,7,816
OUTLANDER 1000,2020-01-13,9,2,AL,US,11,804
OUTLANDER 850,2020-01-13,3,10,AL,US,13,786
OUTLANDER 450,2020-01-13,0,6,AL,US,6,822
OUTLANDER 1000,2020-01-20,4,14,AL,US,18,822
OUTLANDER 850,2020-01-20,8,10,AL,US,18,804
OUTLANDER 450,2020-01-20,14,8,AL,US,22,844
OUTLANDER 1000,2020-01-27,5,7,AL,US,12,834
OUTLANDER 850,2020-01-27,10,6,AL,US,16,820
OUTLANDER 450,2020-01-27,6,15,AL,US,21,865
OUTLANDER 1000,2020-02-03,1,7,AL,US,8,842
OUTLANDER 850,2020-02-03,11,14,AL,US,25,845
OUTLANDER 450,2020-02-03,13,13,AL,US,26,891
OUTLANDER 1000,2020-02-10,13,10,AL,US,23,865
OUTLANDER 850,2020-02-10,10,11,AL,US,21,866
OUTLANDER 450,2020-02-10,7,9,AL,US,16,907
OUTLANDER 1000,2020-02-17,14,1,AL,US,15,880
OUTLANDER 850,2020-02-17,8,6,AL,US,14,880
OUTLANDER 450,2020-02-17,4,8,AL,US,12,919
OUTLANDER 1000,2020-02-24,9,12,AL,US,21,901
OUTLANDER 850,2020-02-24,12,6,AL,US,18,898
OUTLANDER 450,2020-02-24,14,8,AL,US,22,941
OUTLANDER 1000,2020-03-02,7,9,AL,US,16,917
OUTLANDER 850,2020-03-02,12,11,AL,US,23,921
OUTLANDER 450,2020-03-02,11,9,AL,US,20,961
OUTLANDER 1000,2020-03-09,9,3,AL,US,12,929
OUTLANDER 850,2020-03-09,7,1,AL,US,8,929
OUTLANDER 450,2020-03-09,3,3,AL,US,6,967
OUTLANDER 1000,2020-03-16,7,8,AL,US,15,944
OUTLANDER 850,2020-03-16,9,14,AL,US,23,952
OUTLANDER 450,2020-03-16,12,8,AL,US,20,987
OUTLANDER 1000,2020-03-23,11,12,AL,US,23,967
OUTLANDER 850,2020-03-23,14,2,AL,US,16,968
OUTLANDER 450,2020-03-23,3,13,AL,US,16,1003
OUTLANDER 1000,2020-03-30,7,6,AL,US,13,980
OUTLANDER 850,2020-03-30,6,3,AL,US,9,977
OUTLANDER 450,2020-03-30,6,7,AL,US,13,1016
OUTLANDER 1000,2020-04-06,8,4,AL,US,12,992
OUTLANDER 850,2020-04-06,8,10,AL,US,18,995
OUTLANDER 450,2020-04-06,12,12,AL,US,24,1040
OUTLANDER 1000,2020-04-13,13,6,AL,US,19,1011
OUTLANDER 850,2020-04-13,15,5,AL,US,20,1015
OUTLANDER 450,2020-04-13,2,9,AL,US,11,1051
OUTLANDER 1000,2020-04-20,7,0,AL,US,7,1018
OUTLANDER 850,2020-04-20,4,0,AL,US,4,1019
OUTLANDER 450,2020-04-20,5,14,AL,US,19,1070
OUTLANDER 1000,2020-04-27,12,2,AL,US,14,1032
OUTLANDER 850,2020-04-27,5,14,AL,US,19,1038
OUTLANDER 450,2020-04-27,2,2,AL,US,4,1074
OUTLANDER 1000,2020-05-04,10,3,AL,US,13,1045
OUTLANDER 850,2020-05-04,14,8,AL,US,22,1060
OUTLANDER 450,2020-05-04,0,2,AL,US,2,1076
OUTLANDER 1000,2020-05-11,1,12,AL,US,13,1058
OUTLANDER 850,2020-05-11,14,2,AL,US,16,1076
OUTLANDER 450,2020-05-11,4,8,AL,US,12,1088
OUTLANDER 1000,2020-05-18,7,4,AL,US,11,1069
OUTLANDER 850,2020-05-18,3,1,AL,US,4,1080
OUTLANDER 450,2020-05-18,11,13,AL,US,24,1112
OUTLANDER 1000,2020-05-25,13,0,AL,US,13,1082
OUTLANDER 850,2020-05-25,14,7,AL,US,21,1101
OUTLANDER 450,2020-05-25,8,2,AL,US,10,1122
OUTLANDER 1000,2020-06-01,10,9,AL,US,19,1101
OUTLANDER 850,2020-06-01,0,0,AL,US,0,1101
OUTLANDER 450,2020-06-01,2,4,AL,US,6,1128
OUTLANDER 1000,2020-06-08,5,11,AL,US,16,1117
OUTLANDER 850,2020-06-08,3,13,AL,US,16,1117
OUTLANDER 450,2020-06-08,13,9,AL,US,22,1150
OUTLANDER 1000,2020-06-15,8,15,AL,US,23,1140
OUTLANDER 850,2020-06-15,7,7,AL,US,14,1131
OUTLANDER 450,2020-06-15,15,8,AL,US,23,1173
OUTLANDER 1000,2020-06-22,15,14,AL,US,29,1169
OUTLANDER 850,2020-06-22,1,0,AL,US,1,1132
OUTLANDER 450,2020-06-22,5,6,AL,US,11,1184
OUTLANDER 1000,2020-06-29,12,14,AL,US,26,1195
OUTLANDER 850,2020-06-29,5,9,AL,US,14,1146
OUTLANDER 450,2020-06-29,9,8,AL,US,17,1201
OUTLANDER 1000,2020-07-06,14,3,AL,US,17,1212
OUTLANDER 850,2020-07-06,9,10,AL,US,19,1165
OUTLANDER 450,2020-07-06,12,3,AL,US,15,1216
OUTLANDER 1000,2020-07-13,14,5,AL,US,19,1231
OUTLANDER 850,2020-07-13,10,6,AL,US,16,1181
OUTLANDER 450,2020-07-13,14,2,AL,US,16,1232
OUTLANDER 1000,2020-07-20,12,3,AL,US,15,1246
OUTLANDER 850,2020-07-20,5,8,AL,US,13,1194
OUTLANDER 450,2020-07-20,6,11,AL,US,17,1249
OUTLANDER 1000,2020-07-27,7,7,AL,US,14,1260
OUTLANDER 850,2020-07-27,1,13,AL,US,14,1208
OUTLANDER 450,2020-07-27,13,9,AL,US,22,1271
OUTLANDER 1000,2020-08-03,10,7,AL,US,17,1277
OUTLANDER 850,2020-08-03,1,1,AL,US,2,1210
OUTLANDER 450,2020-08-03,4,4,AL,US,8,1279
OUTLANDER 1000,2020-08-10,1,13,AL,US,14,1291
OUTLANDER 850,2020-08-10,2,0,AL,US,2,1212
OUTLANDER 450,2020-08-10,9,15,AL,US,24,1303
OUTLANDER 1000,2020-08-17,15,1,AL,US,16,1307
OUTLANDER 850,2020-08-17,11,3,AL,US,14,1226
OUTLANDER 450,2020-08-17,9,7,AL,US,16,1319
OUTLANDER 1000,2020-08-24,13,6,AL,US,19,1326
OUTLANDER 850,2020-08-24,3,3,AL,US,6,1232
OUTLANDER 450,2020-08-24,1,8,AL,US,9,1328
OUTLANDER 1000,2020-08-31,7,4,AL,US,11,1337
OUTLANDER 850,2020-08-31,4,7,AL,US,11,1243
OUTLANDER 450,2020-08-31,2,10,AL,US,12,1340
OUTLANDER 1000,2020-09-07,2,11,AL,US,13,1350
OUTLANDER 850,2020-09-07,2,10,AL,US,12,1255
OUTLANDER 450,2020-09-07,6,12,AL,US,18,1358
OUTLANDER 1000,2020-09-14,7,2,AL,US,9,1359
OUTLANDER 850,2020-09-14,12,1,AL,US,13,1268
OUTLANDER 450,2020-09-14,7,12,AL,US,19,1377
OUTLANDER 1000,2020-09-21,11,3,AL,US,14,1373
OUTLANDER 850,2020-09-21,1,3,AL,US,4,1272
OUTLANDER 450,2020-09-21,15,5,AL,US,20,1397
OUTLANDER 1000,2020-09-28,9,13,AL,US,22,1395
OUTLANDER 850,2020-09-28,6,0,AL,US,6,1278
OUTLANDER 450,2020-09-28,8,2,AL,US,10,1407
OUTLANDER 1000,2020-10-05,8,15,AL,US,23,1418
OUTLANDER 850,2020-10-05,12,12,AL,US,24,1302
OUTLANDER 450,2020-10-05,6,9,AL,US,15,1422
OUTLANDER 1000,2020-10-12,3,3,AL,US,6,1424
OUTLANDER 850,2020-10-12,12,13,AL,US,25,1327
OUTLANDER 450,2020-10-12,9,4,AL,US,13,1435
OUTLANDER 1000,2020-10-19,14,5,AL,US,19,1443
OUTLANDER 850,2020-10-19,4,11,AL,US,15,1342
OUTLANDER 450,2020-10-19,4,14,AL,US,18,1453
OUTLANDER 1000,2020-10-26,15,10,AL,US,25,1468
OUTLANDER 850,2020-10-26,3,14,AL,US,17,1359
OUTLANDER 450,2020-10-26,7,5,AL,US,12,1465
OUTLANDER 1000,2020-11-02,9,8,AL,US,17,1485
OUTLANDER 850,2020-11-02,10,10,AL,US,20,1379
OUTLANDER 450,2020-11-02,6,8,AL,US,14,1479
OUTLANDER 1000,2020-11-09,14,15,AL,US,29,1514
OUTLANDER 850,2020-11-09,1,12,AL,US,13,1392
OUTLANDER 450,2020-11-09,7,11,AL,US,18,1497
OUTLANDER 1000,2020-11-16,3,15,AL,US,18,1532
OUTLANDER 850,2020-11-16,8,5,AL,US,13,1405
OUTLANDER 450,2020-11-16,10,1,AL,US,11,1508
OUTLANDER 1000,2020-11-23,11,3,AL,US,14,1546
OUTLANDER 850,2020-11-23,13,10,AL,US,23,1428
OUTLANDER 450,2020-11-23,2,14,AL,US,16,1524
OUTLANDER 1000,2020-11-30,0,4,AL,US,4,1550
OUTLANDER 850,2020-11-30,6,5,AL,US,11,1439
OUTLANDER 450,2020-11-30,6,7,AL,US,13,1537
OUTLANDER 1000,2020-12-07,14,0,AL,US,14,1564
OUTLANDER 850,2020-12-07,12,14,AL,US,26,1465
OUTLANDER 450,2020-12-07,6,10,AL,US,16,1553
OUTLANDER 1000,2020-12-14,0,3,AL,US,3,1567
OUTLANDER 850,2020-12-14,13,7,AL,US,20,1485
OUTLANDER 450,2020-12-14,14,15,AL,US,29,1582
OUTLANDER 1000,2020-12-21,10,5,AL,US,15,1582
OUTLANDER 850,2020-12-21,9,10,AL,US,19,1504
OUTLANDER 450,2020-12-21,3,9,AL,US,12,1594
OUTLANDER 1000,2020-12-28,5,13,AL,US,18,1600
OUTLANDER 850,2020-12-28,8,7,AL,US,15,1519
OUTLANDER 450,2020-12-28,1,5,AL,US,6,1600
OUTLANDER 1000,2021-01-04,5,9,AL,US,14,1614
OUTLANDER 850,2021-01-04,5,3,AL,US,8,1527
OUTLANDER 450,2021-01-04,4,10,AL,US,14,1614
OUTLANDER 1000,2021-01-11,2,14,AL,US,16,1630
OUTLANDER 850,2021-01-11,7,5,AL,US,12,1539
OUTLANDER 450,2021-01-11,5,9,AL,US,14,1628
OUTLANDER 1000,2021-01-18,2,5,AL,US,7,1637
OUTLANDER 850,2021-01-18,9,15,AL,US,24,1563
OUTLANDER 450,2021-01-18,5,12,AL,US,17,1645
OUTLANDER 1000,2021-01-25,3,0,AL,US,3,1640
OUTLANDER 850,2021-01-25,7,5,AL,US,12,1575
OUTLANDER 450,2021-01-25,3,9,AL,US,12,1657
OUTLANDER 1000,2021-02-01,14,10,AL,US,24,1664
OUTLANDER 850,2021-02-01,13,11,AL,US,24,1599
OUTLANDER 450,2021-02-01,6,4,AL,US,10,1667
OUTLANDER 1000,2021-02-08,4,5,AL,US,9,1673
OUTLANDER 850,2021-02-08,3,9,AL,US,12,1611
OUTLANDER 450,2021-02-08,7,2,AL,US,9,1676
OUTLANDER 1000,2021-02-15,7,5,AL,US,12,1685
OUTLANDER 850,2021-02-15,4,1,AL,US,5,1616
OUTLANDER 450,2021-02-15,4,13,AL,US,17,1693
OUTLANDER 1000,2021-02-22,14,2,AL,US,16,1701
OUTLANDER 850,2021-02-22,13,8,AL,US,21,1637
OUTLANDER 450,2021-02-22,1,10,AL,US,11,1704
OUTLANDER 1000,2021-03-01,9,3,AL,US,12,1713
OUTLANDER 850,2021-03-01,5,11,AL,US,16,1653
OUTLANDER 450,2021-03-01,5,12,AL,US,17,1721
OUTLANDER 1000,2021-03-08,1,1,AL,US,2,1715
OUTLANDER 850,2021-03-08,6,1,AL,US,7,1660
OUTLANDER 450,2021-03-08,5,5,AL,US,10,1731
OUTLANDER 1000,2021-03-15,15,6,AL,US,21,1736
OUTLANDER 850,2021-03-15,6,13,AL,US,19,1679
OUTLANDER 450,2021-03-15,8,12,AL,US,20,1751
OUTLANDER 1000,2021-03-22,8,14,AL,US,22,1758
OUTLANDER 850,2021-03-22,2,0,AL,US,2,1681
OUTLANDER 450,2021-03-22,9,6,AL,US,15,1766
OUTLANDER 1000,2021-03-29,13,1,AL,US,14,1772
OUTLANDER 850,2021-03-29,14,14,AL,US,28,1709
OUTLANDER 450,2021-03-29,14,6,AL,US,20,1786
OUTLANDER 1000,2021-04-05,0,14,AL,US,14,1786
OUTLANDER 850,2021-04-05,2,6,AL,US,8,1717
OUTLANDER 450,2021-04-05,2,3,AL,US,5,1791
OUTLANDER 1000,2021-04-12,3,2,AL,US,5,1791
OUTLANDER 850,2021-04-12,8,4,AL,US,12,1729
OUTLANDER 450,2021-04-12,6,2,AL,US,8,1799
OUTLANDER 1000,2021-04-19,14,14,AL,US,28,1819
OUTLANDER 850,2021-04-19,10,13,AL,US,23,1752
OUTLANDER 450,2021-04-19,11,12,AL,US,23,1822
OUTLANDER 1000,2021-04-26,11,5,AL,US,16,1835
OUTLANDER 850,2021-04-26,2,13,AL,US,15,1767
OUTLANDER 450,2021-04-26,15,12,AL,US,27,1849
OUTLANDER 1000,2021-05-03,15,14,AL,US,29,1864
OUTLANDER 850,2021-05-03,0,0,AL,US,0,1767
OUTLANDER 450,2021-05-03,3,12,AL,US,15,1864
OUTLANDER 1000,2021-05-10,14,2,AL,US,16,1880
OUTLANDER 850,2021-05-10,11,15,AL,US,26,1793
OUTLANDER 450,2021-05-10,1,8,AL,US,9,1873
OUTLANDER 1000,2021-05-17,1,12,AL,US,13,1893
OUTLANDER 850,2021-05-17,3,1,AL,US,4,1797
OUTLANDER 450,2021-05-17,12,4,AL,US,16,1889
OUTLANDER 1000,2021-05-24,9,10,AL,US,19,1912
OUTLANDER 850,2021-05-24,9,5,AL,US,14,1811
OUTLANDER 450,2021-05-24,13,7,AL,US,20,1909
OUTLANDER 1000,2021-05-31,4,1,AL,US,5,1917
OUTLANDER 850,2021-05-31,1,15,AL,US,16,1827
OUTLANDER 450,2021-05-31,5,4,AL,US,9,1918
OUTLANDER 1000,2021-06-07,4,12,AL,US,16,1933
OUTLANDER 850,2021-06-07,10,4,AL,US,14,1841
OUTLANDER 450,2021-06-07,13,1,AL,US,14,1932
OUTLANDER 1000,2021-06-14,11,1,AL,US,12,1945
OUTLANDER 850,2021-06-14,6,4,AL,US,10,1851
OUTLANDER 450,2021-06-14,11,4,AL,US,15,1947
OUTLANDER 1000,2021-06-21,15,9,AL,US,24,1969
OUTLANDER 850,2021-06-21,5,0,AL,US,5,1856
OUTLANDER 450,2021-06-21,2,12,AL,US,14,1961
OUTLANDER 1000,2021-06-28,8,15,AL,US,23,1992
OUTLANDER 850,2021-06-28,1,9,AL,US,10,1866
OUTLANDER 450,2021-06-28,2,12,AL,US,14,1975
OUTLANDER 1000,2021-07-05,13,11,AL,US,24,2016
OUTLANDER 850,2021-07-05,2,8,AL,US,10,1876
OUTLANDER 450,2021-07-05,4,1,AL,US,5,1980
OUTLANDER 1000,2021-07-12,10,14,AL,US,24,2040
OUTLANDER 850,2021-07-12,7,8,AL,US,15,1891
OUTLANDER 450,2021-07-12,5,3,AL,US,8,1988
OUTLANDER 1000,2021-07-19,7,1,AL,US,8,2048
OUTLANDER 850,2021-07-19,2,12,AL,US,14,1905
OUTLANDER 450,2021-07-19,4,12,AL,US,16,2004
OUTLANDER 1000,2021-07-26,7,0,AL,US,7,2055
OUTLANDER 850,2021-07-26,4,9,AL,US,13,1918
OUTLANDER 450,2021-07-26,4,13,AL,US,17,2021
OUTLANDER 1000,2021-08-02,1,15,AL,US,16,2071
OUTLANDER 850,2021-08-02,11,8,AL,US,19,1937
OUTLANDER 450,2021-08-02,9,7,AL,US,16,2037
OUTLANDER 1000,2021-08-09,12,6,AL,US,18,2089
OUTLANDER 850,2021-08-09,11,13,AL,US,24,1961
OUTLANDER 450,2021-08-09,14,8,AL,US,22,2059
OUTLANDER 1000,2021-08-16,13,3,AL,US,16,2105
OUTLANDER 850,2021-08-16,8,9,AL,US,17,1978
OUTLANDER 450,2021-08-16,10,14,AL,US,24,2083
OUTLANDER 1000,2021-08-23,10,9,AL,US,19,2124
OUTLANDER 850,2021-08-23,6,0,AL,US,6,1984
OUTLANDER 450,2021-08-23,12,6,AL,US,18,2101
OUTLANDER 1000,2021-08-30,9,5,AL,US,14,2138
OUTLANDER 850,2021-08-30,2,2,AL,US,4,1988
OUTLANDER 450,2021-08-30,10,7,AL,US,17,2118
OUTLANDER 1000,2021-09-06,2,6,AL,US,8,2146
OUTLANDER 850,2021-09-06,1,3,AL,US,4,1992
OUTLANDER 450,2021-09-06,6,9,AL,US,15,2133
OUTLANDER 1000,2021-09-13,13,11,AL,US,24,2170
OUTLANDER 850,2021-09-13,10,10,AL,US,20,2012
OUTLANDER 450,2021-09-13,2,9,AL,US,11,2144
OUTLANDER 1000,2021-09-20,10,2,AL,US,12,2182
OUTLANDER 850,2021-09-20,5,12,AL,US,17,2029
OUTLANDER 450,2021-09-20,1,3,AL,US,4,2148
OUTLANDER 1000,2021-09-27,0,12,AL,US,12,2194
OUTLANDER 850,2021-09-27,0,14,AL,US,14,2043
OUTLANDER 450,2021-09-27,15,1,AL,US,16,2164
OUTLANDER 1000,2021-10-04,12,0,AL,US,12,2206
OUTLANDER 850,2021-10-04,1,5,AL,US,6,2049
OUTLANDER 450,2021-10-04,5,8,AL,US,13,2177
OUTLANDER 1000,2021-10-11,14,11,AL,US,25,2231
OUTLANDER 850,2021-10-11,11,13,AL,US,24,2073
OUTLANDER 450,2021-10-11,5,10,AL,US,15,2192
OUTLANDER 1000,2021-10-18,3,0,AL,US,3,2234
OUTLANDER 850,2021-10-18,10,2,AL,US,12,2085
OUTLANDER 450,2021-10-18,2,9,AL,US,11,2203
OUTLANDER 1000,2021-10-25,14,5,AL,US,19,2253
OUTLANDER 850,2021-10-25,9,5,AL,US,14,2099
OUTLANDER 450,2021-10-25,5,9,AL,US,14,2217
OUTLANDER 1000,2021-11-01,8,8,AL,US,16,2269
OUTLANDER 850,2021-11-01,4,13,AL,US,17,2116
OUTLANDER 450,2021-11-01,13,11,AL,US,24,2241
OUTLANDER 1000,2021-11-08,14,0,AL,US,14,2283
OUTLANDER 850,2021-11-08,10,4,AL,US,14,2130
OUTLANDER 450,2021-11-08,12,6,AL,US,18,2259
OUTLANDER 1000,2021-11-15,11,7,AL,US,18,2301
OUTLANDER 850,2021-11-15,0,9,AL,US,9,2139
OUTLANDER 450,2021-11-15,4,12,AL,US,16,2275
OUTLANDER 1000,2021-11-22,11,10,AL,US,21,2322
OUTLANDER 850,2021-11-22,1,11,AL,US,12,2151
OUTLANDER 450,2021-11-22,9,6,AL,US,15,2290
OUTLANDER 1000,2021-11-29,10,2,AL,US,12,2334
OUTLANDER 850,2021-11-29,13,6,AL,US,19,2170
OUTLANDER 450,2021-11-29,1,10,AL,US,11,2301
OUTLANDER 1000,2021-12-06,11,12,AL,US,23,2357
OUTLANDER 850,2021-12-06,12,3,AL,US,15,2185
OUTLANDER 450,2021-12-06,7,7,AL,US,14,2315
OUTLANDER 1000,2021-12-13,11,6,AL,US,17,2374
OUTLANDER 850,2021-12-13,4,9,AL,US,13,2198
OUTLANDER 450,2021-12-13,12,4,AL,US,16,2331
OUTLANDER 1000,2021-12-20,13,12,AL,US,25,2399
OUTLANDER 850,2021-12-20,9,9,AL,US,18,2216
OUTLANDER 450,2021-12-20,15,13,AL,US,28,2359
OUTLANDER 1000,2021-12-27,11,15,AL,US,26,2425
OUTLANDER 850,2021-12-27,8,4,AL,US,12,2228
OUTLANDER 450,2021-12-27,14,9,AL,US,23,2382
OUTLANDER 1000,2019-01-07,5,8,AK,US,13,13
OUTLANDER 850,2019-01-07,14,1,AK,US,15,15
OUTLANDER 450,2019-01-07,12,1,AK,US,13,13
OUTLANDER 1000,2019-01-14,13,7,AK,US,20,33
OUTLANDER 850,2019-01-14,14,8,AK,US,22,37
OUTLANDER 450,2019-01-14,9,2,AK,US,11,24
OUTLANDER 1000,2019-01-21,5,3,AK,US,8,41
OUTLANDER 850,2019-01-21,9,12,AK,US,21,58
OUTLANDER 450,2019-01-21,4,13,AK,US,17,41
OUTLANDER 1000,2019-01-28,12,11,AK,US,23,64
OUTLANDER 850,2019-01-28,1,13,AK,US,14,72
OUTLANDER 450,2019-01-28,9,11,AK,US,20,61
OUTLANDER 1000,2019-02-04,8,6,AK,US,14,78
OUTLANDER 850,2019-02-04,9,7,AK,US,16,88
OUTLANDER 450,2019-02-04,4,2,AK,US,6,67
OUTLANDER 1000,2019-02-11,0,8,AK,US,8,86
OUTLANDER 850,2019-02-11,7,1,AK,US,8,96
OUTLANDER 450,2019-02-11,6,0,AK,US,6,73
OUTLANDER 1000,2019-02-18,2,8,AK,US,10,96
OUTLANDER 850,2019-02-18,7,4,AK,US,11,107
OUTLANDER 450,2019-02-18,6,12,AK,US,18,91
OUTLANDER 1000,2019-02-25,4,4,AK,US,8,104
OUTLANDER 850,2019-02-25,14,13,AK,US,27,134
OUTLANDER 450,2019-02-25,3,4,AK,US,7,98
OUTLANDER 1000,2019-03-04,6,3,AK,US,9,113
OUTLANDER 850,2019-03-04,0,1,AK,US,1,135
OUTLANDER 450,2019-03-04,7,13,AK,US,20,118
OUTLANDER 1000,2019-03-11,9,3,AK,US,12,125
OUTLANDER 850,2019-03-11,3,14,AK,US,17,152
OUTLANDER 450,2019-03-11,10,5,AK,US,15,133
OUTLANDER 1000,2019-03-18,3,11,AK,US,14,139
OUTLANDER 850,2019-03-18,11,14,AK,US,25,177
OUTLANDER 450,2019-03-18,13,8,AK,US,21,154
OUTLANDER 1000,2019-03-25,11,4,AK,US,15,154
OUTLANDER 850,2019-03-25,1,8,AK,US,9,186
OUTLANDER 450,2019-03-25,10,5,AK,US,15,169
OUTLANDER 1000,2019-04-01,12,14,AK,US,26,180
OUTLANDER 850,2019-04-01,14,9,AK,US,23,209
OUTLANDER 450,2019-04-01,8,3,AK,US,11,180
OUTLANDER 1000,2019-04-08,15,15,AK,US,30,210
OUTLANDER 850,2019-04-08,11,0,AK,US,11,220
OUTLANDER 450,2019-04-08,10,11,AK,US,21,201
OUTLANDER 1000,2019-04-15,14,1,AK,US,15,225
OUTLANDER 850,2019-04-15,1,4,AK,US,5,225
OUTLANDER 450,2019-04-15,9,15,AK,US,24,225
OUTLANDER 1000,2019-04-22,12,3,AK,US,15,240
OUTLANDER 850,2019-04-22,2,2,AK,US,4,229
OUTLANDER 450,2019-04-22,11,0,AK,US,11,236
OUTLANDER 1000,2019-04-29,10,13,AK,US,23,263
OUTLANDER 850,2019-04-29,10,7,AK,US,17,246
OUTLANDER 450,2019-04-29,4,6,AK,US,10,246
OUTLANDER 1000,2019-05-06,1,13,AK,US,14,277
OUTLANDER 850,2019-05-06,1,12,AK,US,13,259
OUTLANDER 450,2019-05-06,14,10,AK,US,24,270
OUTLANDER 1000,2019-05-13,12,7,AK,US,19,296
OUTLANDER 850,2019-05-13,10,14,AK,US,24,283
OUTLANDER 450,2019-05-13,2,0,AK,US,2,272
OUTLANDER 1000,2019-05-20,0,13,AK,US,13,309
OUTLANDER 850,2019-05-20,4,7,AK,US,11,294
OUTLANDER 450,2019-05-20,12,9,AK,US,21,293
OUTLANDER 1000,2019-05-27,14,10,AK,US,24,333
OUTLANDER 850,2019-05-27,9,1,AK,US,10,304
OUTLANDER 450,2019-05-27,8,9,AK,US,17,310
OUTLANDER 1000,2019-06-03,1,10,AK,US,11,344
OUTLANDER 850,2019-06-03,13,6,AK,US,19,323
OUTLANDER 450,2019-06-03,3,4,AK,US,7,317
OUTLANDER 1000,2019-06-10,2,1,AK,US,3,347
OUTLANDER 850,2019-06-10,5,10,AK,US,15,338
OUTLANDER 450,2019-06-10,2,11,AK,US,13,330
OUTLANDER 1000,2019-06-17,12,0,AK,US,12,359
OUTLANDER 850,2019-06-17,6,15,AK,US,21,359
OUTLANDER 450,2019-06-17,6,11,AK,US,17,347
OUTLANDER 1000,2019-06-24,1,9,AK,US,10,369
OUTLANDER 850,2019-06-24,9,1,AK,US,10,369
OUTLANDER 450,2019-06-24,9,2,AK,US,11,358
OUTLANDER 1000,2019-07-01,1,14,AK,US,15,384
OUTLANDER 850,2019-07-01,5,4,AK,US,9,378
OUTLANDER 450,2019-07-01,7,0,AK,US,7,365
OUTLANDER 1000,2019-07-08,9,3,AK,US,12,396
OUTLANDER 850,2019-07-08,9,7,AK,US,16,394
OUTLANDER 450,2019-07-08,14,3,AK,US,17,382
OUTLANDER 1000,2019-07-15,1,12,AK,US,13,409
OUTLANDER 850,2019-07-15,0,12,AK,US,12,406
OUTLANDER 450,2019-07-15,4,7,AK,US,11,393
OUTLANDER 1000,2019-07-22,1,11,AK,US,12,421
OUTLANDER 850,2019-07-22,10,7,AK,US,17,423
OUTLANDER 450,2019-07-22,4,9,AK,US,13,406
OUTLANDER 1000,2019-07-29,3,10,AK,US,13,434
OUTLANDER 850,2019-07-29,5,8,AK,US,13,436
OUTLANDER 450,2019-07-29,4,14,AK,US,18,424
OUTLANDER 1000,2019-08-05,5,2,AK,US,7,441
OUTLANDER 850,2019-08-05,2,8,AK,US,10,446
OUTLANDER 450,2019-08-05,13,9,AK,US,22,446
OUTLANDER 1000,2019-08-12,13,12,AK,US,25,466
OUTLANDER 850,2019-08-12,8,6,AK,US,14,460
OUTLANDER 450,2019-08-12,0,10,AK,US,10,456
OUTLANDER 1000,2019-08-19,2,14,AK,US,16,482
OUTLANDER 850,2019-08-19,14,7,AK,US,21,481
OUTLANDER 450,2019-08-19,12,2,AK,US,14,470
OUTLANDER 1000,2019-08-26,3,10,AK,US,13,495
OUTLANDER 850,2019-08-26,3,13,AK,US,16,497
OUTLANDER 450,2019-08-26,4,14,AK,US,18,488
OUTLANDER 1000,2019-09-02,15,13,AK,US,28,523
OUTLANDER 850,2019-09-02,10,0,AK,US,10,507
OUTLANDER 450,2019-09-02,12,4,AK,US,16,504
OUTLANDER 1000,2019-09-09,5,11,AK,US,16,539
OUTLANDER 850,2019-09-09,10,5,AK,US,15,522
OUTLANDER 450,2019-09-09,9,7,AK,US,16,520
OUTLANDER 1000,2019-09-16,8,2,AK,US,10,549
OUTLANDER 850,2019-09-16,2,2,AK,US,4,526
OUTLANDER 450,2019-09-16,0,5,AK,US,5,525
OUTLANDER 1000,2019-09-23,8,11,AK,US,19,568
OUTLANDER 850,2019-09-23,1,13,AK,US,14,540
OUTLANDER 450,2019-09-23,4,1,AK,US,5,530
OUTLANDER 1000,2019-09-30,3,15,AK,US,18,586
OUTLANDER 850,2019-09-30,7,1,AK,US,8,548
OUTLANDER 450,2019-09-30,10,11,AK,US,21,551
OUTLANDER 1000,2019-10-07,4,9,AK,US,13,599
OUTLANDER 850,2019-10-07,14,1,AK,US,15,563
OUTLANDER 450,2019-10-07,6,10,AK,US,16,567
OUTLANDER 1000,2019-10-14,6,4,AK,US,10,609
OUTLANDER 850,2019-10-14,6,5,AK,US,11,574
OUTLANDER 450,2019-10-14,12,0,AK,US,12,579
OUTLANDER 1000,2019-10-21,12,8,AK,US,20,629
OUTLANDER 850,2019-10-21,11,11,AK,US,22,596
OUTLANDER 450,2019-10-21,10,3,AK,US,13,592
OUTLANDER 1000,2019-10-28,7,3,AK,US,10,639
OUTLANDER 850,2019-10-28,8,1,AK,US,9,605
OUTLANDER 450,2019-10-28,13,4,AK,US,17,609
OUTLANDER 1000,2019-11-04,4,5,AK,US,9,648
OUTLANDER 850,2019-11-04,8,0,AK,US,8,613
OUTLANDER 450,2019-11-04,13,4,AK,US,17,626
OUTLANDER 1000,2019-11-11,9,5,AK,US,14,662
OUTLANDER 850,2019-11-11,9,8,AK,US,17,630
OUTLANDER 450,2019-11-11,11,14,AK,US,25,651
OUTLANDER 1000,2019-11-18,12,2,AK,US,14,676
OUTLANDER 850,2019-11-18,11,14,AK,US,25,655
OUTLANDER 450,2019-11-18,0,4,AK,US,4,655
OUTLANDER 1000,2019-11-25,14,2,AK,US,16,692
OUTLANDER 850,2019-11-25,2,1,AK,US,3,658
OUTLANDER 450,2019-11-25,12,3,AK,US,15,670
OUTLANDER 1000,2019-12-02,9,13,AK,US,22,714
OUTLANDER 850,2019-12-02,3,13,AK,US,16,674
OUTLANDER 450,2019-12-02,3,13,AK,US,16,686
OUTLANDER 1000,2019-12-09,11,9,AK,US,20,734
OUTLANDER 850,2019-12-09,12,7,AK,US,19,693
OUTLANDER 450,2019-12-09,7,8,AK,US,15,701
OUTLANDER 1000,2019-12-16,10,7,AK,US,17,751
OUTLANDER 850,2019-12-16,5,1,AK,US,6,699
OUTLANDER 450,2019-12-16,7,2,AK,US,9,710
OUTLANDER 1000,2019-12-23,5,7,AK,US,12,763
OUTLANDER 850,2019-12-23,11,15,AK,US,26,725
OUTLANDER 450,2019-12-23,7,13,AK,US,20,730
OUTLANDER 1000,2019-12-30,2,15,AK,US,17,780
OUTLANDER 850,2019-12-30,13,3,AK,US,16,741
OUTLANDER 450,2019-12-30,1,10,AK,US,11,741
OUTLANDER 1000,2020-01-06,1,12,AK,US,13,793
OUTLANDER 850,2020-01-06,7,2,AK,US,9,750
OUTLANDER 450,2020-01-06,8,12,AK,US,20,761
OUTLANDER 1000,2020-01-13,14,2,AK,US,16,809
OUTLANDER 850,2020-01-13,14,0,AK,US,14,764
OUTLANDER 450,2020-01-13,8,13,AK,US,21,782
OUTLANDER 1000,2020-01-20,5,9,AK,US,14,823
OUTLANDER 850,2020-01-20,5,2,AK,US,7,771
OUTLANDER 450,2020-01-20,12,12,AK,US,24,806
OUTLANDER 1000,2020-01-27,11,12,AK,US,23,846
OUTLANDER 850,2020-01-27,1,1,AK,US,2,773
OUTLANDER 450,2020-01-27,9,7,AK,US,16,822
OUTLANDER 1000,2020-02-03,4,6,AK,US,10,856
OUTLANDER 850,2020-02-03,1,6,AK,US,7,780
OUTLANDER 450,2020-02-03,14,5,AK,US,19,841
OUTLANDER 1000,2020-02-10,10,5,AK,US,15,871
OUTLANDER 850,2020-02-10,9,6,AK,US,15,795
OUTLANDER 450,2020-02-10,14,5,AK,US,19,860
OUTLANDER 1000,2020-02-17,7,5,AK,US,12,883
OUTLANDER 850,2020-02-17,14,12,AK,US,26,821
OUTLANDER 450,2020-02-17,11,12,AK,US,23,883
OUTLANDER 1000,2020-02-24,2,2,AK,US,4,887
OUTLANDER 850,2020-02-24,2,7,AK,US,9,830
OUTLANDER 450,2020-02-24,14,7,AK,US,21,904
OUTLANDER 1000,2020-03-02,5,11,AK,US,16,903
OUTLANDER 850,2020-03-02,10,1,AK,US,11,841
OUTLANDER 450,2020-03-02,9,7,AK,US,16,920
OUTLANDER 1000,2020-03-09,12,11,AK,US,23,926
OUTLANDER 850,2020-03-09,8,13,AK,US,21,862
OUTLANDER 450,2020-03-09,5,8,AK,US,13,933
OUTLANDER 1000,2020-03-16,7,13,AK,US,20,946
OUTLANDER 850,2020-03-16,8,13,AK,US,21,883
OUTLANDER 450,2020-03-16,8,5,AK,US,13,946
OUTLANDER 1000,2020-03-23,10,0,AK,US,10,956
OUTLANDER 850,2020-03-23,8,4,AK,US,12,895
OUTLANDER 450,2020-03-23,12,4,AK,US,16,962
OUTLANDER 1000,2020-03-30,10,1,AK,US,11,967
OUTLANDER 850,2020-03-30,7,5,AK,US,12,907
OUTLANDER 450,2020-03-30,4,12,AK,US,16,978
OUTLANDER 1000,2020-04-06,7,1,AK,US,8,975
OUTLANDER 850,2020-04-06,9,2,AK,US,11,918
OUTLANDER 450,2020-04-06,14,2,AK,US,16,994
OUTLANDER 1000,2020-04-13,13,5,AK,US,18,993
OUTLANDER 850,2020-04-13,11,7,AK,US,18,936
OUTLANDER 450,2020-04-13,9,3,AK,US,12,1006
OUTLANDER 1000,2020-04-20,9,13,AK,US,22,1015
OUTLANDER 850,2020-04-20,5,8,AK,US,13,949
OUTLANDER 450,2020-04-20,6,5,AK,US,11,1017
OUTLANDER 1000,2020-04-27,11,2,AK,US,13,1028
OUTLANDER 850,2020-04-27,12,7,AK,US,19,968
OUTLANDER 450,2020-04-27,14,4,AK,US,18,1035
OUTLANDER 1000,2020-05-04,13,15,AK,US,28,1056
OUTLANDER 850,2020-05-04,12,8,AK,US,20,988
OUTLANDER 450,2020-05-04,7,3,AK,US,10,1045
OUTLANDER 1000,2020-05-11,8,14,AK,US,22,1078
OUTLANDER 850,2020-05-11,5,1,AK,US,6,994
OUTLANDER 450,2020-05-11,8,2,AK,US,10,1055
OUTLANDER 1000,2020-05-18,3,13,AK,US,16,1094
OUTLANDER 850,2020-05-18,7,3,AK,US,10,1004
OUTLANDER 450,2020-05-18,5,14,AK,US,19,1074
OUTLANDER 1000,2020-05-25,5,10,AK,US,15,1109
OUTLANDER 850,2020-05-25,9,1,AK,US,10,1014
OUTLANDER 450,2020-05-25,13,8,AK,US,21,1095
OUTLANDER 1000,2020-06-01,15,9,AK,US,24,1133
OUTLANDER 850,2020-06-01,15,4,AK,US,19,1033
OUTLANDER 450,2020-06-01,9,10,AK,US,19,1114
OUTLANDER 1000,2020-06-08,5,5,AK,US,10,1143
OUTLANDER 850,2020-06-08,14,14,AK,US,28,1061
OUTLANDER 450,2020-06-08,13,15,AK,US,28,1142
OUTLANDER 1000,2020-06-15,1,12,AK,US,13,1156
OUTLANDER 850,2020-06-15,1,9,AK,US,10,1071
OUTLANDER 450,2020-06-15,15,3,AK,US,18,1160
OUTLANDER 1000,2020-06-22,11,2,AK,US,13,1169
OUTLANDER 850,2020-06-22,1,9,AK,US,10,1081
OUTLANDER 450,2020-06-22,5,0,AK,US,5,1165
OUTLANDER 1000,2020-06-29,12,14,AK,US,26,1195
OUTLANDER 850,2020-06-29,7,9,AK,US,16,1097
OUTLANDER 450,2020-06-29,2,3,AK,US,5,1170
OUTLANDER 1000,2020-07-06,9,8,AK,US,17,1212
OUTLANDER 850,2020-07-06,4,2,AK,US,6,1103
OUTLANDER 450,2020-07-06,6,1,AK,US,7,1177
OUTLANDER 1000,2020-07-13,11,5,AK,US,16,1228
OUTLANDER 850,2020-07-13,13,13,AK,US,26,1129
OUTLANDER 450,2020-07-13,3,13,AK,US,16,1193
OUTLANDER 1000,2020-07-20,11,13,AK,US,24,1252
OUTLANDER 850,2020-07-20,10,9,AK,US,19,1148
OUTLANDER 450,2020-07-20,14,7,AK,US,21,1214
OUTLANDER 1000,2020-07-27,4,12,AK,US,16,1268
OUTLANDER 850,2020-07-27,2,6,AK,US,8,1156
OUTLANDER 450,2020-07-27,14,7,AK,US,21,1235
OUTLANDER 1000,2020-08-03,11,13,AK,US,24,1292
OUTLANDER 850,2020-08-03,10,2,AK,US,12,1168
OUTLANDER 450,2020-08-03,10,1,AK,US,11,1246
OUTLANDER 1000,2020-08-10,8,12,AK,US,20,1312
OUTLANDER 850,2020-08-10,1,1,AK,US,2,1170
OUTLANDER 450,2020-08-10,4,0,AK,US,4,1250
OUTLANDER 1000,2020-08-17,12,10,AK,US,22,1334
OUTLANDER 850,2020-08-17,9,12,AK,US,21,1191
OUTLANDER 450,2020-08-17,9,7,AK,US,16,1266
OUTLANDER 1000,2020-08-24,5,0,AK,US,5,1339
OUTLANDER 850,2020-08-24,9,13,AK,US,22,1213
OUTLANDER 450,2020-08-24,4,3,AK,US,7,1273
OUTLANDER 1000,2020-08-31,7,3,AK,US,10,1349
OUTLANDER 850,2020-08-31,3,7,AK,US,10,1223
OUTLANDER 450,2020-08-31,6,10,AK,US,16,1289
OUTLANDER 1000,2020-09-07,10,3,AK,US,13,1362
OUTLANDER 850,2020-09-07,3,13,AK,US,16,1239
OUTLANDER 450,2020-09-07,13,12,AK,US,25,1314
OUTLANDER 1000,2020-09-14,6,12,AK,US,18,1380
OUTLANDER 850,2020-09-14,1,5,AK,US,6,1245
OUTLANDER 450,2020-09-14,6,7,AK,US,13,1327
OUTLANDER 1000,2020-09-21,14,2,AK,US,16,1396
OUTLANDER 850,2020-09-21,2,0,AK,US,2,1247
OUTLANDER 450,2020-09-21,5,11,AK,US,16,1343
OUTLANDER 1000,2020-09-28,6,5,AK,US,11,1407
OUTLANDER 850,2020-09-28,8,6,AK,US,14,1261
OUTLANDER 450,2020-09-28,6,12,AK,US,18,1361
OUTLANDER 1000,2020-10-05,7,3,AK,US,10,1417
OUTLANDER 850,2020-10-05,11,5,AK,US,16,1277
OUTLANDER 450,2020-10-05,14,8,AK,US,22,1383
OUTLANDER 1000,2020-10-12,0,7,AK,US,7,1424
OUTLANDER 850,2020-10-12,6,2,AK,US,8,1285
OUTLANDER 450,2020-10-12,8,10,AK,US,18,1401
OUTLANDER 1000,2020-10-19,13,7,AK,US,20,1444
OUTLANDER 850,2020-10-19,6,12,AK,US,18,1303
OUTLANDER 450,2020-10-19,2,1,AK,US,3,1404
OUTLANDER 1000,2020-10-26,1,2,AK,US,3,1447
OUTLANDER 850,2020-10-26,0,4,AK,US,4,1307
OUTLANDER 450,2020-10-26,13,6,AK,US,19,1423
OUTLANDER 1000,2020-11-02,8,12,AK,US,20,1467
OUTLANDER 850,2020-11-02,5,13,AK,US,18,1325
OUTLANDER 450,2020-11-02,14,5,AK,US,19,1442
OUTLANDER 1000,2020-11-09,6,8,AK,US,14,1481
OUTLANDER 850,2020-11-09,1,12,AK,US,13,1338
OUTLANDER 450,2020-11-09,7,15,AK,US,22,1464
OUTLANDER 1000,2020-11-16,14,8,AK,US,22,1503
OUTLANDER 850,2020-11-16,11,14,AK,US,25,1363
OUTLANDER 450,2020-11-16,9,15,AK,US,24,1488
OUTLANDER 1000,2020-11-23,11,5,AK,US,16,1519
OUTLANDER 850,2020-11-23,7,12,AK,US,19,1382
OUTLANDER 450,2020-11-23,7,8,AK,US,15,1503
OUTLANDER 1000,2020-11-30,9,8,AK,US,17,1536
OUTLANDER 850,2020-11-30,14,6,AK,US,20,1402
OUTLANDER 450,2020-11-30,5,5,AK,US,10,1513
OUTLANDER 1000,2020-12-07,5,12,AK,US,17,1553
OUTLANDER 850,2020-12-07,9,6,AK,US,15,1417
OUTLANDER 450,2020-12-07,3,14,AK,US,17,1530
OUTLANDER 1000,2020-12-14,1,12,AK,US,13,1566
OUTLANDER 850,2020-12-14,14,13,AK,US,27,1444
OUTLANDER 450,2020-12-14,2,3,AK,US,5,1535
OUTLANDER 1000,2020-12-21,15,15,AK,US,30,1596
OUTLANDER 850,2020-12-21,5,13,AK,US,18,1462
OUTLANDER 450,2020-12-21,3,3,AK,US,6,1541
OUTLANDER 1000,2020-12-28,6,12,AK,US,18,1614
OUTLANDER 850,2020-12-28,13,6,AK,US,19,1481
OUTLANDER 450,2020-12-28,5,4,AK,US,9,1550
OUTLANDER 1000,2021-01-04,14,5,AK,US,19,1633
OUTLANDER 850,2021-01-04,11,2,AK,US,13,1494
OUTLANDER 450,2021-01-04,0,9,AK,US,9,1559
OUTLANDER 1000,2021-01-11,8,14,AK,US,22,1655
OUTLANDER 850,2021-01-11,7,9,AK,US,16,1510
OUTLANDER 450,2021-01-11,9,4,AK,US,13,1572
OUTLANDER 1000,2021-01-18,11,7,AK,US,18,1673
OUTLANDER 850,2021-01-18,8,5,AK,US,13,1523
OUTLANDER 450,2021-01-18,2,4,AK,US,6,1578
OUTLANDER 1000,2021-01-25,9,8,AK,US,17,1690
OUTLANDER 850,2021-01-25,4,8,AK,US,12,1535
OUTLANDER 450,2021-01-25,4,6,AK,US,10,1588
OUTLANDER 1000,2021-02-01,3,4,AK,US,7,1697
OUTLANDER 850,2021-02-01,9,3,AK,US,12,1547
OUTLANDER 450,2021-02-01,2,2,AK,US,4,1592
OUTLANDER 1000,2021-02-08,14,4,AK,US,18,1715
OUTLANDER 850,2021-02-08,8,7,AK,US,15,1562
OUTLANDER 450,2021-02-08,12,5,AK,US,17,1609
OUTLANDER 1000,2021-02-15,13,4,AK,US,17,1732
OUTLANDER 850,2021-02-15,6,1,AK,US,7,1569
OUTLANDER 450,2021-02-15,12,3,AK,US,15,1624
OUTLANDER 1000,2021-02-22,6,0,AK,US,6,1738
OUTLANDER 850,2021-02-22,13,5,AK,US,18,1587
OUTLANDER 450,2021-02-22,9,3,AK,US,12,1636
OUTLANDER 1000,2021-03-01,10,0,AK,US,10,1748
OUTLANDER 850,2021-03-01,7,7,AK,US,14,1601
OUTLANDER 450,2021-03-01,11,14,AK,US,25,1661
OUTLANDER 1000,2021-03-08,8,14,AK,US,22,1770
OUTLANDER 850,2021-03-08,4,1,AK,US,5,1606
OUTLANDER 450,2021-03-08,6,14,AK,US,20,1681
OUTLANDER 1000,2021-03-15,1,7,AK,US,8,1778
OUTLANDER 850,2021-03-15,11,6,AK,US,17,1623
OUTLANDER 450,2021-03-15,5,6,AK,US,11,1692
OUTLANDER 1000,2021-03-22,14,11,AK,US,25,1803
OUTLANDER 850,2021-03-22,9,2,AK,US,11,1634
OUTLANDER 450,2021-03-22,4,0,AK,US,4,1696
OUTLANDER 1000,2021-03-29,2,3,AK,US,5,1808
OUTLANDER 850,2021-03-29,1,12,AK,US,13,1647
OUTLANDER 450,2021-03-29,3,12,AK,US,15,1711
OUTLANDER 1000,2021-04-05,2,1,AK,US,3,1811
OUTLANDER 850,2021-04-05,13,9,AK,US,22,1669
OUTLANDER 450,2021-04-05,6,7,AK,US,13,1724
OUTLANDER 1000,2021-04-12,12,11,AK,US,23,1834
OUTLANDER 850,2021-04-12,2,12,AK,US,14,1683
OUTLANDER 450,2021-04-12,5,12,AK,US,17,1741
OUTLANDER 1000,2021-04-19,10,15,AK,US,25,1859
OUTLANDER 850,2021-04-19,9,9,AK,US,18,1701
OUTLANDER 450,2021-04-19,4,4,AK,US,8,1749
OUTLANDER 1000,2021-04-26,13,0,AK,US,13,1872
OUTLANDER 850,2021-04-26,7,15,AK,US,22,1723
OUTLANDER 450,2021-04-26,2,7,AK,US,9,1758
OUTLANDER 1000,2021-05-03,14,11,AK,US,25,1897
OUTLANDER 850,2021-05-03,11,12,AK,US,23,1746
OUTLANDER 450,2021-05-03,8,10,AK,US,18,1776
OUTLANDER 1000,2021-05-10,12,10,AK,US,22,1919
OUTLANDER 850,2021-05-10,6,15,AK,US,21,1767
OUTLANDER 450,2021-05-10,1,13,AK,US,14,1790
OUTLANDER 1000,2021-05-17,4,2,AK,US,6,1925
OUTLANDER 850,2021-05-17,7,4,AK,US,11,1778
OUTLANDER 450,2021-05-17,12,15,AK,US,27,1817
OUTLANDER 1000,2021-05-24,8,14,AK,US,22,1947
OUTLANDER 850,2021-05-24,10,14,AK,US,24,1802
OUTLANDER 450,2021-05-24,3,13,AK,US,16,1833
OUTLANDER 1000,2021-05-31,6,3,AK,US,9,1956
OUTLANDER 850,2021-05-31,7,3,AK,US,10,1812
OUTLANDER 450,2021-05-31,8,13,AK,US,21,1854
OUTLANDER 1000,2021-06-07,10,13,AK,US,23,1979
OUTLANDER 850,2021-06-07,3,9,AK,US,12,1824
OUTLANDER 450,2021-06-07,2,3,AK,US,5,1859
OUTLANDER 1000,2021-06-14,12,1,AK,US,13,1992
OUTLANDER 850,2021-06-14,4,14,AK,US,18,1842
OUTLANDER 450,2021-06-14,1,0,AK,US,1,1860
OUTLANDER 1000,2021-06-21,12,10,AK,US,22,2014
OUTLANDER 850,2021-06-21,1,7,AK,US,8,1850
OUTLANDER 450,2021-06-21,14,1,AK,US,15,1875
OUTLANDER 1000,2021-06-28,1,7,AK,US,8,2022
OUTLANDER 850,2021-06-28,3,5,AK,US,8,1858
OUTLANDER 450,2021-06-28,4,13,AK,US,17,1892
OUTLANDER 1000,2021-07-05,4,7,AK,US,11,2033
OUTLANDER 850,2021-07-05,11,12,AK,US,23,1881
OUTLANDER 450,2021-07-05,9,11,AK,US,20,1912
OUTLANDER 1000,2021-07-12,5,2,AK,US,7,2040
OUTLANDER 850,2021-07-12,9,11,AK,US,20,1901
OUTLANDER 450,2021-07-12,4,15,AK,US,19,1931
OUTLANDER 1000,2021-07-19,3,13,AK,US,16,2056
OUTLANDER 850,2021-07-19,12,6,AK,US,18,1919
OUTLANDER 450,2021-07-19,9,13,AK,US,22,1953
OUTLANDER 1000,2021-07-26,7,14,AK,US,21,2077
OUTLANDER 850,2021-07-26,14,10,AK,US,24,1943
OUTLANDER 450,2021-07-26,9,7,AK,US,16,1969
OUTLANDER 1000,2021-08-02,4,4,AK,US,8,2085
OUTLANDER 850,2021-08-02,13,5,AK,US,18,1961
OUTLANDER 450,2021-08-02,7,2,AK,US,9,1978
OUTLANDER 1000,2021-08-09,4,8,AK,US,12,2097
OUTLANDER 850,2021-08-09,9,0,AK,US,9,1970
OUTLANDER 450,2021-08-09,7,11,AK,US,18,1996
OUTLANDER 1000,2021-08-16,4,6,AK,US,10,2107
OUTLANDER 850,2021-08-16,11,4,AK,US,15,1985
OUTLANDER 450,2021-08-16,4,5,AK,US,9,2005
OUTLANDER 1000,2021-08-23,8,4,AK,US,12,2119
OUTLANDER 850,2021-08-23,4,14,AK,US,18,2003
OUTLANDER 450,2021-08-23,5,13,AK,US,18,2023
OUTLANDER 1000,2021-08-30,14,6,AK,US,20,2139
OUTLANDER 850,2021-08-30,5,1,AK,US,6,2009
OUTLANDER 450,2021-08-30,4,1,AK,US,5,2028
OUTLANDER 1000,2021-09-06,9,8,AK,US,17,2156
OUTLANDER 850,2021-09-06,9,5,AK,US,14,2023
OUTLANDER 450,2021-09-06,6,11,AK,US,17,2045
OUTLANDER 1000,2021-09-13,13,3,AK,US,16,2172
OUTLANDER 850,2021-09-13,14,7,AK,US,21,2044
OUTLANDER 450,2021-09-13,3,7,AK,US,10,2055
OUTLANDER 1000,2021-09-20,10,11,AK,US,21,2193
OUTLANDER 850,2021-09-20,1,10,AK,US,11,2055
OUTLANDER 450,2021-09-20,14,8,AK,US,22,2077
OUTLANDER 1000,2021-09-27,4,13,AK,US,17,2210
OUTLANDER 850,2021-09-27,1,14,AK,US,15,2070
OUTLANDER 450,2021-09-27,10,4,AK,US,14,2091
OUTLANDER 1000,2021-10-04,2,1,AK,US,3,2213
OUTLANDER 850,2021-10-04,5,1,AK,US,6,2076
OUTLANDER 450,2021-10-04,1,10,AK,US,11,2102
OUTLANDER 1000,2021-10-11,1,4,AK,US,5,2218
OUTLANDER 850,2021-10-11,11,1,AK,US,12,2088
OUTLANDER 450,2021-10-11,4,9,AK,US,13,2115
OUTLANDER 1000,2021-10-18,15,0,AK,US,15,2233
OUTLANDER 850,2021-10-18,8,5,AK,US,13,2101
OUTLANDER 450,2021-10-18,3,8,AK,US,11,2126
OUTLANDER 1000,2021-10-25,6,10,AK,US,16,2249
OUTLANDER 850,2021-10-25,14,14,AK,US,28,2129
OUTLANDER 450,2021-10-25,5,6,AK,US,11,2137
OUTLANDER 1000,2021-11-01,14,5,AK,US,19,2268
OUTLANDER 850,2021-11-01,9,11,AK,US,20,2149
OUTLANDER 450,2021-11-01,15,10,AK,US,25,2162
OUTLANDER 1000,2021-11-08,11,10,AK,US,21,2289
OUTLANDER 850,2021-11-08,9,8,AK,US,17,2166
OUTLANDER 450,2021-11-08,11,10,AK,US,21,2183
OUTLANDER 1000,2021-11-15,5,4,AK,US,9,2298
OUTLANDER 850,2021-11-15,14,9,AK,US,23,2189
OUTLANDER 450,2021-11-15,6,6,AK,US,12,2195
OUTLANDER 1000,2021-11-22,15,5,AK,US,20,2318
OUTLANDER 850,2021-11-22,13,13,AK,US,26,2215
OUTLANDER 450,2021-11-22,6,3,AK,US,9,2204
OUTLANDER 1000,2021-11-29,1,13,AK,US,14,2332
OUTLANDER 850,2021-11-29,2,7,AK,US,9,2224
OUTLANDER 450,2021-11-29,14,0,AK,US,14,2218
OUTLANDER 1000,2021-12-06,6,11,AK,US,17,2349
OUTLANDER 850,2021-12-06,1,3,AK,US,4,2228
OUTLANDER 450,2021-12-06,0,3,AK,US,3,2221
OUTLANDER 1000,2021-12-13,0,13,AK,US,13,2362
OUTLANDER 850,2021-12-13,13,6,AK,US,19,2247
OUTLANDER 450,2021-12-13,11,13,AK,US,24,2245
OUTLANDER 1000,2021-12-20,9,4,AK,US,13,2375
OUTLANDER 850,2021-12-20,4,11,AK,US,15,2262
OUTLANDER 450,2021-12-20,6,14,AK,US,20,2265
OUTLANDER 1000,2021-12-27,11,11,AK,US,22,2397
OUTLANDER 850,2021-12-27,13,7,AK,US,20,2282
OUTLANDER 450,2021-12-27,12,2,AK,US,14,2279
OUTLANDER 1000,2019-01-07,2,6,AZ,US,8,8
OUTLANDER 850,2019-01-07,8,1,AZ,US,9,9
OUTLANDER 450,2019-01-07,7,8,AZ,US,15,15
OUTLANDER 1000,2019-01-14,12,2,AZ,US,14,22
OUTLANDER 850,2019-01-14,1,13,AZ,US,14,23
OUTLANDER 450,2019-01-14,1,11,AZ,US,12,27
OUTLANDER 1000,2019-01-21,0,15,AZ,US,15,37
OUTLANDER 850,2019-01-21,8,13,AZ,US,21,44
OUTLANDER 450,2019-01-21,2,14,AZ,US,16,43
OUTLANDER 1000,2019-01-28,5,2,AZ,US,7,44
OUTLANDER 850,2019-01-28,0,8,AZ,US,8,52
OUTLANDER 450,2019-01-28,8,13,AZ,US,21,64
OUTLANDER 1000,2019-02-04,11,1,AZ,US,12,56
OUTLANDER 850,2019-02-04,9,3,AZ,US,12,64
OUTLANDER 450,2019-02-04,12,6,AZ,US,18,82
OUTLANDER 1000,2019-02-11,15,13,AZ,US,28,84
OUTLANDER 850,2019-02-11,1,14,AZ,US,15,79
OUTLANDER 450,2019-02-11,7,10,AZ,US,17,99
OUTLANDER 1000,2019-02-18,12,5,AZ,US,17,101
OUTLANDER 850,2019-02-18,12,2,AZ,US,14,93
OUTLANDER 450,2019-02-18,9,2,AZ,US,11,110
OUTLANDER 1000,2019-02-25,11,0,AZ,US,11,112
OUTLANDER 850,2019-02-25,11,12,AZ,US,23,116
OUTLANDER 450,2019-02-25,7,8,AZ,US,15,125
OUTLANDER 1000,2019-03-04,11,10,AZ,US,21,133
OUTLANDER 850,2019-03-04,13,13,AZ,US,26,142
OUTLANDER 450,2019-03-04,10,11,AZ,US,21,146
OUTLANDER 1000,2019-03-11,5,6,AZ,US,11,144
OUTLANDER 850,2019-03-11,10,1,AZ,US,11,153
OUTLANDER 450,2019-03-11,14,10,AZ,US,24,170
OUTLANDER 1000,2019-03-18,12,13,AZ,US,25,169
OUTLANDER 850,2019-03-18,11,3,AZ,US,14,167
OUTLANDER 450,2019-03-18,0,9,AZ,US,9,179
OUTLANDER 1000,2019-03-25,8,12,AZ,US,20,189
OUTLANDER 850,2019-03-25,12,6,AZ,US,18,185
OUTLANDER 450,2019-03-25,0,6,AZ,US,6,185
OUTLANDER 1000,2019-04-01,7,7,AZ,US,14,203
OUTLANDER 850,2019-04-01,8,9,AZ,US,17,202
OUTLANDER 450,2019-04-01,9,12,AZ,US,21,206
OUTLANDER 1000,2019-04-08,10,4,AZ,US,14,217
OUTLANDER 850,2019-04-08,5,11,AZ,US,16,218
OUTLANDER 450,2019-04-08,1,9,AZ,US,10,216
OUTLANDER 1000,2019-04-15,11,4,AZ,US,15,232
OUTLANDER 850,2019-04-15,6,3,AZ,US,9,227
OUTLANDER 450,2019-04-15,15,2,AZ,US,17,233
OUTLANDER 1000,2019-04-22,0,2,AZ,US,2,234
OUTLANDER 850,2019-04-22,1,9,AZ,US,10,237
OUTLANDER 450,2019-04-22,2,6,AZ,US,8,241
OUTLANDER 1000,2019-04-29,10,1,AZ,US,11,245
OUTLANDER 850,2019-04-29,15,1,AZ,US,16,253
OUTLANDER 450,2019-04-29,14,12,AZ,US,26,267
OUTLANDER 1000,2019-05-06,6,10,AZ,US,16,261
OUTLANDER 850,2019-05-06,10,9,AZ,US,19,272
OUTLANDER 450,2019-05-06,4,12,AZ,US,16,283
OUTLANDER 1000,2019-05-13,4,11,AZ,US,15,276
OUTLANDER 850,2019-05-13,13,1,AZ,US,14,286
OUTLANDER 450,2019-05-13,5,2,AZ,US,7,290
OUTLANDER 1000,2019-05-20,11,8,AZ,US,19,295
OUTLANDER 850,2019-05-20,11,7,AZ,US,18,304
OUTLANDER 450,2019-05-20,11,9,AZ,US,20,310
OUTLANDER 1000,2019-05-27,3,3,AZ,US,6,301
OUTLANDER 850,2019-05-27,13,10,AZ,US,23,327
OUTLANDER 450,2019-05-27,7,6,AZ,US,13,323
OUTLANDER 1000,2019-06-03,0,9,AZ,US,9,310
OUTLANDER 850,2019-06-03,7,10,AZ,US,17,344
OUTLANDER 450,2019-06-03,14,12,AZ,US,26,349
OUTLANDER 1000,2019-06-10,12,8,AZ,US,20,330
OUTLANDER 850,2019-06-10,1,11,AZ,US,12,356
OUTLANDER 450,2019-06-10,14,3,AZ,US,17,366
OUTLANDER 1000,2019-06-17,8,13,AZ,US,21,351
OUTLANDER 850,2019-06-17,8,9,AZ,US,17,373
OUTLANDER 450,2019-06-17,8,9,AZ,US,17,383
OUTLANDER 1000,2019-06-24,2,14,AZ,US,16,367
OUTLANDER 850,2019-06-24,6,9,AZ,US,15,388
OUTLANDER 450,2019-06-24,3,9,AZ,US,12,395
OUTLANDER 1000,2019-07-01,14,4,AZ,US,18,385
OUTLANDER 850,2019-07-01,13,2,AZ,US,15,403
OUTLANDER 450,2019-07-01,4,13,AZ,US,17,412
OUTLANDER 1000,2019-07-08,5,8,AZ,US,13,398
OUTLANDER 850,2019-07-08,12,10,AZ,US,22,425
OUTLANDER 450,2019-07-08,12,0,AZ,US,12,424
OUTLANDER 1000,2019-07-15,11,9,AZ,US,20,418
OUTLANDER 850,2019-07-15,9,9,AZ,US,18,443
OUTLANDER 450,2019-07-15,5,2,AZ,US,7,431
OUTLANDER 1000,2019-07-22,5,10,AZ,US,15,433
OUTLANDER 850,2019-07-22,11,7,AZ,US,18,461
OUTLANDER 450,2019-07-22,11,14,AZ,US,25,456
OUTLANDER 1000,2019-07-29,1,10,AZ,US,11,444
OUTLANDER 850,2019-07-29,10,13,AZ,US,23,484
OUTLANDER 450,2019-07-29,11,11,AZ,US,22,478
OUTLANDER 1000,2019-08-05,13,13,AZ,US,26,470
OUTLANDER 850,2019-08-05,7,3,AZ,US,10,494
OUTLANDER 450,2019-08-05,3,12,AZ,US,15,493
OUTLANDER 1000,2019-08-12,14,9,AZ,US,23,493
OUTLANDER 850,2019-08-12,1,11,AZ,US,12,506
OUTLANDER 450,2019-08-12,10,4,AZ,US,14,507
OUTLANDER 1000,2019-08-19,12,7,AZ,US,19,512
OUTLANDER 850,2019-08-19,10,3,AZ,US,13,519
OUTLANDER 450,2019-08-19,4,11,AZ,US,15,522
OUTLANDER 1000,2019-08-26,2,7,AZ,US,9,521
OUTLANDER 850,2019-08-26,0,11,AZ,US,11,530
OUTLANDER 450,2019-08-26,6,11,AZ,US,17,539
OUTLANDER 1000,2019-09-02,3,14,AZ,US,17,538
OUTLANDER 850,2019-09-02,8,1,AZ,US,9,539
OUTLANDER 450,2019-09-02,9,14,AZ,US,23,562
OUTLANDER 1000,2019-09-09,10,10,AZ,US,20,558
OUTLANDER 850,2019-09-09,14,11,AZ,US,25,564
OUTLANDER 450,2019-09-09,14,6,AZ,US,20,582
OUTLANDER 1000,2019-09-16,1,2,AZ,US,3,561
OUTLANDER 850,2019-09-16,3,13,AZ,US,16,580
OUTLANDER 450,2019-09-16,10,7,AZ,US,17,599
OUTLANDER 1000,2019-09-23,10,8,AZ,US,18,579
OUTLANDER 850,2019-09-23,4,13,AZ,US,17,597
OUTLANDER 450,2019-09-23,1,10,AZ,US,11,610
OUTLANDER 1000,2019-09-30,5,9,AZ,US,14,593
OUTLANDER 850,2019-09-30,0,8,AZ,US,8,605
OUTLANDER 450,2019-09-30,10,2,AZ,US,12,622
OUTLANDER 1000,2019-10-07,14,5,AZ,US,19,612
OUTLANDER 850,2019-10-07,7,11,AZ,US,18,623
OUTLANDER 450,2019-10-07,7,12,AZ,US,19,641
OUTLANDER 1000,2019-10-14,8,12,AZ,US,20,632
OUTLANDER 850,2019-10-14,5,5,AZ,US,10,633
OUTLANDER 450,2019-10-14,2,6,AZ,US,8,649
OUTLANDER 1000,2019-10-21,6,11,AZ,US,17,649
OUTLANDER 850,2019-10-21,12,11,AZ,US,23,656
OUTLANDER 450,2019-10-21,8,11,AZ,US,19,668
OUTLANDER 1000,2019-10-28,0,14,AZ,US,14,663
OUTLANDER 850,2019-10-28,3,12,AZ,US,15,671
OUTLANDER 450,2019-10-28,12,12,AZ,US,24,692
OUTLANDER 1000,2019-11-04,13,2,AZ,US,15,678
OUTLANDER 850,2019-11-04,14,7,AZ,US,21,692
OUTLANDER 450,2019-11-04,9,11,AZ,US,20,712
OUTLANDER 1000,2019-11-11,3,9,AZ,US,12,690
OUTLANDER 850,2019-11-11,2,1,AZ,US,3,695
OUTLANDER 450,2019-11-11,12,13,AZ,US,25,737
OUTLANDER 1000,2019-11-18,9,11,AZ,US,20,710
OUTLANDER 850,2019-11-18,1,15,AZ,US,16,711
OUTLANDER 450,2019-11-18,8,1,AZ,US,9,746
OUTLANDER 1000,2019-11-25,10,11,AZ,US,21,731
OUTLANDER 850,2019-11-25,4,11,AZ,US,15,726
OUTLANDER 450,2019-11-25,1,14,AZ,US,15,761
OUTLANDER 1000,2019-12-02,5,13,AZ,US,18,749
OUTLANDER 850,2019-12-02,6,11,AZ,US,17,743
OUTLANDER 450,2019-12-02,11,10,AZ,US,21,782
OUTLANDER 1000,2019-12-09,10,14,AZ,US,24,773
OUTLANDER 850,2019-12-09,6,9,AZ,US,15,758
OUTLANDER 450,2019-12-09,7,9,AZ,US,16,798
OUTLANDER 1000,2019-12-16,5,4,AZ,US,9,782
OUTLANDER 850,2019-12-16,11,13,AZ,US,24,782
OUTLANDER 450,2019-12-16,9,8,AZ,US,17,815
OUTLANDER 1000,2019-12-23,3,2,AZ,US,5,787
OUTLANDER 850,2019-12-23,8,12,AZ,US,20,802
OUTLANDER 450,2019-12-23,4,14,AZ,US,18,833
OUTLANDER 1000,2019-12-30,1,11,AZ,US,12,799
OUTLANDER 850,2019-12-30,9,4,AZ,US,13,815
OUTLANDER 450,2019-12-30,13,15,AZ,US,28,861
OUTLANDER 1000,2020-01-06,13,9,AZ,US,22,821
OUTLANDER 850,2020-01-06,15,0,AZ,US,15,830
OUTLANDER 450,2020-01-06,4,13,AZ,US,17,878
OUTLANDER 1000,2020-01-13,7,5,AZ,US,12,833
OUTLANDER 850,2020-01-13,10,3,AZ,US,13,843
OUTLANDER 450,2020-01-13,10,10,AZ,US,20,898
OUTLANDER 1000,2020-01-20,9,11,AZ,US,20,853
OUTLANDER 850,2020-01-20,3,14,AZ,US,17,860
OUTLANDER 450,2020-01-20,7,10,AZ,US,17,915
OUTLANDER 1000,2020-01-27,6,13,AZ,US,19,872
OUTLANDER 850,2020-01-27,11,11,AZ,US,22,882
OUTLANDER 450,2020-01-27,3,10,AZ,US,13,928
OUTLANDER 1000,2020-02-03,6,14,AZ,US,20,892
OUTLANDER 850,2020-02-03,5,8,AZ,US,13,895
OUTLANDER 450,2020-02-03,8,8,AZ,US,16,944
OUTLANDER 1000,2020-02-10,11,10,AZ,US,21,913
OUTLANDER 850,2020-02-10,15,13,AZ,US,28,923
OUTLANDER 450,2020-02-10,2,6,AZ,US,8,952
OUTLANDER 1000,2020-02-17,2,7,AZ,US,9,922
OUTLANDER 850,2020-02-17,10,3,AZ,US,13,936
OUTLANDER 450,2020-02-17,1,6,AZ,US,7,959
OUTLANDER 1000,2020-02-24,6,1,AZ,US,7,929
OUTLANDER 850,2020-02-24,1,9,AZ,US,10,946
OUTLANDER 450,2020-02-24,11,1,AZ,US,12,971
OUTLANDER 1000,2020-03-02,13,7,AZ,US,20,949
OUTLANDER 850,2020-03-02,9,12,AZ,US,21,967
OUTLANDER 450,2020-03-02,12,15,AZ,US,27,998
OUTLANDER 1000,2020-03-09,3,1,AZ,US,4,953
OUTLANDER 850,2020-03-09,4,11,AZ,US,15,982
OUTLANDER 450,2020-03-09,5,12,AZ,US,17,1015
OUTLANDER 1000,2020-03-16,1,8,AZ,US,9,962
OUTLANDER 850,2020-03-16,1,11,AZ,US,12,994
OUTLANDER 450,2020-03-16,4,10,AZ,US,14,1029
OUTLANDER 1000,2020-03-23,3,15,AZ,US,18,980
OUTLANDER 850,2020-03-23,12,13,AZ,US,25,1019
OUTLANDER 450,2020-03-23,4,8,AZ,US,12,1041
OUTLANDER 1000,2020-03-30,7,1,AZ,US,8,988
OUTLANDER 850,2020-03-30,14,1,AZ,US,15,1034
OUTLANDER 450,2020-03-30,14,9,AZ,US,23,1064
OUTLANDER 1000,2020-04-06,13,5,AZ,US,18,1006
OUTLANDER 850,2020-04-06,0,8,AZ,US,8,1042
OUTLANDER 450,2020-04-06,7,6,AZ,US,13,1077
OUTLANDER 1000,2020-04-13,10,4,AZ,US,14,1020
OUTLANDER 850,2020-04-13,9,1,AZ,US,10,1052
OUTLANDER 450,2020-04-13,0,12,AZ,US,12,1089
OUTLANDER 1000,2020-04-20,13,2,AZ,US,15,1035
OUTLANDER 850,2020-04-20,4,0,AZ,US,4,1056
OUTLANDER 450,2020-04-20,12,5,AZ,US,17,1106
OUTLANDER 1000,2020-04-27,12,6,AZ,US,18,1053
OUTLANDER 850,2020-04-27,9,11,AZ,US,20,1076
OUTLANDER 450,2020-04-27,10,15,AZ,US,25,1131
OUTLANDER 1000,2020-05-04,11,11,AZ,US,22,1075
OUTLANDER 850,2020-05-04,13,12,AZ,US,25,1101
OUTLANDER 450,2020-05-04,11,1,AZ,US,12,1143
OUTLANDER 1000,2020-05-11,9,13,AZ,US,22,1097
OUTLANDER 850,2020-05-11,1,4,AZ,US,5,1106
OUTLANDER 450,2020-05-11,14,13,AZ,US,27,1170
OUTLANDER 1000,2020-05-18,13,3,AZ,US,16,1113
OUTLANDER 850,2020-05-18,10,10,AZ,US,20,1126
OUTLANDER 450,2020-05-18,11,15,AZ,US,26,1196
OUTLANDER 1000,2020-05-25,2,3,AZ,US,5,1118
OUTLANDER 850,2020-05-25,11,11,AZ,US,22,1148
OUTLANDER 450,2020-05-25,12,2,AZ,US,14,1210
OUTLANDER 1000,2020-06-01,7,2,AZ,US,9,1127
OUTLANDER 850,2020-06-01,13,10,AZ,US,23,1171
OUTLANDER 450,2020-06-01,2,3,AZ,US,5,1215
OUTLANDER 1000,2020-06-08,2,5,AZ,US,7,1134
OUTLANDER 850,2020-06-08,12,2,AZ,US,14,1185
OUTLANDER 450,2020-06-08,4,4,AZ,US,8,1223
OUTLANDER 1000,2020-06-15,14,8,AZ,US,22,1156
OUTLANDER 850,2020-06-15,2,6,AZ,US,8,1193
OUTLANDER 450,2020-06-15,15,1,AZ,US,16,1239
OUTLANDER 1000,2020-06-22,12,10,AZ,US,22,1178
OUTLANDER 850,2020-06-22,12,7,AZ,US,19,1212
OUTLANDER 450,2020-06-22,7,5,AZ,US,12,1251
OUTLANDER 1000,2020-06-29,14,8,AZ,US,22,1200
OUTLANDER 850,2020-06-29,7,6,AZ,US,13,1225
OUTLANDER 450,2020-06-29,4,12,AZ,US,16,1267
OUTLANDER 1000,2020-07-06,12,8,AZ,US,20,1220
OUTLANDER 850,2020-07-06,5,13,AZ,US,18,1243
OUTLANDER 450,2020-07-06,2,7,AZ,US,9,1276
OUTLANDER 1000,2020-07-13,8,0,AZ,US,8,1228
OUTLANDER 850,2020-07-13,11,14,AZ,US,25,1268
OUTLANDER 450,2020-07-13,2,2,AZ,US,4,1280
OUTLANDER 1000,2020-07-20,4,9,AZ,US,13,1241
OUTLANDER 850,2020-07-20,2,5,AZ,US,7,1275
OUTLANDER 450,2020-07-20,13,1,AZ,US,14,1294
OUTLANDER 1000,2020-07-27,12,7,AZ,US,19,1260
OUTLANDER 850,2020-07-27,5,3,AZ,US,8,1283
OUTLANDER 450,2020-07-27,6,7,AZ,US,13,1307
OUTLANDER 1000,2020-08-03,7,10,AZ,US,17,1277
OUTLANDER 850,2020-08-03,11,10,AZ,US,21,1304
OUTLANDER 450,2020-08-03,6,5,AZ,US,11,1318
OUTLANDER 1000,2020-08-10,4,12,AZ,US,16,1293
OUTLANDER 850,2020-08-10,15,15,AZ,US,30,1334
OUTLANDER 450,2020-08-10,4,8,AZ,US,12,1330
OUTLANDER 1000,2020-08-17,5,3,AZ,US,8,1301
OUTLANDER 850,2020-08-17,5,4,AZ,US,9,1343
OUTLANDER 450,2020-08-17,5,6,AZ,US,11,1341
OUTLANDER 1000,2020-08-24,14,4,AZ,US,18,1319
OUTLANDER 850,2020-08-24,1,11,AZ,US,12,1355
OUTLANDER 450,2020-08-24,4,11,AZ,US,15,1356
OUTLANDER 1000,2020-08-31,12,7,AZ,US,19,1338
OUTLANDER 850,2020-08-31,10,7,AZ,US,17,1372
OUTLANDER 450,2020-08-31,9,10,AZ,US,19,1375
OUTLANDER 1000,2020-09-07,8,14,AZ,US,22,1360
OUTLANDER 850,2020-09-07,2,12,AZ,US,14,1386
OUTLANDER 450,2020-09-07,1,8,AZ,US,9,1384
OUTLANDER 1000,2020-09-14,7,14,AZ,US,21,1381
OUTLANDER 850,2020-09-14,5,5,AZ,US,10,1396
OUTLANDER 450,2020-09-14,1,3,AZ,US,4,1388
OUTLANDER 1000,2020-09-21,7,2,AZ,US,9,1390
OUTLANDER 850,2020-09-21,10,13,AZ,US,23,1419
OUTLANDER 450,2020-09-21,1,1,AZ,US,2,1390
OUTLANDER 1000,2020-09-28,13,6,AZ,US,19,1409
OUTLANDER 850,2020-09-28,13,8,AZ,US,21,1440
OUTLANDER 450,2020-09-28,3,1,AZ,US,4,1394
OUTLANDER 1000,2020-10-05,1,3,AZ,US,4,1413
OUTLANDER 850,2020-10-05,10,5,AZ,US,15,1455
OUTLANDER 450,2020-10-05,13,1,AZ,US,14,1408
OUTLANDER 1000,2020-10-12,12,5,AZ,US,17,1430
OUTLANDER 850,2020-10-12,2,10,AZ,US,12,1467
OUTLANDER 450,2020-10-12,12,1,AZ,US,13,1421
OUTLANDER 1000,2020-10-19,11,11,AZ,US,22,1452
OUTLANDER 850,2020-10-19,7,15,AZ,US,22,1489
OUTLANDER 450,2020-10-19,5,11,AZ,US,16,1437
OUTLANDER 1000,2020-10-26,12,0,AZ,US,12,1464
OUTLANDER 850,2020-10-26,11,11,AZ,US,22,1511
OUTLANDER 450,2020-10-26,11,12,AZ,US,23,1460
OUTLANDER 1000,2020-11-02,7,11,AZ,US,18,1482
OUTLANDER 850,2020-11-02,5,13,AZ,US,18,1529
OUTLANDER 450,2020-11-02,12,13,AZ,US,25,1485
OUTLANDER 1000,2020-11-09,4,13,AZ,US,17,1499
OUTLANDER 850,2020-11-09,15,6,AZ,US,21,1550
OUTLANDER 450,2020-11-09,14,7,AZ,US,21,1506
OUTLANDER 1000,2020-11-16,8,0,AZ,US,8,1507
OUTLANDER 850,2020-11-16,12,12,AZ,US,24,1574
OUTLANDER 450,2020-11-16,14,4,AZ,US,18,1524
OUTLANDER 1000,2020-11-23,6,7,AZ,US,13,1520
OUTLANDER 850,2020-11-23,11,8,AZ,US,19,1593
OUTLANDER 450,2020-11-23,4,9,AZ,US,13,1537
OUTLANDER 1000,2020-11-30,7,10,AZ,US,17,1537
OUTLANDER 850,2020-11-30,5,11,AZ,US,16,1609
OUTLANDER 450,2020-11-30,13,7,AZ,US,20,1557
OUTLANDER 1000,2020-12-07,9,13,AZ,US,22,1559
OUTLANDER 850,2020-12-07,2,4,AZ,US,6,1615
OUTLANDER 450,2020-12-07,15,15,AZ,US,30,1587
OUTLANDER 1000,2020-12-14,1,3,AZ,US,4,1563
OUTLANDER 850,2020-12-14,8,3,AZ,US,11,1626
OUTLANDER 450,2020-12-14,11,13,AZ,US,24,1611
OUTLANDER 1000,2020-12-21,13,6,AZ,US,19,1582
OUTLANDER 850,2020-12-21,15,2,AZ,US,17,1643
OUTLANDER 450,2020-12-21,14,6,AZ,US,20,1631
OUTLANDER 1000,2020-12-28,12,7,AZ,US,19,1601
OUTLANDER 850,2020-12-28,10,5,AZ,US,15,1658
OUTLANDER 450,2020-12-28,13,7,AZ,US,20,1651
OUTLANDER 1000,2021-01-04,4,11,AZ,US,15,1616
OUTLANDER 850,2021-01-04,0,10,AZ,US,10,1668
OUTLANDER 450,2021-01-04,6,9,AZ,US,15,1666
OUTLANDER 1000,2021-01-11,12,8,AZ,US,20,1636
OUTLANDER 850,2021-01-11,5,10,AZ,US,15,1683
OUTLANDER 450,2021-01-11,3,5,AZ,US,8,1674
OUTLANDER 1000,2021-01-18,12,3,AZ,US,15,1651
OUTLANDER 850,2021-01-18,7,12,AZ,US,19,1702
OUTLANDER 450,2021-01-18,0,5,AZ,US,5,1679
OUTLANDER 1000,2021-01-25,13,4,AZ,US,17,1668
OUTLANDER 850,2021-01-25,14,8,AZ,US,22,1724
OUTLANDER 450,2021-01-25,4,5,AZ,US,9,1688
OUTLANDER 1000,2021-02-01,11,2,AZ,US,13,1681
OUTLANDER 850,2021-02-01,10,2,AZ,US,12,1736
OUTLANDER 450,2021-02-01,3,12,AZ,US,15,1703
OUTLANDER 1000,2021-02-08,10,12,AZ,US,22,1703
OUTLANDER 850,2021-02-08,12,1,AZ,US,13,1749
OUTLANDER 450,2021-02-08,2,12,AZ,US,14,1717
OUTLANDER 1000,2021-02-15,9,0,AZ,US,9,1712
OUTLANDER 850,2021-02-15,15,1,AZ,US,16,1765
OUTLANDER 450,2021-02-15,13,10,AZ,US,23,1740
OUTLANDER 1000,2021-02-22,2,7,AZ,US,9,1721
OUTLANDER 850,2021-02-22,12,11,AZ,US,23,1788
OUTLANDER 450,2021-02-22,8,6,AZ,US,14,1754
OUTLANDER 1000,2021-03-01,12,7,AZ,US,19,1740
OUTLANDER 850,2021-03-01,10,5,AZ,US,15,1803
OUTLANDER 450,2021-03-01,1,4,AZ,US,5,1759
OUTLANDER 1000,2021-03-08,5,0,AZ,US,5,1745
OUTLANDER 850,2021-03-08,12,6,AZ,US,18,1821
OUTLANDER 450,2021-03-08,1,1,AZ,US,2,1761
OUTLANDER 1000,2021-03-15,14,5,AZ,US,19,1764
OUTLANDER 850,2021-03-15,3,6,AZ,US,9,1830
OUTLANDER 450,2021-03-15,6,4,AZ,US,10,1771
OUTLANDER 1000,2021-03-22,9,3,AZ,US,12,1776
OUTLANDER 850,2021-03-22,7,11,AZ,US,18,1848
OUTLANDER 450,2021-03-22,11,3,AZ,US,14,1785
OUTLANDER 1000,2021-03-29,5,11,AZ,US,16,1792
OUTLANDER 850,2021-03-29,13,11,AZ,US,24,1872
OUTLANDER 450,2021-03-29,4,11,AZ,US,15,1800
OUTLANDER 1000,2021-04-05,8,14,AZ,US,22,1814
OUTLANDER 850,2021-04-05,5,10,AZ,US,15,1887
OUTLANDER 450,2021-04-05,12,7,AZ,US,19,1819
OUTLANDER 1000,2021-04-12,8,8,AZ,US,16,1830
OUTLANDER 850,2021-04-12,2,4,AZ,US,6,1893
OUTLANDER 450,2021-04-12,14,3,AZ,US,17,1836
OUTLANDER 1000,2021-04-19,4,12,AZ,US,16,1846
OUTLANDER 850,2021-04-19,2,7,AZ,US,9,1902
OUTLANDER 450,2021-04-19,10,3,AZ,US,13,1849
OUTLANDER 1000,2021-04-26,0,7,AZ,US,7,1853
OUTLANDER 850,2021-04-26,1,14,AZ,US,15,1917
OUTLANDER 450,2021-04-26,4,7,AZ,US,11,1860
OUTLANDER 1000,2021-05-03,5,9,AZ,US,14,1867
OUTLANDER 850,2021-05-03,10,13,AZ,US,23,1940
OUTLANDER 450,2021-05-03,11,5,AZ,US,16,1876
OUTLANDER 1000,2021-05-10,0,4,AZ,US,4,1871
OUTLANDER 850,2021-05-10,7,1,AZ,US,8,1948
OUTLANDER 450,2021-05-10,2,14,AZ,US,16,1892
OUTLANDER 1000,2021-05-17,3,5,AZ,US,8,1879
OUTLANDER 850,2021-05-17,7,7,AZ,US,14,1962
OUTLANDER 450,2021-05-17,0,12,AZ,US,12,1904
OUTLANDER 1000,2021-05-24,9,7,AZ,US,16,1895
OUTLANDER 850,2021-05-24,9,2,AZ,US,11,1973
OUTLANDER 450,2021-05-24,4,0,AZ,US,4,1908
OUTLANDER 1000,2021-05-31,6,2,AZ,US,8,1903
OUTLANDER 850,2021-05-31,6,3,AZ,US,9,1982
OUTLANDER 450,2021-05-31,0,5,AZ,US,5,1913
OUTLANDER 1000,2021-06-07,1,12,AZ,US,13,1916
OUTLANDER 850,2021-06-07,4,8,AZ,US,12,1994
OUTLANDER 450,2021-06-07,10,14,AZ,US,24,1937
OUTLANDER 1000,2021-06-14,13,1,AZ,US,14,1930
OUTLANDER 850,2021-06-14,10,7,AZ,US,17,2011
OUTLANDER 450,2021-06-14,12,3,AZ,US,15,1952
OUTLANDER 1000,2021-06-21,5,5,AZ,US,10,1940
OUTLANDER 850,2021-06-21,5,1,AZ,US,6,2017
OUTLANDER 450,2021-06-21,6,15,AZ,US,21,1973
OUTLANDER 1000,2021-06-28,13,15,AZ,US,28,1968
OUTLANDER 850,2021-06-28,6,1,AZ,US,7,2024
OUTLANDER 450,2021-06-28,12,5,AZ,US,17,1990
OUTLANDER 1000,2021-07-05,8,3,AZ,US,11,1979
OUTLANDER 850,2021-07-05,0,5,AZ,US,5,2029
OUTLANDER 450,2021-07-05,1,8,AZ,US,9,1999
OUTLANDER 1000,2021-07-12,1,8,AZ,US,9,1988
OUTLANDER 850,2021-07-12,6,15,AZ,US,21,2050
OUTLANDER 450,2021-07-12,10,11,AZ,US,21,2020
OUTLANDER 1000,2021-07-19,2,2,AZ,US,4,1992
OUTLANDER 850,2021-07-19,3,2,AZ,US,5,2055
OUTLANDER 450,2021-07-19,2,1,AZ,US,3,2023
OUTLANDER 1000,2021-07-26,4,5,AZ,US,9,2001
OUTLANDER 850,2021-07-26,0,4,AZ,US,4,2059
OUTLANDER 450,2021-07-26,7,4,AZ,US,11,2034
OUTLANDER 1000,2021-08-02,9,8,AZ,US,17,2018
OUTLANDER 850,2021-08-02,2,6,AZ,US,8,2067
OUTLANDER 450,2021-08-02,9,2,AZ,US,11,2045
OUTLANDER 1000,2021-08-09,12,9,AZ,US,21,2039
OUTLANDER 850,2021-08-09,10,11,AZ,US,21,2088
OUTLANDER 450,2021-08-09,9,5,AZ,US,14,2059
OUTLANDER 1000,2021-08-16,14,8,AZ,US,22,2061
OUTLANDER 850,2021-08-16,12,8,AZ,US,20,2108
OUTLANDER 450,2021-08-16,15,15,AZ,US,30,2089
OUTLANDER 1000,2021-08-23,12,10,AZ,US,22,2083
OUTLANDER 850,2021-08-23,7,11,AZ,US,18,2126
OUTLANDER 450,2021-08-23,9,10,AZ,US,19,2108
OUTLANDER 1000,2021-08-30,7,8,AZ,US,15,2098
OUTLANDER 850,2021-08-30,1,3,AZ,US,4,2130
OUTLANDER 450,2021-08-30,8,7,AZ,US,15,2123
OUTLANDER 1000,2021-09-06,7,1,AZ,US,8,2106
OUTLANDER 850,2021-09-06,15,10,AZ,US,25,2155
OUTLANDER 450,2021-09-06,5,13,AZ,US,18,2141
OUTLANDER 1000,2021-09-13,11,5,AZ,US,16,2122
OUTLANDER 850,2021-09-13,15,11,AZ,US,26,2181
OUTLANDER 450,2021-09-13,12,4,AZ,US,16,2157
OUTLANDER 1000,2021-09-20,4,15,AZ,US,19,2141
OUTLANDER 850,2021-09-20,8,4,AZ,US,12,2193
OUTLANDER 450,2021-09-20,1,11,AZ,US,12,2169
OUTLANDER 1000,2021-09-27,6,1,AZ,US,7,2148
OUTLANDER 850,2021-09-27,7,11,AZ,US,18,2211
OUTLANDER 450,2021-09-27,9,2,AZ,US,11,2180
OUTLANDER 1000,2021-10-04,14,12,AZ,US,26,2174
OUTLANDER 850,2021-10-04,10,7,AZ,US,17,2228
OUTLANDER 450,2021-10-04,5,2,AZ,US,7,2187
OUTLANDER 1000,2021-10-11,4,2,AZ,US,6,2180
OUTLANDER 850,2021-10-11,8,4,AZ,US,12,2240
OUTLANDER 450,2021-10-11,6,5,AZ,US,11,2198
OUTLANDER 1000,2021-10-18,13,13,AZ,US,26,2206
OUTLANDER 850,2021-10-18,14,2,AZ,US,16,2256
OUTLANDER 450,2021-10-18,6,5,AZ,US,11,2209
OUTLANDER 1000,2021-10-25,4,7,AZ,US,11,2217
OUTLANDER 850,2021-10-25,0,8,AZ,US,8,2264
OUTLANDER 450,2021-10-25,1,8,AZ,US,9,2218
OUTLANDER 1000,2021-11-01,4,4,AZ,US,8,2225
OUTLANDER 850,2021-11-01,5,13,AZ,US,18,2282
OUTLANDER 450,2021-11-01,6,5,AZ,US,11,2229
OUTLANDER 1000,2021-11-08,12,14,AZ,US,26,2251
OUTLANDER 850,2021-11-08,10,10,AZ,US,20,2302
OUTLANDER 450,2021-11-08,8,14,AZ,US,22,2251
OUTLANDER 1000,2021-11-15,10,13,AZ,US,23,2274
OUTLANDER 850,2021-11-15,10,6,AZ,US,16,2318
OUTLANDER 450,2021-11-15,3,10,AZ,US,13,2264
OUTLANDER 1000,2021-11-22,2,14,AZ,US,16,2290
OUTLANDER 850,2021-11-22,12,5,AZ,US,17,2335
OUTLANDER 450,2021-11-22,11,12,AZ,US,23,2287
OUTLANDER 1000,2021-11-29,8,7,AZ,US,15,2305
OUTLANDER 850,2021-11-29,15,11,AZ,US,26,2361
OUTLANDER 450,2021-11-29,0,12,AZ,US,12,2299
OUTLANDER 1000,2021-12-06,0,5,AZ,US,5,2310
OUTLANDER 850,2021-12-06,12,6,AZ,US,18,2379
OUTLANDER 450,2021-12-06,14,0,AZ,US,14,2313
OUTLANDER 1000,2021-12-13,12,6,AZ,US,18,2328
OUTLANDER 850,2021-12-13,8,6,AZ,US,14,2393
OUTLANDER 450,2021-12-13,6,11,AZ,US,17,2330
OUTLANDER 1000,2021-12-20,12,6,AZ,US,18,2346
OUTLANDER 850,2021-12-20,6,4,AZ,US,10,2403
OUTLANDER 450,2021-12-20,8,7,AZ,US,15,2345
OUTLANDER 1000,2021-12-27,14,5,AZ,US,19,2365
OUTLANDER 850,2021-12-27,9,10,AZ,US,19,2422
OUTLANDER 450,2021-12-27,1,11,AZ,US,12,2357
OUTLANDER 1000,2019-01-07,3,6,AR,US,9,9
OUTLANDER 850,2019-01-07,0,15,AR,US,15,15
OUTLANDER 450,2019-01-07,0,8,AR,US,8,8
OUTLANDER 1000,2019-01-14,1,13,AR,US,14,23
OUTLANDER 850,2019-01-14,0,15,AR,US,15,30
OUTLANDER 450,2019-01-14,11,13,AR,US,24,32
OUTLANDER 1000,2019-01-21,2,10,AR,US,12,35
OUTLANDER 850,2019-01-21,13,5,AR,US,18,48
OUTLANDER 450,2019-01-21,7,2,AR,US,9,41
OUTLANDER 1000,2019-01-28,2,12,AR,US,14,49
OUTLANDER 850,2019-01-28,5,12,AR,US,17,65
OUTLANDER 450,2019-01-28,2,14,AR,US,16,57
OUTLANDER 1000,2019-02-04,15,14,AR,US,29,78
OUTLANDER 850,2019-02-04,2,11,AR,US,13,78
OUTLANDER 450,2019-02-04,5,3,AR,US,8,65
OUTLANDER 1000,2019-02-11,15,11,AR,US,26,104
OUTLANDER 850,2019-02-11,14,5,AR,US,19,97
OUTLANDER 450,2019-02-11,12,14,AR,US,26,91
OUTLANDER 1000,2019-02-18,11,4,AR,US,15,119
OUTLANDER 850,2019-02-18,11,11,AR,US,22,119
OUTLANDER 450,2019-02-18,10,4,AR,US,14,105
OUTLANDER 1000,2019-02-25,8,11,AR,US,19,138
OUTLANDER 850,2019-02-25,1,1,AR,US,2,121
OUTLANDER 450,2019-02-25,5,3,AR,US,8,113
OUTLANDER 1000,2019-03-04,14,9,AR,US,23,161
OUTLANDER 850,2019-03-04,12,1,AR,US,13,134
OUTLANDER 450,2019-03-04,1,13,AR,US,14,127
OUTLANDER 1000,2019-03-11,5,4,AR,US,9,170
OUTLANDER 850,2019-03-11,8,1,AR,US,9,143
OUTLANDER 450,2019-03-11,1,8,AR,US,9,136
OUTLANDER 1000,2019-03-18,12,13,AR,US,25,195
OUTLANDER 850,2019-03-18,7,10,AR,US,17,160
OUTLANDER 450,2019-03-18,11,9,AR,US,20,156
OUTLANDER 1000,2019-03-25,5,2,AR,US,7,202
OUTLANDER 850,2019-03-25,13,14,AR,US,27,187
OUTLANDER 450,2019-03-25,2,2,AR,US,4,160
OUTLANDER 1000,2019-04-01,8,11,AR,US,19,221
OUTLANDER 850,2019-04-01,12,7,AR,US,19,206
OUTLANDER 450,2019-04-01,0,2,AR,US,2,162
OUTLANDER 1000,2019-04-08,6,2,AR,US,8,229
OUTLANDER 850,2019-04-08,1,6,AR,US,7,213
OUTLANDER 450,2019-04-08,13,2,AR,US,15,177
OUTLANDER 1000,2019-04-15,1,11,AR,US,12,241
OUTLANDER 850,2019-04-15,3,12,AR,US,15,228
OUTLANDER 450,2019-04-15,4,6,AR,US,10,187
OUTLANDER 1000,2019-04-22,11,4,AR,US,15,256
OUTLANDER 850,2019-04-22,3,2,AR,US,5,233
OUTLANDER 450,2019-04-22,11,12,AR,US,23,210
OUTLANDER 1000,2019-04-29,10,8,AR,US,18,274
OUTLANDER 850,2019-04-29,6,10,AR,US,16,249
OUTLANDER 450,2019-04-29,6,9,AR,US,15,225
OUTLANDER 1000,2019-05-06,5,1,AR,US,6,280
OUTLANDER 850,2019-05-06,3,1,AR,US,4,253
OUTLANDER 450,2019-05-06,4,6,AR,US,10,235
OUTLANDER 1000,2019-05-13,13,5,AR,US,18,298
OUTLANDER 850,2019-05-13,1,4,AR,US,5,258
OUTLANDER 450,2019-05-13,7,7,AR,US,14,249
OUTLANDER 1000,2019-05-20,1,12,AR,US,13,311
OUTLANDER 850,2019-05-20,8,2,AR,US,10,268
OUTLANDER 450,2019-05-20,5,13,AR,US,18,267
OUTLANDER 1000,2019-05-27,10,10,AR,US,20,331
OUTLANDER 850,2019-05-27,4,11,AR,US,15,283
OUTLANDER 450,2019-05-27,12,7,AR,US,19,286
OUTLANDER 1000,2019-06-03,7,15,AR,US,22,353
OUTLANDER 850,2019-06-03,2,15,AR,US,17,300
OUTLANDER 450,2019-06-03,12,8,AR,US,20,306
OUTLANDER 1000,2019-06-10,12,7,AR,US,19,372
OUTLANDER 850,2019-06-10,8,8,AR,US,16,316
OUTLANDER 450,2019-06-10,0,6,AR,US,6,312
OUTLANDER 1000,2019-06-17,9,13,AR,US,22,394
OUTLANDER 850,2019-06-17,8,0,AR,US,8,324
OUTLANDER 450,2019-06-17,12,5,AR,US,17,329
OUTLANDER 1000,2019-06-24,3,2,AR,US,5,399
OUTLANDER 850,2019-06-24,10,12,AR,US,22,346
OUTLANDER 450,2019-06-24,7,10,AR,US,17,346
OUTLANDER 1000,2019-07-01,9,13,AR,US,22,421
OUTLANDER 850,2019-07-01,13,3,AR,US,16,362
OUTLANDER 450,2019-07-01,11,6,AR,US,17,363
OUTLANDER 1000,2019-07-08,7,7,AR,US,14,435
OUTLANDER 850,2019-07-08,9,10,AR,US,19,381
OUTLANDER 450,2019-07-08,7,8,AR,US,15,378
OUTLANDER 1000,2019-07-15,2,11,AR,US,13,448
OUTLANDER 850,2019-07-15,1,9,AR,US,10,391
OUTLANDER 450,2019-07-15,9,10,AR,US,19,397
OUTLANDER 1000,2019-07-22,4,13,AR,US,17,465
OUTLANDER 850,2019-07-22,15,10,AR,US,25,416
OUTLANDER 450,2019-07-22,2,5,AR,US,7,404
OUTLANDER 1000,2019-07-29,13,10,AR,US,23,488
OUTLANDER 850,2019-07-29,12,11,AR,US,23,439
OUTLANDER 450,2019-07-29,12,6,AR,US,18,422
OUTLANDER 1000,2019-08-05,5,3,AR,US,8,496
OUTLANDER 850,2019-08-05,3,12,AR,US,15,454
OUTLANDER 450,2019-08-05,2,7,AR,US,9,431
OUTLANDER 1000,2019-08-12,9,8,AR,US,17,513
OUTLANDER 850,2019-08-12,1,2,AR,US,3,457
OUTLANDER 450,2019-08-12,6,15,AR,US,21,452
OUTLANDER 1000,2019-08-19,3,8,AR,US,11,524
OUTLANDER 850,2019-08-19,2,5,AR,US,7,464
OUTLANDER 450,2019-08-19,11,3,AR,US,14,466
OUTLANDER 1000,2019-08-26,12,5,AR,US,17,541
OUTLANDER 850,2019-08-26,6,5,AR,US,11,475
OUTLANDER 450,2019-08-26,14,6,AR,US,20,486
OUTLANDER 1000,2019-09-02,8,12,AR,US,20,561
OUTLANDER 850,2019-09-02,3,2,AR,US,5,480
OUTLANDER 450,2019-09-02,4,2,AR,US,6,492
OUTLANDER 1000,2019-09-09,12,3,AR,US,15,576
OUTLANDER 850,2019-09-09,9,5,AR,US,14,494
OUTLANDER 450,2019-09-09,5,2,AR,US,7,499
OUTLANDER 1000,2019-09-16,5,14,AR,US,19,595
OUTLANDER 850,2019-09-16,2,7,AR,US,9,503
OUTLANDER 450,2019-09-16,2,6,AR,US,8,507
OUTLANDER 1000,2019-09-23,11,6,AR,US,17,612
OUTLANDER 850,2019-09-23,11,14,AR,US,25,528
OUTLANDER 450,2019-09-23,11,9,AR,US,20,527
OUTLANDER 1000,2019-09-30,13,2,AR,US,15,627
OUTLANDER 850,2019-09-30,6,8,AR,US,14,542
OUTLANDER 450,2019-09-30,0,5,AR,US,5,532
OUTLANDER 1000,2019-10-07,15,1,AR,US,16,643
OUTLANDER 850,2019-10-07,5,4,AR,US,9,551
OUTLANDER 450,2019-10-07,5,10,AR,US,15,547
OUTLANDER 1000,2019-10-14,12,5,AR,US,17,660
OUTLANDER 850,2019-10-14,13,12,AR,US,25,576
OUTLANDER 450,2019-10-14,0,1,AR,US,1,548
OUTLANDER 1000,2019-10-21,4,1,AR,US,5,665
OUTLANDER 850,2019-10-21,1,13,AR,US,14,590
OUTLANDER 450,2019-10-21,5,11,AR,US,16,564
OUTLANDER 1000,2019-10-28,3,10,AR,US,13,678
OUTLANDER 850,2019-10-28,8,1,AR,US,9,599
OUTLANDER 450,2019-10-28,1,5,AR,US,6,570
OUTLANDER 1000,2019-11-04,12,15,AR,US,27,705
OUTLANDER 850,2019-11-04,2,14,AR,US,16,615
OUTLANDER 450,2019-11-04,0,10,AR,US,10,580
OUTLANDER 1000,2019-11-11,12,8,AR,US,20,725
OUTLANDER 850,2019-11-11,10,11,AR,US,21,636
OUTLANDER 450,2019-11-11,14,6,AR,US,20,600
OUTLANDER 1000,2019-11-18,4,8,AR,US,12,737
OUTLANDER 850,2019-11-18,6,1,AR,US,7,643
OUTLANDER 450,2019-11-18,8,5,AR,US,13,613
OUTLANDER 1000,2019-11-25,4,6,AR,US,10,747
OUTLANDER 850,2019-11-25,6,11,AR,US,17,660
OUTLANDER 450,2019-11-25,3,7,AR,US,10,623
OUTLANDER 1000,2019-12-02,1,6,AR,US,7,754
OUTLANDER 850,2019-12-02,5,3,AR,US,8,668
OUTLANDER 450,2019-12-02,14,13,AR,US,27,650
OUTLANDER 1000,2019-12-09,3,3,AR,US,6,760
OUTLANDER 850,2019-12-09,8,1,AR,US,9,677
OUTLANDER 450,2019-12-09,9,11,AR,US,20,670
OUTLANDER 1000,2019-12-16,5,9,AR,US,14,774
OUTLANDER 850,2019-12-16,14,7,AR,US,21,698
OUTLANDER 450,2019-12-16,5,7,AR,US,12,682
OUTLANDER 1000,2019-12-23,6,5,AR,US,11,785
OUTLANDER 850,2019-12-23,11,0,AR,US,11,709
OUTLANDER 450,2019-12-23,7,2,AR,US,9,691
OUTLANDER 1000,2019-12-30,2,11,AR,US,13,798
OUTLANDER 850,2019-12-30,8,8,AR,US,16,725
OUTLANDER 450,2019-12-30,6,0,AR,US,6,697
OUTLANDER 1000,2020-01-06,11,13,AR,US,24,822
OUTLANDER 850,2020-01-06,8,2,AR,US,10,735
OUTLANDER 450,2020-01-06,12,3,AR,US,15,712
OUTLANDER 1000,2020-01-13,14,14,AR,US,28,850
OUTLANDER 850,2020-01-13,5,11,AR,US,16,751
OUTLANDER 450,2020-01-13,2,2,AR,US,4,716
OUTLANDER 1000,2020-01-20,13,12,AR,US,25,875
OUTLANDER 850,2020-01-20,2,12,AR,US,14,765
OUTLANDER 450,2020-01-20,10,5,AR,US,15,731
OUTLANDER 1000,2020-01-27,3,12,AR,US,15,890
OUTLANDER 850,2020-01-27,8,5,AR,US,13,778
OUTLANDER 450,2020-01-27,9,8,AR,US,17,748
OUTLANDER 1000,2020-02-03,6,7,AR,US,13,903
OUTLANDER 850,2020-02-03,9,11,AR,US,20,798
OUTLANDER 450,2020-02-03,6,6,AR,US,12,760
OUTLANDER 1000,2020-02-10,14,13,AR,US,27,930
OUTLANDER 850,2020-02-10,4,8,AR,US,12,810
OUTLANDER 450,2020-02-10,14,10,AR,US,24,784
OUTLANDER 1000,2020-02-17,11,13,AR,US,24,954
OUTLANDER 850,2020-02-17,3,9,AR,US,12,822
OUTLANDER 450,2020-02-17,6,11,AR,US,17,801
OUTLANDER 1000,2020-02-24,5,8,AR,US,13,967
OUTLANDER 850,2020-02-24,14,8,AR,US,22,844
OUTLANDER 450,2020-02-24,4,5,AR,US,9,810
OUTLANDER 1000,2020-03-02,13,3,AR,US,16,983
OUTLANDER 850,2020-03-02,2,15,AR,US,17,861
OUTLANDER 450,2020-03-02,2,14,AR,US,16,826
OUTLANDER 1000,2020-03-09,13,15,AR,US,28,1011
OUTLANDER 850,2020-03-09,1,11,AR,US,12,873
OUTLANDER 450,2020-03-09,1,5,AR,US,6,832
OUTLANDER 1000,2020-03-16,10,11,AR,US,21,1032
OUTLANDER 850,2020-03-16,9,12,AR,US,21,894
OUTLANDER 450,2020-03-16,7,3,AR,US,10,842
OUTLANDER 1000,2020-03-23,11,6,AR,US,17,1049
OUTLANDER 850,2020-03-23,7,10,AR,US,17,911
OUTLANDER 450,2020-03-23,13,12,AR,US,25,867
OUTLANDER 1000,2020-03-30,6,6,AR,US,12,1061
OUTLANDER 850,2020-03-30,2,2,AR,US,4,915
OUTLANDER 450,2020-03-30,5,11,AR,US,16,883
OUTLANDER 1000,2020-04-06,7,3,AR,US,10,1071
OUTLANDER 850,2020-04-06,10,2,AR,US,12,927
OUTLANDER 450,2020-04-06,1,4,AR,US,5,888
OUTLANDER 1000,2020-04-13,6,12,AR,US,18,1089
OUTLANDER 850,2020-04-13,7,7,AR,US,14,941
OUTLANDER 450,2020-04-13,13,13,AR,US,26,914
OUTLANDER 1000,2020-04-20,12,12,AR,US,24,1113
OUTLANDER 850,2020-04-20,3,2,AR,US,5,946
OUTLANDER 450,2020-04-20,13,15,AR,US,28,942
OUTLANDER 1000,2020-04-27,8,8,AR,US,16,1129
OUTLANDER 850,2020-04-27,3,0,AR,US,3,949
OUTLANDER 450,2020-04-27,14,10,AR,US,24,966
OUTLANDER 1000,2020-05-04,13,11,AR,US,24,1153
OUTLANDER 850,2020-05-04,3,8,AR,US,11,960
OUTLANDER 450,2020-05-04,2,7,AR,US,9,975
OUTLANDER 1000,2020-05-11,14,6,AR,US,20,1173
OUTLANDER 850,2020-05-11,0,1,AR,US,1,961
OUTLANDER 450,2020-05-11,1,1,AR,US,2,977
OUTLANDER 1000,2020-05-18,1,12,AR,US,13,1186
OUTLANDER 850,2020-05-18,5,7,AR,US,12,973
OUTLANDER 450,2020-05-18,12,14,AR,US,26,1003
OUTLANDER 1000,2020-05-25,11,12,AR,US,23,1209
OUTLANDER 850,2020-05-25,7,8,AR,US,15,988
OUTLANDER 450,2020-05-25,9,12,AR,US,21,1024
OUTLANDER 1000,2020-06-01,5,3,AR,US,8,1217
OUTLANDER 850,2020-06-01,4,14,AR,US,18,1006
OUTLANDER 450,2020-06-01,5,9,AR,US,14,1038
OUTLANDER 1000,2020-06-08,10,5,AR,US,15,1232
OUTLANDER 850,2020-06-08,7,15,AR,US,22,1028
OUTLANDER 450,2020-06-08,3,6,AR,US,9,1047
OUTLANDER 1000,2020-06-15,7,8,AR,US,15,1247
OUTLANDER 850,2020-06-15,13,15,AR,US,28,1056
OUTLANDER 450,2020-06-15,8,13,AR,US,21,1068
OUTLANDER 1000,2020-06-22,9,12,AR,US,21,1268
OUTLANDER 850,2020-06-22,3,8,AR,US,11,1067
OUTLANDER 450,2020-06-22,10,11,AR,US,21,1089
OUTLANDER 1000,2020-06-29,1,6,AR,US,7,1275
OUTLANDER 850,2020-06-29,4,1,AR,US,5,1072
OUTLANDER 450,2020-06-29,3,10,AR,US,13,1102
OUTLANDER 1000,2020-07-06,12,11,AR,US,23,1298
OUTLANDER 850,2020-07-06,5,1,AR,US,6,1078
OUTLANDER 450,2020-07-06,15,6,AR,US,21,1123
OUTLANDER 1000,2020-07-13,3,2,AR,US,5,1303
OUTLANDER 850,2020-07-13,8,6,AR,US,14,1092
OUTLANDER 450,2020-07-13,13,4,AR,US,17,1140
OUTLANDER 1000,2020-07-20,9,5,AR,US,14,1317
OUTLANDER 850,2020-07-20,9,1,AR,US,10,1102
OUTLANDER 450,2020-07-20,3,14,AR,US,17,1157
OUTLANDER 1000,2020-07-27,11,11,AR,US,22,1339
OUTLANDER 850,2020-07-27,10,1,AR,US,11,1113
OUTLANDER 450,2020-07-27,6,2,AR,US,8,1165
OUTLANDER 1000,2020-08-03,8,2,AR,US,10,1349
OUTLANDER 850,2020-08-03,10,3,AR,US,13,1126
OUTLANDER 450,2020-08-03,5,9,AR,US,14,1179
OUTLANDER 1000,2020-08-10,10,7,AR,US,17,1366
OUTLANDER 850,2020-08-10,7,6,AR,US,13,1139
OUTLANDER 450,2020-08-10,1,10,AR,US,11,1190
OUTLANDER 1000,2020-08-17,11,8,AR,US,19,1385
OUTLANDER 850,2020-08-17,2,12,AR,US,14,1153
OUTLANDER 450,2020-08-17,11,12,AR,US,23,1213
OUTLANDER 1000,2020-08-24,8,11,AR,US,19,1404
OUTLANDER 850,2020-08-24,5,12,AR,US,17,1170
OUTLANDER 450,2020-08-24,14,9,AR,US,23,1236
OUTLANDER 1000,2020-08-31,5,1,AR,US,6,1410
OUTLANDER 850,2020-08-31,14,11,AR,US,25,1195
OUTLANDER 450,2020-08-31,4,3,AR,US,7,1243
OUTLANDER 1000,2020-09-07,8,6,AR,US,14,1424
OUTLANDER 850,2020-09-07,5,1,AR,US,6,1201
OUTLANDER 450,2020-09-07,13,1,AR,US,14,1257
OUTLANDER 1000,2020-09-14,9,11,AR,US,20,1444
OUTLANDER 850,2020-09-14,9,13,AR,US,22,1223
OUTLANDER 450,2020-09-14,14,4,AR,US,18,1275
OUTLANDER 1000,2020-09-21,12,13,AR,US,25,1469
OUTLANDER 850,2020-09-21,4,12,AR,US,16,1239
OUTLANDER 450,2020-09-21,14,5,AR,US,19,1294
OUTLANDER 1000,2020-09-28,3,14,AR,US,17,1486
OUTLANDER 850,2020-09-28,15,1,AR,US,16,1255
OUTLANDER 450,2020-09-28,5,3,AR,US,8,1302
OUTLANDER 1000,2020-10-05,1,5,AR,US,6,1492
OUTLANDER 850,2020-10-05,11,10,AR,US,21,1276
OUTLANDER 450,2020-10-05,9,7,AR,US,16,1318
OUTLANDER 1000,2020-10-12,1,6,AR,US,7,1499
OUTLANDER 850,2020-10-12,3,2,AR,US,5,1281
OUTLANDER 450,2020-10-12,14,15,AR,US,29,1347
OUTLANDER 1000,2020-10-19,11,2,AR,US,13,1512
OUTLANDER 850,2020-10-19,5,6,AR,US,11,1292
OUTLANDER 450,2020-10-19,12,6,AR,US,18,1365
OUTLANDER 1000,2020-10-26,7,7,AR,US,14,1526
OUTLANDER 850,2020-10-26,5,7,AR,US,12,1304
OUTLANDER 450,2020-10-26,3,12,AR,US,15,1380
OUTLANDER 1000,2020-11-02,14,9,AR,US,23,1549
OUTLANDER 850,2020-11-02,1,6,AR,US,7,1311
OUTLANDER 450,2020-11-02,12,13,AR,US,25,1405
OUTLANDER 1000,2020-11-09,7,15,AR,US,22,1571
OUTLANDER 850,2020-11-09,12,4,AR,US,16,1327
OUTLANDER 450,2020-11-09,5,3,AR,US,8,1413
OUTLANDER 1000,2020-11-16,1,5,AR,US,6,1577
OUTLANDER 850,2020-11-16,3,2,AR,US,5,1332
OUTLANDER 450,2020-11-16,4,9,AR,US,13,1426
OUTLANDER 1000,2020-11-23,1,3,AR,US,4,1581
OUTLANDER 850,2020-11-23,7,4,AR,US,11,1343
OUTLANDER 450,2020-11-23,11,8,AR,US,19,1445
OUTLANDER 1000,2020-11-30,13,1,AR,US,14,1595
OUTLANDER 850,2020-11-30,2,11,AR,US,13,1356
OUTLANDER 450,2020-11-30,9,7,AR,US,16,1461
OUTLANDER 1000,2020-12-07,4,4,AR,US,8,1603
OUTLANDER 850,2020-12-07,8,11,AR,US,19,1375
OUTLANDER 450,2020-12-07,7,2,AR,US,9,1470
OUTLANDER 1000,2020-12-14,13,2,AR,US,15,1618
OUTLANDER 850,2020-12-14,4,11,AR,US,15,1390
OUTLANDER 450,2020-12-14,8,12,AR,US,20,1490
OUTLANDER 1000,2020-12-21,10,6,AR,US,16,1634
OUTLANDER 850,2020-12-21,8,1,AR,US,9,1399
OUTLANDER 450,2020-12-21,3,2,AR,US,5,1495
OUTLANDER 1000,2020-12-28,15,0,AR,US,15,1649
OUTLANDER 850,2020-12-28,0,14,AR,US,14,1413
OUTLANDER 450,2020-12-28,8,4,AR,US,12,1507
OUTLANDER 1000,2021-01-04,12,12,AR,US,24,1673
OUTLANDER 850,2021-01-04,5,8,AR,US,13,1426
OUTLANDER 450,2021-01-04,9,8,AR,US,17,1524
OUTLANDER 1000,2021-01-11,5,1,AR,US,6,1679
OUTLANDER 850,2021-01-11,14,2,AR,US,16,1442
OUTLANDER 450,2021-01-11,7,15,AR,US,22,1546
OUTLANDER 1000,2021-01-18,2,6,AR,US,8,1687
OUTLANDER 850,2021-01-18,13,4,AR,US,17,1459
OUTLANDER 450,2021-01-18,9,1,AR,US,10,1556
OUTLANDER 1000,2021-01-25,0,9,AR,US,9,1696
OUTLANDER 850,2021-01-25,8,3,AR,US,11,1470
OUTLANDER 450,2021-01-25,12,13,AR,US,25,1581
OUTLANDER 1000,2021-02-01,13,10,AR,US,23,1719
OUTLANDER 850,2021-02-01,14,1,AR,US,15,1485
OUTLANDER 450,2021-02-01,3,12,AR,US,15,1596
OUTLANDER 1000,2021-02-08,1,4,AR,US,5,1724
OUTLANDER 850,2021-02-08,11,13,AR,US,24,1509
OUTLANDER 450,2021-02-08,3,1,AR,US,4,1600
OUTLANDER 1000,2021-02-15,0,10,AR,US,10,1734
OUTLANDER 850,2021-02-15,2,9,AR,US,11,1520
OUTLANDER 450,2021-02-15,4,2,AR,US,6,1606
OUTLANDER 1000,2021-02-22,5,0,AR,US,5,1739
OUTLANDER 850,2021-02-22,13,8,AR,US,21,1541
OUTLANDER 450,2021-02-22,13,15,AR,US,28,1634
OUTLANDER 1000,2021-03-01,8,1,AR,US,9,1748
OUTLANDER 850,2021-03-01,14,3,AR,US,17,1558
OUTLANDER 450,2021-03-01,12,6,AR,US,18,1652
OUTLANDER 1000,2021-03-08,13,8,AR,US,21,1769
OUTLANDER 850,2021-03-08,13,7,AR,US,20,1578
OUTLANDER 450,2021-03-08,3,7,AR,US,10,1662
OUTLANDER 1000,2021-03-15,2,4,AR,US,6,1775
OUTLANDER 850,2021-03-15,12,7,AR,US,19,1597
OUTLANDER 450,2021-03-15,13,11,AR,US,24,1686
OUTLANDER 1000,2021-03-22,3,6,AR,US,9,1784
OUTLANDER 850,2021-03-22,11,4,AR,US,15,1612
OUTLANDER 450,2021-03-22,8,0,AR,US,8,1694
OUTLANDER 1000,2021-03-29,12,14,AR,US,26,1810
OUTLANDER 850,2021-03-29,2,14,AR,US,16,1628
OUTLANDER 450,2021-03-29,5,7,AR,US,12,1706
OUTLANDER 1000,2021-04-05,1,3,AR,US,4,1814
OUTLANDER 850,2021-04-05,4,13,AR,US,17,1645
OUTLANDER 450,2021-04-05,14,1,AR,US,15,1721
OUTLANDER 1000,2021-04-12,4,11,AR,US,15,1829
OUTLANDER 850,2021-04-12,9,9,AR,US,18,1663
OUTLANDER 450,2021-04-12,14,7,AR,US,21,1742
OUTLANDER 1000,2021-04-19,14,14,AR,US,28,1857
OUTLANDER 850,2021-04-19,1,7,AR,US,8,1671
OUTLANDER 450,2021-04-19,4,6,AR,US,10,1752
OUTLANDER 1000,2021-04-26,4,6,AR,US,10,1867
OUTLANDER 850,2021-04-26,1,3,AR,US,4,1675
OUTLANDER 450,2021-04-26,0,11,AR,US,11,1763
OUTLANDER 1000,2021-05-03,1,9,AR,US,10,1877
OUTLANDER 850,2021-05-03,12,6,AR,US,18,1693
OUTLANDER 450,2021-05-03,13,6,AR,US,19,1782
OUTLANDER 1000,2021-05-10,10,13,AR,US,23,1900
OUTLANDER 850,2021-05-10,7,5,AR,US,12,1705
OUTLANDER 450,2021-05-10,7,15,AR,US,22,1804
OUTLANDER 1000,2021-05-17,14,0,AR,US,14,1914
OUTLANDER 850,2021-05-17,6,12,AR,US,18,1723
OUTLANDER 450,2021-05-17,7,3,AR,US,10,1814
OUTLANDER 1000,2021-05-24,10,1,AR,US,11,1925
OUTLANDER 850,2021-05-24,11,9,AR,US,20,1743
OUTLANDER 450,2021-05-24,1,8,AR,US,9,1823
OUTLANDER 1000,2021-05-31,1,14,AR,US,15,1940
OUTLANDER 850,2021-05-31,3,3,AR,US,6,1749
OUTLANDER 450,2021-05-31,9,4,AR,US,13,1836
OUTLANDER 1000,2021-06-07,8,4,AR,US,12,1952
OUTLANDER 850,2021-06-07,5,5,AR,US,10,1759
OUTLANDER 450,2021-06-07,11,2,AR,US,13,1849
OUTLANDER 1000,2021-06-14,6,0,AR,US,6,1958
OUTLANDER 850,2021-06-14,13,6,AR,US,19,1778
OUTLANDER 450,2021-06-14,7,14,AR,US,21,1870
OUTLANDER 1000,2021-06-21,8,9,AR,US,17,1975
OUTLANDER 850,2021-06-21,9,13,AR,US,22,1800
OUTLANDER 450,2021-06-21,13,11,AR,US,24,1894
OUTLANDER 1000,2021-06-28,14,4,AR,US,18,1993
OUTLANDER 850,2021-06-28,7,3,AR,US,10,1810
OUTLANDER 450,2021-06-28,6,12,AR,US,18,1912
OUTLANDER 1000,2021-07-05,2,8,AR,US,10,2003
OUTLANDER 850,2021-07-05,5,2,AR,US,7,1817
OUTLANDER 450,2021-07-05,12,10,AR,US,22,1934
OUTLANDER 1000,2021-07-12,4,2,AR,US,6,2009
OUTLANDER 850,2021-07-12,12,2,AR,US,14,1831
OUTLANDER 450,2021-07-12,2,1,AR,US,3,1937
OUTLANDER 1000,2021-07-19,4,5,AR,US,9,2018
OUTLANDER 850,2021-07-19,11,11,AR,US,22,1853
OUTLANDER 450,2021-07-19,9,10,AR,US,19,1956
OUTLANDER 1000,2021-07-26,10,4,AR,US,14,2032
OUTLANDER 850,2021-07-26,0,10,AR,US,10,1863
OUTLANDER 450,2021-07-26,3,6,AR,US,9,1965
OUTLANDER 1000,2021-08-02,11,6,AR,US,17,2049
OUTLANDER 850,2021-08-02,9,9,AR,US,18,1881
OUTLANDER 450,2021-08-02,5,5,AR,US,10,1975
OUTLANDER 1000,2021-08-09,2,7,AR,US,9,2058
OUTLANDER 850,2021-08-09,14,15,AR,US,29,1910
OUTLANDER 450,2021-08-09,8,13,AR,US,21,1996
OUTLANDER 1000,2021-08-16,11,2,AR,US,13,2071
OUTLANDER 850,2021-08-16,12,1,AR,US,13,1923
OUTLANDER 450,2021-08-16,15,11,AR,US,26,2022
OUTLANDER 1000,2021-08-23,10,5,AR,US,15,2086
OUTLANDER 850,2021-08-23,4,10,AR,US,14,1937
OUTLANDER 450,2021-08-23,11,4,AR,US,15,2037
OUTLANDER 1000,2021-08-30,10,12,AR,US,22,2108
OUTLANDER 850,2021-08-30,6,2,AR,US,8,1945
OUTLANDER 450,2021-08-30,0,8,AR,US,8,2045
OUTLANDER 1000,2021-09-06,11,0,AR,US,11,2119
OUTLANDER 850,2021-09-06,1,6,AR,US,7,1952
OUTLANDER 450,2021-09-06,15,7,AR,US,22,2067
OUTLANDER 1000,2021-09-13,2,4,AR,US,6,2125
OUTLANDER 850,2021-09-13,10,4,AR,US,14,1966
OUTLANDER 450,2021-09-13,1,0,AR,US,1,2068
OUTLANDER 1000,2021-09-20,2,8,AR,US,10,2135
OUTLANDER 850,2021-09-20,3,1,AR,US,4,1970
OUTLANDER 450,2021-09-20,2,5,AR,US,7,2075
OUTLANDER 1000,2021-09-27,15,9,AR,US,24,2159
OUTLANDER 850,2021-09-27,3,1,AR,US,4,1974
OUTLANDER 450,2021-09-27,11,12,AR,US,23,2098
OUTLANDER 1000,2021-10-04,12,9,AR,US,21,2180
OUTLANDER 850,2021-10-04,14,13,AR,US,27,2001
OUTLANDER 450,2021-10-04,4,6,AR,US,10,2108
OUTLANDER 1000,2021-10-11,12,12,AR,US,24,2204
OUTLANDER 850,2021-10-11,10,7,AR,US,17,2018
OUTLANDER 450,2021-10-11,9,1,AR,US,10,2118
OUTLANDER 1000,2021-10-18,15,8,AR,US,23,2227
OUTLANDER 850,2021-10-18,8,4,AR,US,12,2030
OUTLANDER 450,2021-10-18,7,1,AR,US,8,2126
OUTLANDER 1000,2021-10-25,0,2,AR,US,2,2229
OUTLANDER 850,2021-10-25,10,9,AR,US,19,2049
OUTLANDER 450,2021-10-25,10,6,AR,US,16,2142
OUTLANDER 1000,2021-11-01,2,3,AR,US,5,2234
OUTLANDER 850,2021-11-01,0,4,AR,US,4,2053
OUTLANDER 450,2021-11-01,2,8,AR,US,10,2152
OUTLANDER 1000,2021-11-08,12,3,AR,US,15,2249
OUTLANDER 850,2021-11-08,11,14,AR,US,25,2078
OUTLANDER 450,2021-11-08,15,8,AR,US,23,2175
OUTLANDER 1000,2021-11-15,11,4,AR,US,15,2264
OUTLANDER 850,2021-11-15,15,7,AR,US,22,2100
OUTLANDER 450,2021-11-15,7,15,AR,US,22,2197
OUTLANDER 1000,2021-11-22,5,10,AR,US,15,2279
OUTLANDER 850,2021-11-22,8,1,AR,US,9,2109
OUTLANDER 450,2021-11-22,3,12,AR,US,15,2212
OUTLANDER 1000,2021-11-29,15,7,AR,US,22,2301
OUTLANDER 850,2021-11-29,5,2,AR,US,7,2116
OUTLANDER 450,2021-11-29,11,0,AR,US,11,2223
OUTLANDER 1000,2021-12-06,7,3,AR,US,10,2311
OUTLANDER 850,2021-12-06,3,4,AR,US,7,2123
OUTLANDER 450,2021-12-06,10,3,AR,US,13,2236
OUTLANDER 1000,2021-12-13,12,13,AR,US,25,2336
OUTLANDER 850,2021-12-13,9,9,AR,US,18,2141
OUTLANDER 450,2021-12-13,3,13,AR,US,16,2252
OUTLANDER 1000,2021-12-20,10,11,AR,US,21,2357
OUTLANDER 850,2021-12-20,6,2,AR,US,8,2149
OUTLANDER 450,2021-12-20,10,7,AR,US,17,2269
OUTLANDER 1000,2021-12-27,12,15,AR,US,27,2384
OUTLANDER 850,2021-12-27,8,13,AR,US,21,2170
OUTLANDER 450,2021-12-27,14,13,AR,US,27,2296
OUTLANDER 1000,2019-01-07,7,13,CA,US,20,20
OUTLANDER 850,2019-01-07,7,8,CA,US,15,15
OUTLANDER 450,2019-01-07,12,6,CA,US,18,18
OUTLANDER 1000,2019-01-14,5,5,CA,US,10,30
OUTLANDER 850,2019-01-14,12,10,CA,US,22,37
OUTLANDER 450,2019-01-14,1,6,CA,US,7,25
OUTLANDER 1000,2019-01-21,11,10,CA,US,21,51
OUTLANDER 850,2019-01-21,14,2,CA,US,16,53
OUTLANDER 450,2019-01-21,5,11,CA,US,16,41
OUTLANDER 1000,2019-01-28,3,1,CA,US,4,55
OUTLANDER 850,2019-01-28,6,1,CA,US,7,60
OUTLANDER 450,2019-01-28,6,7,CA,US,13,54
OUTLANDER 1000,2019-02-04,10,5,CA,US,15,70
OUTLANDER 850,2019-02-04,11,7,CA,US,18,78
OUTLANDER 450,2019-02-04,2,10,CA,US,12,66
OUTLANDER 1000,2019-02-11,5,14,CA,US,19,89
OUTLANDER 850,2019-02-11,8,4,CA,US,12,90
OUTLANDER 450,2019-02-11,12,10,CA,US,22,88
OUTLANDER 1000,2019-02-18,10,11,CA,US,21,110
OUTLANDER 850,2019-02-18,6,11,CA,US,17,107
OUTLANDER 450,2019-02-18,8,8,CA,US,16,104
OUTLANDER 1000,2019-02-25,14,14,CA,US,28,138
OUTLANDER 850,2019-02-25,0,13,CA,US,13,120
OUTLANDER 450,2019-02-25,3,7,CA,US,10,114
OUTLANDER 1000,2019-03-04,3,6,CA,US,9,147
OUTLANDER 850,2019-03-04,1,6,CA,US,7,127
OUTLANDER 450,2019-03-04,7,5,CA,US,12,126
OUTLANDER 1000,2019-03-11,11,6,CA,US,17,164
OUTLANDER 850,2019-03-11,8,12,CA,US,20,147
OUTLANDER 450,2019-03-11,14,2,CA,US,16,142
OUTLANDER 1000,2019-03-18,1,6,CA,US,7,171
OUTLANDER 850,2019-03-18,12,10,CA,US,22,169
OUTLANDER 450,2019-03-18,7,13,CA,US,20,162
OUTLANDER 1000,2019-03-25,8,15,CA,US,23,194
OUTLANDER 850,2019-03-25,3,7,CA,US,10,179
OUTLANDER 450,2019-03-25,3,9,CA,US,12,174
OUTLANDER 1000,2019-04-01,2,1,CA,US,3,197
OUTLANDER 850,2019-04-01,9,9,CA,US,18,197
OUTLANDER 450,2019-04-01,12,4,CA,US,16,190
OUTLANDER 1000,2019-04-08,4,11,CA,US,15,212
OUTLANDER 850,2019-04-08,8,0,CA,US,8,205
OUTLANDER 450,2019-04-08,6,2,CA,US,8,198
OUTLANDER 1000,2019-04-15,1,7,CA,US,8,220
OUTLANDER 850,2019-04-15,4,0,CA,US,4,209
OUTLANDER 450,2019-04-15,12,14,CA,US,26,224
OUTLANDER 1000,2019-04-22,6,9,CA,US,15,235
OUTLANDER 850,2019-04-22,9,3,CA,US,12,221
OUTLANDER 450,2019-04-22,14,13,CA,US,27,251
OUTLANDER 1000,2019-04-29,8,9,CA,US,17,252
OUTLANDER 850,2019-04-29,14,11,CA,US,25,246
OUTLANDER 450,2019-04-29,13,9,CA,US,22,273
OUTLANDER 1000,2019-05-06,3,11,CA,US,14,266
OUTLANDER 850,2019-05-06,8,4,CA,US,12,258
OUTLANDER 450,2019-05-06,1,6,CA,US,7,280
OUTLANDER 1000,2019-05-13,12,8,CA,US,20,286
OUTLANDER 850,2019-05-13,4,4,CA,US,8,266
OUTLANDER 450,2019-05-13,1,7,CA,US,8,288
OUTLANDER 1000,2019-05-20,9,12,CA,US,21,307
OUTLANDER 850,2019-05-20,10,12,CA,US,22,288
OUTLANDER 450,2019-05-20,5,13,CA,US,18,306
OUTLANDER 1000,2019-05-27,9,4,CA,US,13,320
OUTLANDER 850,2019-05-27,1,12,CA,US,13,301
OUTLANDER 450,2019-05-27,13,6,CA,US,19,325
OUTLANDER 1000,2019-06-03,11,12,CA,US,23,343
OUTLANDER 850,2019-06-03,4,0,CA,US,4,305
OUTLANDER 450,2019-06-03,14,12,CA,US,26,351
OUTLANDER 1000,2019-06-10,5,5,CA,US,10,353
OUTLANDER 850,2019-06-10,1,4,CA,US,5,310
OUTLANDER 450,2019-06-10,5,8,CA,US,13,364
OUTLANDER 1000,2019-06-17,8,9,CA,US,17,370
OUTLANDER 850,2019-06-17,1,9,CA,US,10,320
OUTLANDER 450,2019-06-17,2,1,CA,US,3,367
OUTLANDER 1000,2019-06-24,12,13,CA,US,25,395
OUTLANDER 850,2019-06-24,3,11,CA,US,14,334
OUTLANDER 450,2019-06-24,3,12,CA,US,15,382
OUTLANDER 1000,2019-07-01,6,15,CA,US,21,416
OUTLANDER 850,2019-07-01,11,14,CA,US,25,359
OUTLANDER 450,2019-07-01,11,4,CA,US,15,397
OUTLANDER 1000,2019-07-08,14,8,CA,US,22,438
OUTLANDER 850,2019-07-08,2,7,CA,US,9,368
OUTLANDER 450,2019-07-08,12,8,CA,US,20,417
OUTLANDER 1000,2019-07-15,9,8,CA,US,17,455
OUTLANDER 850,2019-07-15,7,12,CA,US,19,387
OUTLANDER 450,2019-07-15,14,8,CA,US,22,439
OUTLANDER 1000,2019-07-22,14,2,CA,US,16,471
OUTLANDER 850,2019-07-22,1,10,CA,US,11,398
OUTLANDER 450,2019-07-22,11,13,CA,US,24,463
OUTLANDER 1000,2019-07-29,13,7,CA,US,20,491
OUTLANDER 850,2019-07-29,11,3,CA,US,14,412
OUTLANDER 450,2019-07-29,11,0,CA,US,11,474
OUTLANDER 1000,2019-08-05,9,3,CA,US,12,503
OUTLANDER 850,2019-08-05,5,13,CA,US,18,430
OUTLANDER 450,2019-08-05,2,2,CA,US,4,478
OUTLANDER 1000,2019-08-12,3,3,CA,US,6,509
OUTLANDER 850,2019-08-12,14,13,CA,US,27,457
OUTLANDER 450,2019-08-12,2,11,CA,US,13,491
OUTLANDER 1000,2019-08-19,7,8,CA,US,15,524
OUTLANDER 850,2019-08-19,12,1,CA,US,13,470
OUTLANDER 450,2019-08-19,10,2,CA,US,12,503
OUTLANDER 1000,2019-08-26,9,1,CA,US,10,534
OUTLANDER 850,2019-08-26,15,3,CA,US,18,488
OUTLANDER 450,2019-08-26,6,15,CA,US,21,524
OUTLANDER 1000,2019-09-02,12,2,CA,US,14,548
OUTLANDER 850,2019-09-02,5,2,CA,US,7,495
OUTLANDER 450,2019-09-02,14,1,CA,US,15,539
OUTLANDER 1000,2019-09-09,10,4,CA,US,14,562
OUTLANDER 850,2019-09-09,15,1,CA,US,16,511
OUTLANDER 450,2019-09-09,5,14,CA,US,19,558
OUTLANDER 1000,2019-09-16,3,3,CA,US,6,568
OUTLANDER 850,2019-09-16,6,15,CA,US,21,532
OUTLANDER 450,2019-09-16,3,3,CA,US,6,564
OUTLANDER 1000,2019-09-23,12,3,CA,US,15,583
OUTLANDER 850,2019-09-23,15,0,CA,US,15,547
OUTLANDER 450,2019-09-23,13,8,CA,US,21,585
OUTLANDER 1000,2019-09-30,8,5,CA,US,13,596
OUTLANDER 850,2019-09-30,2,10,CA,US,12,559
OUTLANDER 450,2019-09-30,3,3,CA,US,6,591
OUTLANDER 1000,2019-10-07,8,9,CA,US,17,613
OUTLANDER 850,2019-10-07,6,6,CA,US,12,571
OUTLANDER 450,2019-10-07,3,5,CA,US,8,599
OUTLANDER 1000,2019-10-14,3,7,CA,US,10,623
OUTLANDER 850,2019-10-14,7,3,CA,US,10,581
OUTLANDER 450,2019-10-14,10,11,CA,US,21,620
OUTLANDER 1000,2019-10-21,7,11,CA,US,18,641
OUTLANDER 850,2019-10-21,11,13,CA,US,24,605
OUTLANDER 450,2019-10-21,4,7,CA,US,11,631
OUTLANDER 1000,2019-10-28,8,9,CA,US,17,658
OUTLANDER 850,2019-10-28,15,10,CA,US,25,630
OUTLANDER 450,2019-10-28,9,1,CA,US,10,641
OUTLANDER 1000,2019-11-04,15,0,CA,US,15,673
OUTLANDER 850,2019-11-04,14,15,CA,US,29,659
OUTLANDER 450,2019-11-04,4,2,CA,US,6,647
OUTLANDER 1000,2019-11-11,4,5,CA,US,9,682
OUTLANDER 850,2019-11-11,0,7,CA,US,7,666
OUTLANDER 450,2019-11-11,7,9,CA,US,16,663
OUTLANDER 1000,2019-11-18,13,7,CA,US,20,702
OUTLANDER 850,2019-11-18,15,9,CA,US,24,690
OUTLANDER 450,2019-11-18,10,1,CA,US,11,674
OUTLANDER 1000,2019-11-25,12,3,CA,US,15,717
OUTLANDER 850,2019-11-25,11,8,CA,US,19,709
OUTLANDER 450,2019-11-25,14,14,CA,US,28,702
OUTLANDER 1000,2019-12-02,1,7,CA,US,8,725
OUTLANDER 850,2019-12-02,15,11,CA,US,26,735
OUTLANDER 450,2019-12-02,8,0,CA,US,8,710
OUTLANDER 1000,2019-12-09,9,11,CA,US,20,745
OUTLANDER 850,2019-12-09,8,6,CA,US,14,749
OUTLANDER 450,2019-12-09,12,12,CA,US,24,734
OUTLANDER 1000,2019-12-16,3,9,CA,US,12,757
OUTLANDER 850,2019-12-16,9,9,CA,US,18,767
OUTLANDER 450,2019-12-16,4,14,CA,US,18,752
OUTLANDER 1000,2019-12-23,6,6,CA,US,12,769
OUTLANDER 850,2019-12-23,8,1,CA,US,9,776
OUTLANDER 450,2019-12-23,2,4,CA,US,6,758
OUTLANDER 1000,2019-12-30,12,1,CA,US,13,782
OUTLANDER 850,2019-12-30,13,5,CA,US,18,794
OUTLANDER 450,2019-12-30,8,0,CA,US,8,766
OUTLANDER 1000,2020-01-06,14,14,CA,US,28,810
OUTLANDER 850,2020-01-06,3,3,CA,US,6,800
OUTLANDER 450,2020-01-06,10,6,CA,US,16,782
OUTLANDER 1000,2020-01-13,9,9,CA,US,18,828
OUTLANDER 850,2020-01-13,7,1,CA,US,8,808
OUTLANDER 450,2020-01-13,6,15,CA,US,21,803
OUTLANDER 1000,2020-01-20,7,14,CA,US,21,849
OUTLANDER 850,2020-01-20,11,7,CA,US,18,826
OUTLANDER 450,2020-01-20,6,8,CA,US,14,817
OUTLANDER 1000,2020-01-27,2,11,CA,US,13,862
OUTLANDER 850,2020-01-27,6,12,CA,US,18,844
OUTLANDER 450,2020-01-27,1,5,CA,US,6,823
OUTLANDER 1000,2020-02-03,12,6,CA,US,18,880
OUTLANDER 850,2020-02-03,12,4,CA,US,16,860
OUTLANDER 450,2020-02-03,1,3,CA,US,4,827
OUTLANDER 1000,2020-02-10,9,11,CA,US,20,900
OUTLANDER 850,2020-02-10,10,13,CA,US,23,883
OUTLANDER 450,2020-02-10,8,7,CA,US,15,842
OUTLANDER 1000,2020-02-17,1,7,CA,US,8,908
OUTLANDER 850,2020-02-17,8,7,CA,US,15,898
OUTLANDER 450,2020-02-17,11,1,CA,US,12,854
OUTLANDER 1000,2020-02-24,8,2,CA,US,10,918
OUTLANDER 850,2020-02-24,2,5,CA,US,7,905
OUTLANDER 450,2020-02-24,7,5,CA,US,12,866
OUTLANDER 1000,2020-03-02,9,8,CA,US,17,935
OUTLANDER 850,2020-03-02,7,9,CA,US,16,921
OUTLANDER 450,2020-03-02,9,0,CA,US,9,875
OUTLANDER 1000,2020-03-09,14,15,CA,US,29,964
OUTLANDER 850,2020-03-09,15,6,CA,US,21,942
OUTLANDER 450,2020-03-09,0,13,CA,US,13,888
OUTLANDER 1000,2020-03-16,10,8,CA,US,18,982
OUTLANDER 850,2020-03-16,3,10,CA,US,13,955
OUTLANDER 450,2020-03-16,3,3,CA,US,6,894
OUTLANDER 1000,2020-03-23,8,1,CA,US,9,991
OUTLANDER 850,2020-03-23,6,12,CA,US,18,973
OUTLANDER 450,2020-03-23,1,6,CA,US,7,901
OUTLANDER 1000,2020-03-30,3,2,CA,US,5,996
OUTLANDER 850,2020-03-30,6,9,CA,US,15,988
OUTLANDER 450,2020-03-30,11,5,CA,US,16,917
OUTLANDER 1000,2020-04-06,5,8,CA,US,13,1009
OUTLANDER 850,2020-04-06,14,3,CA,US,17,1005
OUTLANDER 450,2020-04-06,4,11,CA,US,15,932
OUTLANDER 1000,2020-04-13,15,9,CA,US,24,1033
OUTLANDER 850,2020-04-13,1,1,CA,US,2,1007
OUTLANDER 450,2020-04-13,1,11,CA,US,12,944
OUTLANDER 1000,2020-04-20,9,5,CA,US,14,1047
OUTLANDER 850,2020-04-20,0,7,CA,US,7,1014
OUTLANDER 450,2020-04-20,7,9,CA,US,16,960
OUTLANDER 1000,2020-04-27,1,7,CA,US,8,1055
OUTLANDER 850,2020-04-27,2,11,CA,US,13,1027
OUTLANDER 450,2020-04-27,1,4,CA,US,5,965
OUTLANDER 1000,2020-05-04,3,11,CA,US,14,1069
OUTLANDER 850,2020-05-04,9,2,CA,US,11,1038
OUTLANDER 450,2020-05-04,8,6,CA,US,14,979
OUTLANDER 1000,2020-05-11,2,1,CA,US,3,1072
OUTLANDER 850,2020-05-11,11,12,CA,US,23,1061
OUTLANDER 450,2020-05-11,0,5,CA,US,5,984
OUTLANDER 1000,2020-05-18,6,2,CA,US,8,1080
OUTLANDER 850,2020-05-18,9,3,CA,US,12,1073
OUTLANDER 450,2020-05-18,14,4,CA,US,18,1002
OUTLANDER 1000,2020-05-25,12,9,CA,US,21,1101
OUTLANDER 850,2020-05-25,2,9,CA,US,11,1084
OUTLANDER 450,2020-05-25,15,2,CA,US,17,1019
OUTLANDER 1000,2020-06-01,10,2,CA,US,12,1113
OUTLANDER 850,2020-06-01,11,4,CA,US,15,1099
OUTLANDER 450,2020-06-01,12,14,CA,US,26,1045
OUTLANDER 1000,2020-06-08,2,2,CA,US,4,1117
OUTLANDER 850,2020-06-08,12,0,CA,US,12,1111
OUTLANDER 450,2020-06-08,10,15,CA,US,25,1070
OUTLANDER 1000,2020-06-15,13,1,CA,US,14,1131
OUTLANDER 850,2020-06-15,6,1,CA,US,7,1118
OUTLANDER 450,2020-06-15,13,6,CA,US,19,1089
OUTLANDER 1000,2020-06-22,1,8,CA,US,9,1140
OUTLANDER 850,2020-06-22,15,9,CA,US,24,1142
OUTLANDER 450,2020-06-22,11,4,CA,US,15,1104
OUTLANDER 1000,2020-06-29,5,15,CA,US,20,1160
OUTLANDER 850,2020-06-29,10,10,CA,US,20,1162
OUTLANDER 450,2020-06-29,14,11,CA,US,25,1129
OUTLANDER 1000,2020-07-06,2,2,CA,US,4,1164
OUTLANDER 850,2020-07-06,9,4,CA,US,13,1175
OUTLANDER 450,2020-07-06,5,10,CA,US,15,1144
OUTLANDER 1000,2020-07-13,0,5,CA,US,5,1169
OUTLANDER 850,2020-07-13,15,13,CA,US,28,1203
OUTLANDER 450,2020-07-13,6,11,CA,US,17,1161
OUTLANDER 1000,2020-07-20,10,9,CA,US,19,1188
OUTLANDER 850,2020-07-20,6,14,CA,US,20,1223
OUTLANDER 450,2020-07-20,3,11,CA,US,14,1175
OUTLANDER 1000,2020-07-27,4,14,CA,US,18,1206
OUTLANDER 850,2020-07-27,14,2,CA,US,16,1239
OUTLANDER 450,2020-07-27,6,10,CA,US,16,1191
OUTLANDER 1000,2020-08-03,15,2,CA,US,17,1223
OUTLANDER 850,2020-08-03,7,5,CA,US,12,1251
OUTLANDER 450,2020-08-03,11,2,CA,US,13,1204
OUTLANDER 1000,2020-08-10,3,2,CA,US,5,1228
OUTLANDER 850,2020-08-10,15,8,CA,US,23,1274
OUTLANDER 450,2020-08-10,8,5,CA,US,13,1217
OUTLANDER 1000,2020-08-17,9,12,CA,US,21,1249
OUTLANDER 850,2020-08-17,3,4,CA,US,7,1281
OUTLANDER 450,2020-08-17,2,4,CA,US,6,1223
OUTLANDER 1000,2020-08-24,6,13,CA,US,19,1268
OUTLANDER 850,2020-08-24,15,1,CA,US,16,1297
OUTLANDER 450,2020-08-24,2,4,CA,US,6,1229
OUTLANDER 1000,2020-08-31,13,11,CA,US,24,1292
OUTLANDER 850,2020-08-31,3,12,CA,US,15,1312
OUTLANDER 450,2020-08-31,1,1,CA,US,2,1231
OUTLANDER 1000,2020-09-07,15,2,CA,US,17,1309
OUTLANDER 850,2020-09-07,10,5,CA,US,15,1327
OUTLANDER 450,2020-09-07,1,1,CA,US,2,1233
OUTLANDER 1000,2020-09-14,4,10,CA,US,14,1323
OUTLANDER 850,2020-09-14,14,6,CA,US,20,1347
OUTLANDER 450,2020-09-14,3,13,CA,US,16,1249
OUTLANDER 1000,2020-09-21,4,9,CA,US,13,1336
OUTLANDER 850,2020-09-21,11,11,CA,US,22,1369
OUTLANDER 450,2020-09-21,8,1,CA,US,9,1258
OUTLANDER 1000,2020-09-28,14,6,CA,US,20,1356
OUTLANDER 850,2020-09-28,10,12,CA,US,22,1391
OUTLANDER 450,2020-09-28,2,4,CA,US,6,1264
OUTLANDER 1000,2020-10-05,10,13,CA,US,23,1379
OUTLANDER 850,2020-10-05,6,13,CA,US,19,1410
OUTLANDER 450,2020-10-05,4,11,CA,US,15,1279
OUTLANDER 1000,2020-10-12,4,5,CA,US,9,1388
OUTLANDER 850,2020-10-12,6,9,CA,US,15,1425
OUTLANDER 450,2020-10-12,7,10,CA,US,17,1296
OUTLANDER 1000,2020-10-19,1,4,CA,US,5,1393
OUTLANDER 850,2020-10-19,13,10,CA,US,23,1448
OUTLANDER 450,2020-10-19,3,3,CA,US,6,1302
OUTLANDER 1000,2020-10-26,3,7,CA,US,10,1403
OUTLANDER 850,2020-10-26,1,13,CA,US,14,1462
OUTLANDER 450,2020-10-26,6,14,CA,US,20,1322
OUTLANDER 1000,2020-11-02,8,4,CA,US,12,1415
OUTLANDER 850,2020-11-02,6,6,CA,US,12,1474
OUTLANDER 450,2020-11-02,12,12,CA,US,24,1346
OUTLANDER 1000,2020-11-09,11,7,CA,US,18,1433
OUTLANDER 850,2020-11-09,13,6,CA,US,19,1493
OUTLANDER 450,2020-11-09,4,10,CA,US,14,1360
OUTLANDER 1000,2020-11-16,2,1,CA,US,3,1436
OUTLANDER 850,2020-11-16,5,2,CA,US,7,1500
OUTLANDER 450,2020-11-16,11,6,CA,US,17,1377
OUTLANDER 1000,2020-11-23,2,1,CA,US,3,1439
OUTLANDER 850,2020-11-23,13,6,CA,US,19,1519
OUTLANDER 450,2020-11-23,9,14,CA,US,23,1400
OUTLANDER 1000,2020-11-30,14,13,CA,US,27,1466
OUTLANDER 850,2020-11-30,11,4,CA,US,15,1534
OUTLANDER 450,2020-11-30,12,10,CA,US,22,1422
OUTLANDER 1000,2020-12-07,10,6,CA,US,16,1482
OUTLANDER 850,2020-12-07,12,0,CA,US,12,1546
OUTLANDER 450,2020-12-07,3,0,CA,US,3,1425
OUTLANDER 1000,2020-12-14,10,15,CA,US,25,1507
OUTLANDER 850,2020-12-14,4,9,CA,US,13,1559
OUTLANDER 450,2020-12-14,4,7,CA,US,11,1436
OUTLANDER 1000,2020-12-21,6,10,CA,US,16,1523
OUTLANDER 850,2020-12-21,5,3,CA,US,8,1567
OUTLANDER 450,2020-12-21,2,8,CA,US,10,1446
OUTLANDER 1000,2020-12-28,5,3,CA,US,8,1531
OUTLANDER 850,2020-12-28,1,7,CA,US,8,1575
OUTLANDER 450,2020-12-28,9,10,CA,US,19,1465
OUTLANDER 1000,2021-01-04,7,13,CA,US,20,1551
OUTLANDER 850,2021-01-04,9,9,CA,US,18,1593
OUTLANDER 450,2021-01-04,9,13,CA,US,22,1487
OUTLANDER 1000,2021-01-11,1,9,CA,US,10,1561
OUTLANDER 850,2021-01-11,14,13,CA,US,27,1620
OUTLANDER 450,2021-01-11,15,7,CA,US,22,1509
OUTLANDER 1000,2021-01-18,12,7,CA,US,19,1580
OUTLANDER 850,2021-01-18,6,10,CA,US,16,1636
OUTLANDER 450,2021-01-18,4,2,CA,US,6,1515
OUTLANDER 1000,2021-01-25,12,7,CA,US,19,1599
OUTLANDER 850,2021-01-25,8,12,CA,US,20,1656
OUTLANDER 450,2021-01-25,14,8,CA,US,22,1537
OUTLANDER 1000,2021-02-01,10,12,CA,US,22,1621
OUTLANDER 850,2021-02-01,15,4,CA,US,19,1675
OUTLANDER 450,2021-02-01,7,12,CA,US,19,1556
OUTLANDER 1000,2021-02-08,10,0,CA,US,10,1631
OUTLANDER 850,2021-02-08,6,8,CA,US,14,1689
OUTLANDER 450,2021-02-08,15,4,CA,US,19,1575
OUTLANDER 1000,2021-02-15,9,5,CA,US,14,1645
OUTLANDER 850,2021-02-15,2,13,CA,US,15,1704
OUTLANDER 450,2021-02-15,15,2,CA,US,17,1592
OUTLANDER 1000,2021-02-22,5,13,CA,US,18,1663
OUTLANDER 850,2021-02-22,14,12,CA,US,26,1730
OUTLANDER 450,2021-02-22,0,1,CA,US,1,1593
OUTLANDER 1000,2021-03-01,10,2,CA,US,12,1675
OUTLANDER 850,2021-03-01,13,15,CA,US,28,1758
OUTLANDER 450,2021-03-01,6,13,CA,US,19,1612
OUTLANDER 1000,2021-03-08,12,9,CA,US,21,1696
OUTLANDER 850,2021-03-08,1,4,CA,US,5,1763
OUTLANDER 450,2021-03-08,1,1,CA,US,2,1614
OUTLANDER 1000,2021-03-15,13,14,CA,US,27,1723
OUTLANDER 850,2021-03-15,13,13,CA,US,26,1789
OUTLANDER 450,2021-03-15,6,8,CA,US,14,1628
OUTLANDER 1000,2021-03-22,14,8,CA,US,22,1745
OUTLANDER 850,2021-03-22,9,10,CA,US,19,1808
OUTLANDER 450,2021-03-22,1,14,CA,US,15,1643
OUTLANDER 1000,2021-03-29,13,8,CA,US,21,1766
OUTLANDER 850,2021-03-29,4,7,CA,US,11,1819
OUTLANDER 450,2021-03-29,2,1,CA,US,3,1646
OUTLANDER 1000,2021-04-05,7,2,CA,US,9,1775
OUTLANDER 850,2021-04-05,4,5,CA,US,9,1828
OUTLANDER 450,2021-04-05,1,0,CA,US,1,1647
OUTLANDER 1000,2021-04-12,5,14,CA,US,19,1794
OUTLANDER 850,2021-04-12,14,11,CA,US,25,1853
OUTLANDER 450,2021-04-12,2,5,CA,US,7,1654
OUTLANDER 1000,2021-04-19,13,2,CA,US,15,1809
OUTLANDER 850,2021-04-19,8,1,CA,US,9,1862
OUTLANDER 450,2021-04-19,9,10,CA,US,19,1673
OUTLANDER 1000,2021-04-26,4,3,CA,US,7,1816
OUTLANDER 850,2021-04-26,4,10,CA,US,14,1876
OUTLANDER 450,2021-04-26,12,2,CA,US,14,1687
OUTLANDER 1000,2021-05-03,2,6,CA,US,8,1824
OUTLANDER 850,2021-05-03,10,9,CA,US,19,1895
OUTLANDER 450,2021-05-03,2,7,CA,US,9,1696
OUTLANDER 1000,2021-05-10,10,1,CA,US,11,1835
OUTLANDER 850,2021-05-10,4,3,CA,US,7,1902
OUTLANDER 450,2021-05-10,8,13,CA,US,21,1717
OUTLANDER 1000,2021-05-17,6,0,CA,US,6,1841
OUTLANDER 850,2021-05-17,13,9,CA,US,22,1924
OUTLANDER 450,2021-05-17,5,5,CA,US,10,1727
OUTLANDER 1000,2021-05-24,5,0,CA,US,5,1846
OUTLANDER 850,2021-05-24,12,1,CA,US,13,1937
OUTLANDER 450,2021-05-24,3,5,CA,US,8,1735
OUTLANDER 1000,2021-05-31,2,10,CA,US,12,1858
OUTLANDER 850,2021-05-31,1,4,CA,US,5,1942
OUTLANDER 450,2021-05-31,2,13,CA,US,15,1750
OUTLANDER 1000,2021-06-07,3,8,CA,US,11,1869
OUTLANDER 850,2021-06-07,5,2,CA,US,7,1949
OUTLANDER 450,2021-06-07,5,9,CA,US,14,1764
OUTLANDER 1000,2021-06-14,10,7,CA,US,17,1886
OUTLANDER 850,2021-06-14,12,5,CA,US,17,1966
OUTLANDER 450,2021-06-14,13,12,CA,US,25,1789
OUTLANDER 1000,2021-06-21,6,3,CA,US,9,1895
OUTLANDER 850,2021-06-21,9,9,CA,US,18,1984
OUTLANDER 450,2021-06-21,2,2,CA,US,4,1793
OUTLANDER 1000,2021-06-28,11,5,CA,US,16,1911
OUTLANDER 850,2021-06-28,15,6,CA,US,21,2005
OUTLANDER 450,2021-06-28,0,6,CA,US,6,1799
OUTLANDER 1000,2021-07-05,5,5,CA,US,10,1921
OUTLANDER 850,2021-07-05,8,2,CA,US,10,2015
OUTLANDER 450,2021-07-05,10,14,CA,US,24,1823
OUTLANDER 1000,2021-07-12,9,11,CA,US,20,1941
OUTLANDER 850,2021-07-12,8,10,CA,US,18,2033
OUTLANDER 450,2021-07-12,6,3,CA,US,9,1832
OUTLANDER 1000,2021-07-19,11,8,CA,US,19,1960
OUTLANDER 850,2021-07-19,7,14,CA,US,21,2054
OUTLANDER 450,2021-07-19,10,9,CA,US,19,1851
OUTLANDER 1000,2021-07-26,5,5,CA,US,10,1970
OUTLANDER 850,2021-07-26,12,10,CA,US,22,2076
OUTLANDER 450,2021-07-26,5,11,CA,US,16,1867
OUTLANDER 1000,2021-08-02,13,9,CA,US,22,1992
OUTLANDER 850,2021-08-02,10,9,CA,US,19,2095
OUTLANDER 450,2021-08-02,12,6,CA,US,18,1885
OUTLANDER 1000,2021-08-09,15,2,CA,US,17,2009
OUTLANDER 850,2021-08-09,11,6,CA,US,17,2112
OUTLANDER 450,2021-08-09,10,11,CA,US,21,1906
OUTLANDER 1000,2021-08-16,15,14,CA,US,29,2038
OUTLANDER 850,2021-08-16,3,11,CA,US,14,2126
OUTLANDER 450,2021-08-16,1,10,CA,US,11,1917
OUTLANDER 1000,2021-08-23,5,6,CA,US,11,2049
OUTLANDER 850,2021-08-23,7,2,CA,US,9,2135
OUTLANDER 450,2021-08-23,8,6,CA,US,14,1931
OUTLANDER 1000,2021-08-30,10,3,CA,US,13,2062
OUTLANDER 850,2021-08-30,7,4,CA,US,11,2146
OUTLANDER 450,2021-08-30,15,12,CA,US,27,1958
OUTLANDER 1000,2021-09-06,7,14,CA,US,21,2083
OUTLANDER 850,2021-09-06,3,13,CA,US,16,2162
OUTLANDER 450,2021-09-06,10,12,CA,US,22,1980
OUTLANDER 1000,2021-09-13,9,4,CA,US,13,2096
OUTLANDER 850,2021-09-13,9,10,CA,US,19,2181
OUTLANDER 450,2021-09-13,13,12,CA,US,25,2005
OUTLANDER 1000,2021-09-20,8,7,CA,US,15,2111
OUTLANDER 850,2021-09-20,6,2,CA,US,8,2189
OUTLANDER 450,2021-09-20,6,14,CA,US,20,2025
OUTLANDER 1000,2021-09-27,3,2,CA,US,5,2116
OUTLANDER 850,2021-09-27,14,6,CA,US,20,2209
OUTLANDER 450,2021-09-27,2,6,CA,US,8,2033
OUTLANDER 1000,2021-10-04,9,4,CA,US,13,2129
OUTLANDER 850,2021-10-04,8,2,CA,US,10,2219
OUTLANDER 450,2021-10-04,13,14,CA,US,27,2060
OUTLANDER 1000,2021-10-11,4,2,CA,US,6,2135
OUTLANDER 850,2021-10-11,14,10,CA,US,24,2243
OUTLANDER 450,2021-10-11,9,14,CA,US,23,2083
OUTLANDER 1000,2021-10-18,9,15,CA,US,24,2159
OUTLANDER 850,2021-10-18,4,13,CA,US,17,2260
OUTLANDER 450,2021-10-18,0,7,CA,US,7,2090
OUTLANDER 1000,2021-10-25,3,11,CA,US,14,2173
OUTLANDER 850,2021-10-25,0,4,CA,US,4,2264
OUTLANDER 450,2021-10-25,10,7,CA,US,17,2107
OUTLANDER 1000,2021-11-01,3,14,CA,US,17,2190
OUTLANDER 850,2021-11-01,1,12,CA,US,13,2277
OUTLANDER 450,2021-11-01,5,4,CA,US,9,2116
OUTLANDER 1000,2021-11-08,10,5,CA,US,15,2205
OUTLANDER 850,2021-11-08,14,2,CA,US,16,2293
OUTLANDER 450,2021-11-08,4,5,CA,US,9,2125
OUTLANDER 1000,2021-11-15,2,9,CA,US,11,2216
OUTLANDER 850,2021-11-15,12,3,CA,US,15,2308
OUTLANDER 450,2021-11-15,11,1,CA,US,12,2137
OUTLANDER 1000,2021-11-22,9,2,CA,US,11,2227
OUTLANDER 850,2021-11-22,6,10,CA,US,16,2324
OUTLANDER 450,2021-11-22,7,2,CA,US,9,2146
OUTLANDER 1000,2021-11-29,13,5,CA,US,18,2245
OUTLANDER 850,2021-11-29,5,1,CA,US,6,2330
OUTLANDER 450,2021-11-29,5,3,CA,US,8,2154
OUTLANDER 1000,2021-12-06,14,7,CA,US,21,2266
OUTLANDER 850,2021-12-06,14,11,CA,US,25,2355
OUTLANDER 450,2021-12-06,14,13,CA,US,27,2181
OUTLANDER 1000,2021-12-13,10,12,CA,US,22,2288
OUTLANDER 850,2021-12-13,6,12,CA,US,18,2373
OUTLANDER 450,2021-12-13,9,14,CA,US,23,2204
OUTLANDER 1000,2021-12-20,6,5,CA,US,11,2299
OUTLANDER 850,2021-12-20,14,15,CA,US,29,2402
OUTLANDER 450,2021-12-20,2,13,CA,US,15,2219
OUTLANDER 1000,2021-12-27,2,15,CA,US,17,2316
OUTLANDER 850,2021-12-27,10,11,CA,US,21,2423
OUTLANDER 450,2021-12-27,2,0,CA,US,2,2221
OUTLANDER 1000,2019-01-07,8,7,CO,US,15,15
OUTLANDER 850,2019-01-07,9,7,CO,US,16,16
OUTLANDER 450,2019-01-07,15,3,CO,US,18,18
OUTLANDER 1000,2019-01-14,6,8,CO,US,14,29
OUTLANDER 850,2019-01-14,7,8,CO,US,15,31
OUTLANDER 450,2019-01-14,4,8,CO,US,12,30
OUTLANDER 1000,2019-01-21,14,12,CO,US,26,55
OUTLANDER 850,2019-01-21,11,1,CO,US,12,43
OUTLANDER 450,2019-01-21,13,11,CO,US,24,54
OUTLANDER 1000,2019-01-28,10,7,CO,US,17,72
OUTLANDER 850,2019-01-28,8,12,CO,US,20,63
OUTLANDER 450,2019-01-28,3,14,CO,US,17,71
OUTLANDER 1000,2019-02-04,0,1,CO,US,1,73
OUTLANDER 850,2019-02-04,8,7,CO,US,15,78
OUTLANDER 450,2019-02-04,13,2,CO,US,15,86
OUTLANDER 1000,2019-02-11,2,5,CO,US,7,80
OUTLANDER 850,2019-02-11,6,14,CO,US,20,98
OUTLANDER 450,2019-02-11,3,11,CO,US,14,100
OUTLANDER 1000,2019-02-18,9,1,CO,US,10,90
OUTLANDER 850,2019-02-18,14,3,CO,US,17,115
OUTLANDER 450,2019-02-18,3,8,CO,US,11,111
OUTLANDER 1000,2019-02-25,4,5,CO,US,9,99
OUTLANDER 850,2019-02-25,7,10,CO,US,17,132
OUTLANDER 450,2019-02-25,10,4,CO,US,14,125
OUTLANDER 1000,2019-03-04,13,5,CO,US,18,117
OUTLANDER 850,2019-03-04,4,3,CO,US,7,139
OUTLANDER 450,2019-03-04,3,9,CO,US,12,137
OUTLANDER 1000,2019-03-11,4,13,CO,US,17,134
OUTLANDER 850,2019-03-11,15,14,CO,US,29,168
OUTLANDER 450,2019-03-11,1,2,CO,US,3,140
OUTLANDER 1000,2019-03-18,15,8,CO,US,23,157
OUTLANDER 850,2019-03-18,10,1,CO,US,11,179
OUTLANDER 450,2019-03-18,10,1,CO,US,11,151
OUTLANDER 1000,2019-03-25,15,13,CO,US,28,185
OUTLANDER 850,2019-03-25,4,5,CO,US,9,188
OUTLANDER 450,2019-03-25,2,4,CO,US,6,157
OUTLANDER 1000,2019-04-01,11,4,CO,US,15,200
OUTLANDER 850,2019-04-01,13,15,CO,US,28,216
OUTLANDER 450,2019-04-01,2,7,CO,US,9,166
OUTLANDER 1000,2019-04-08,7,14,CO,US,21,221
OUTLANDER 850,2019-04-08,1,10,CO,US,11,227
OUTLANDER 450,2019-04-08,14,15,CO,US,29,195
OUTLANDER 1000,2019-04-15,4,11,CO,US,15,236
OUTLANDER 850,2019-04-15,9,11,CO,US,20,247
OUTLANDER 450,2019-04-15,8,5,CO,US,13,208
OUTLANDER 1000,2019-04-22,10,4,CO,US,14,250
OUTLANDER 850,2019-04-22,3,7,CO,US,10,257
OUTLANDER 450,2019-04-22,2,6,CO,US,8,216
OUTLANDER 1000,2019-04-29,2,4,CO,US,6,256
OUTLANDER 850,2019-04-29,3,9,CO,US,12,269
OUTLANDER 450,2019-04-29,9,4,CO,US,13,229
OUTLANDER 1000,2019-05-06,10,9,CO,US,19,275
OUTLANDER 850,2019-05-06,5,13,CO,US,18,287
OUTLANDER 450,2019-05-06,9,7,CO,US,16,245
OUTLANDER 1000,2019-05-13,9,12,CO,US,21,296
OUTLANDER 850,2019-05-13,10,10,CO,US,20,307
OUTLANDER 450,2019-05-13,5,8,CO,US,13,258
OUTLANDER 1000,2019-05-20,4,15,CO,US,19,315
OUTLANDER 850,2019-05-20,8,14,CO,US,22,329
OUTLANDER 450,2019-05-20,1,13,CO,US,14,272
OUTLANDER 1000,2019-05-27,8,4,CO,US,12,327
OUTLANDER 850,2019-05-27,9,11,CO,US,20,349
OUTLANDER 450,2019-05-27,2,11,CO,US,13,285
OUTLANDER 1000,2019-06-03,2,0,CO,US,2,329
OUTLANDER 850,2019-06-03,10,14,CO,US,24,373
OUTLANDER 450,2019-06-03,4,13,CO,US,17,302
OUTLANDER 1000,2019-06-10,9,4,CO,US,13,342
OUTLANDER 850,2019-06-10,8,5,CO,US,13,386
OUTLANDER 450,2019-06-10,6,14,CO,US,20,322
OUTLANDER 1000,2019-06-17,1,14,CO,US,15,357
OUTLANDER 850,2019-06-17,8,3,CO,US,11,397
OUTLANDER 450,2019-06-17,8,6,CO,US,14,336
OUTLANDER 1000,2019-06-24,4,8,CO,US,12,369
OUTLANDER 850,2019-06-24,5,15,CO,US,20,417
OUTLANDER 450,2019-06-24,4,14,CO,US,18,354
OUTLANDER 1000,2019-07-01,3,7,CO,US,10,379
OUTLANDER 850,2019-07-01,12,0,CO,US,12,429
OUTLANDER 450,2019-07-01,14,2,CO,US,16,370
OUTLANDER 1000,2019-07-08,6,10,CO,US,16,395
OUTLANDER 850,2019-07-08,11,9,CO,US,20,449
OUTLANDER 450,2019-07-08,7,9,CO,US,16,386
OUTLANDER 1000,2019-07-15,12,4,CO,US,16,411
OUTLANDER 850,2019-07-15,0,1,CO,US,1,450
OUTLANDER 450,2019-07-15,2,2,CO,US,4,390
OUTLANDER 1000,2019-07-22,6,6,CO,US,12,423
OUTLANDER 850,2019-07-22,9,5,CO,US,14,464
OUTLANDER 450,2019-07-22,2,2,CO,US,4,394
OUTLANDER 1000,2019-07-29,4,11,CO,US,15,438
OUTLANDER 850,2019-07-29,10,10,CO,US,20,484
OUTLANDER 450,2019-07-29,7,13,CO,US,20,414
OUTLANDER 1000,2019-08-05,5,8,CO,US,13,451
OUTLANDER 850,2019-08-05,14,7,CO,US,21,505
OUTLANDER 450,2019-08-05,3,12,CO,US,15,429
OUTLANDER 1000,2019-08-12,12,0,CO,US,12,463
OUTLANDER 850,2019-08-12,1,12,CO,US,13,518
OUTLANDER 450,2019-08-12,4,2,CO,US,6,435
OUTLANDER 1000,2019-08-19,11,12,CO,US,23,486
OUTLANDER 850,2019-08-19,14,3,CO,US,17,535
OUTLANDER 450,2019-08-19,2,10,CO,US,12,447
OUTLANDER 1000,2019-08-26,8,5,CO,US,13,499
OUTLANDER 850,2019-08-26,3,4,CO,US,7,542
OUTLANDER 450,2019-08-26,7,13,CO,US,20,467
OUTLANDER 1000,2019-09-02,1,9,CO,US,10,509
OUTLANDER 850,2019-09-02,3,9,CO,US,12,554
OUTLANDER 450,2019-09-02,14,13,CO,US,27,494
OUTLANDER 1000,2019-09-09,4,5,CO,US,9,518
OUTLANDER 850,2019-09-09,9,7,CO,US,16,570
OUTLANDER 450,2019-09-09,2,10,CO,US,12,506
OUTLANDER 1000,2019-09-16,3,5,CO,US,8,526
OUTLANDER 850,2019-09-16,6,3,CO,US,9,579
OUTLANDER 450,2019-09-16,3,11,CO,US,14,520
OUTLANDER 1000,2019-09-23,9,14,CO,US,23,549
OUTLANDER 850,2019-09-23,6,6,CO,US,12,591
OUTLANDER 450,2019-09-23,7,5,CO,US,12,532
OUTLANDER 1000,2019-09-30,3,6,CO,US,9,558
OUTLANDER 850,2019-09-30,1,6,CO,US,7,598
OUTLANDER 450,2019-09-30,0,11,CO,US,11,543
OUTLANDER 1000,2019-10-07,14,4,CO,US,18,576
OUTLANDER 850,2019-10-07,1,4,CO,US,5,603
OUTLANDER 450,2019-10-07,9,6,CO,US,15,558
OUTLANDER 1000,2019-10-14,2,7,CO,US,9,585
OUTLANDER 850,2019-10-14,14,9,CO,US,23,626
OUTLANDER 450,2019-10-14,1,9,CO,US,10,568
OUTLANDER 1000,2019-10-21,10,14,CO,US,24,609
OUTLANDER 850,2019-10-21,12,4,CO,US,16,642
OUTLANDER 450,2019-10-21,13,6,CO,US,19,587
OUTLANDER 1000,2019-10-28,1,3,CO,US,4,613
OUTLANDER 850,2019-10-28,4,3,CO,US,7,649
OUTLANDER 450,2019-10-28,2,7,CO,US,9,596
OUTLANDER 1000,2019-11-04,14,12,CO,US,26,639
OUTLANDER 850,2019-11-04,10,13,CO,US,23,672
OUTLANDER 450,2019-11-04,4,6,CO,US,10,606
OUTLANDER 1000,2019-11-11,1,9,CO,US,10,649
OUTLANDER 850,2019-11-11,3,5,CO,US,8,680
OUTLANDER 450,2019-11-11,11,3,CO,US,14,620
OUTLANDER 1000,2019-11-18,6,14,CO,US,20,669
OUTLANDER 850,2019-11-18,3,2,CO,US,5,685
OUTLANDER 450,2019-11-18,9,8,CO,US,17,637
OUTLANDER 1000,2019-11-25,11,11,CO,US,22,691
OUTLANDER 850,2019-11-25,2,6,CO,US,8,693
OUTLANDER 450,2019-11-25,14,11,CO,US,25,662
OUTLANDER 1000,2019-12-02,5,4,CO,US,9,700
OUTLANDER 850,2019-12-02,0,7,CO,US,7,700
OUTLANDER 450,2019-12-02,2,14,CO,US,16,678
OUTLANDER 1000,2019-12-09,6,11,CO,US,17,717
OUTLANDER 850,2019-12-09,10,12,CO,US,22,722
OUTLANDER 450,2019-12-09,1,3,CO,US,4,682
OUTLANDER 1000,2019-12-16,3,2,CO,US,5,722
OUTLANDER 850,2019-12-16,3,8,CO,US,11,733
OUTLANDER 450,2019-12-16,7,8,CO,US,15,697
OUTLANDER 1000,2019-12-23,12,6,CO,US,18,740
OUTLANDER 850,2019-12-23,4,6,CO,US,10,743
OUTLANDER 450,2019-12-23,9,10,CO,US,19,716
OUTLANDER 1000,2019-12-30,9,11,CO,US,20,760
OUTLANDER 850,2019-12-30,9,3,CO,US,12,755
OUTLANDER 450,2019-12-30,10,10,CO,US,20,736
OUTLANDER 1000,2020-01-06,14,12,CO,US,26,786
OUTLANDER 850,2020-01-06,0,2,CO,US,2,757
OUTLANDER 450,2020-01-06,4,2,CO,US,6,742
OUTLANDER 1000,2020-01-13,15,13,CO,US,28,814
OUTLANDER 850,2020-01-13,9,9,CO,US,18,775
OUTLANDER 450,2020-01-13,11,12,CO,US,23,765
OUTLANDER 1000,2020-01-20,2,4,CO,US,6,820
OUTLANDER 850,2020-01-20,12,11,CO,US,23,798
OUTLANDER 450,2020-01-20,13,10,CO,US,23,788
OUTLANDER 1000,2020-01-27,13,6,CO,US,19,839
OUTLANDER 850,2020-01-27,10,7,CO,US,17,815
OUTLANDER 450,2020-01-27,1,7,CO,US,8,796
OUTLANDER 1000,2020-02-03,11,1,CO,US,12,851
OUTLANDER 850,2020-02-03,1,7,CO,US,8,823
OUTLANDER 450,2020-02-03,13,6,CO,US,19,815
OUTLANDER 1000,2020-02-10,10,9,CO,US,19,870
OUTLANDER 850,2020-02-10,15,1,CO,US,16,839
OUTLANDER 450,2020-02-10,13,3,CO,US,16,831
OUTLANDER 1000,2020-02-17,2,8,CO,US,10,880
OUTLANDER 850,2020-02-17,8,1,CO,US,9,848
OUTLANDER 450,2020-02-17,4,6,CO,US,10,841
OUTLANDER 1000,2020-02-24,12,14,CO,US,26,906
OUTLANDER 850,2020-02-24,5,12,CO,US,17,865
OUTLANDER 450,2020-02-24,12,3,CO,US,15,856
OUTLANDER 1000,2020-03-02,0,7,CO,US,7,913
OUTLANDER 850,2020-03-02,10,6,CO,US,16,881
OUTLANDER 450,2020-03-02,10,12,CO,US,22,878
OUTLANDER 1000,2020-03-09,15,9,CO,US,24,937
OUTLANDER 850,2020-03-09,1,9,CO,US,10,891
OUTLANDER 450,2020-03-09,0,0,CO,US,0,878
OUTLANDER 1000,2020-03-16,3,6,CO,US,9,946
OUTLANDER 850,2020-03-16,13,12,CO,US,25,916
OUTLANDER 450,2020-03-16,10,6,CO,US,16,894
OUTLANDER 1000,2020-03-23,3,11,CO,US,14,960
OUTLANDER 850,2020-03-23,15,3,CO,US,18,934
OUTLANDER 450,2020-03-23,12,8,CO,US,20,914
OUTLANDER 1000,2020-03-30,0,9,CO,US,9,969
OUTLANDER 850,2020-03-30,12,8,CO,US,20,954
OUTLANDER 450,2020-03-30,13,1,CO,US,14,928
OUTLANDER 1000,2020-04-06,8,3,CO,US,11,980
OUTLANDER 850,2020-04-06,5,9,CO,US,14,968
OUTLANDER 450,2020-04-06,13,4,CO,US,17,945
OUTLANDER 1000,2020-04-13,5,4,CO,US,9,989
OUTLANDER 850,2020-04-13,15,6,CO,US,21,989
OUTLANDER 450,2020-04-13,11,9,CO,US,20,965
OUTLANDER 1000,2020-04-20,0,1,CO,US,1,990
OUTLANDER 850,2020-04-20,13,9,CO,US,22,1011
OUTLANDER 450,2020-04-20,8,1,CO,US,9,974
OUTLANDER 1000,2020-04-27,9,9,CO,US,18,1008
OUTLANDER 850,2020-04-27,7,11,CO,US,18,1029
OUTLANDER 450,2020-04-27,1,4,CO,US,5,979
OUTLANDER 1000,2020-05-04,10,7,CO,US,17,1025
OUTLANDER 850,2020-05-04,6,1,CO,US,7,1036
OUTLANDER 450,2020-05-04,6,11,CO,US,17,996
OUTLANDER 1000,2020-05-11,7,9,CO,US,16,1041
OUTLANDER 850,2020-05-11,12,10,CO,US,22,1058
OUTLANDER 450,2020-05-11,3,9,CO,US,12,1008
OUTLANDER 1000,2020-05-18,4,14,CO,US,18,1059
OUTLANDER 850,2020-05-18,9,7,CO,US,16,1074
OUTLANDER 450,2020-05-18,6,0,CO,US,6,1014
OUTLANDER 1000,2020-05-25,6,6,CO,US,12,1071
OUTLANDER 850,2020-05-25,10,1,CO,US,11,1085
OUTLANDER 450,2020-05-25,11,0,CO,US,11,1025
OUTLANDER 1000,2020-06-01,5,4,CO,US,9,1080
OUTLANDER 850,2020-06-01,3,5,CO,US,8,1093
OUTLANDER 450,2020-06-01,9,11,CO,US,20,1045
OUTLANDER 1000,2020-06-08,13,10,CO,US,23,1103
OUTLANDER 850,2020-06-08,5,9,CO,US,14,1107
OUTLANDER 450,2020-06-08,2,11,CO,US,13,1058
OUTLANDER 1000,2020-06-15,12,3,CO,US,15,1118
OUTLANDER 850,2020-06-15,0,13,CO,US,13,1120
OUTLANDER 450,2020-06-15,10,7,CO,US,17,1075
OUTLANDER 1000,2020-06-22,4,1,CO,US,5,1123
OUTLANDER 850,2020-06-22,13,2,CO,US,15,1135
OUTLANDER 450,2020-06-22,13,1,CO,US,14,1089
OUTLANDER 1000,2020-06-29,5,0,CO,US,5,1128
OUTLANDER 850,2020-06-29,9,13,CO,US,22,1157
OUTLANDER 450,2020-06-29,1,1,CO,US,2,1091
OUTLANDER 1000,2020-07-06,1,2,CO,US,3,1131
OUTLANDER 850,2020-07-06,6,1,CO,US,7,1164
OUTLANDER 450,2020-07-06,3,8,CO,US,11,1102
OUTLANDER 1000,2020-07-13,6,3,CO,US,9,1140
OUTLANDER 850,2020-07-13,4,10,CO,US,14,1178
OUTLANDER 450,2020-07-13,7,2,CO,US,9,1111
OUTLANDER 1000,2020-07-20,1,6,CO,US,7,1147
OUTLANDER 850,2020-07-20,13,7,CO,US,20,1198
OUTLANDER 450,2020-07-20,3,12,CO,US,15,1126
OUTLANDER 1000,2020-07-27,9,2,CO,US,11,1158
OUTLANDER 850,2020-07-27,14,3,CO,US,17,1215
OUTLANDER 450,2020-07-27,6,8,CO,US,14,1140
OUTLANDER 1000,2020-08-03,5,14,CO,US,19,1177
OUTLANDER 850,2020-08-03,15,2,CO,US,17,1232
OUTLANDER 450,2020-08-03,11,5,CO,US,16,1156
OUTLANDER 1000,2020-08-10,4,6,CO,US,10,1187
OUTLANDER 850,2020-08-10,5,15,CO,US,20,1252
OUTLANDER 450,2020-08-10,12,4,CO,US,16,1172
OUTLANDER 1000,2020-08-17,9,10,CO,US,19,1206
OUTLANDER 850,2020-08-17,3,1,CO,US,4,1256
OUTLANDER 450,2020-08-17,4,12,CO,US,16,1188
OUTLANDER 1000,2020-08-24,5,6,CO,US,11,1217
OUTLANDER 850,2020-08-24,5,2,CO,US,7,1263
OUTLANDER 450,2020-08-24,2,13,CO,US,15,1203
OUTLANDER 1000,2020-08-31,2,7,CO,US,9,1226
OUTLANDER 850,2020-08-31,13,11,CO,US,24,1287
OUTLANDER 450,2020-08-31,3,1,CO,US,4,1207
OUTLANDER 1000,2020-09-07,8,10,CO,US,18,1244
OUTLANDER 850,2020-09-07,12,14,CO,US,26,1313
OUTLANDER 450,2020-09-07,10,4,CO,US,14,1221
OUTLANDER 1000,2020-09-14,2,2,CO,US,4,1248
OUTLANDER 850,2020-09-14,10,3,CO,US,13,1326
OUTLANDER 450,2020-09-14,14,1,CO,US,15,1236
OUTLANDER 1000,2020-09-21,10,3,CO,US,13,1261
OUTLANDER 850,2020-09-21,4,13,CO,US,17,1343
OUTLANDER 450,2020-09-21,3,1,CO,US,4,1240
OUTLANDER 1000,2020-09-28,2,7,CO,US,9,1270
OUTLANDER 850,2020-09-28,1,1,CO,US,2,1345
OUTLANDER 450,2020-09-28,5,13,CO,US,18,1258
OUTLANDER 1000,2020-10-05,10,8,CO,US,18,1288
OUTLANDER 850,2020-10-05,9,9,CO,US,18,1363
OUTLANDER 450,2020-10-05,6,1,CO,US,7,1265
OUTLANDER 1000,2020-10-12,15,3,CO,US,18,1306
OUTLANDER 850,2020-10-12,7,8,CO,US,15,1378
OUTLANDER 450,2020-10-12,1,2,CO,US,3,1268
OUTLANDER 1000,2020-10-19,6,5,CO,US,11,1317
OUTLANDER 850,2020-10-19,2,7,CO,US,9,1387
OUTLANDER 450,2020-10-19,15,8,CO,US,23,1291
OUTLANDER 1000,2020-10-26,5,1,CO,US,6,1323
OUTLANDER 850,2020-10-26,14,0,CO,US,14,1401
OUTLANDER 450,2020-10-26,6,13,CO,US,19,1310
OUTLANDER 1000,2020-11-02,14,14,CO,US,28,1351
OUTLANDER 850,2020-11-02,15,14,CO,US,29,1430
OUTLANDER 450,2020-11-02,8,5,CO,US,13,1323
OUTLANDER 1000,2020-11-09,4,9,CO,US,13,1364
OUTLANDER 850,2020-11-09,2,3,CO,US,5,1435
OUTLANDER 450,2020-11-09,13,7,CO,US,20,1343
OUTLANDER 1000,2020-11-16,3,0,CO,US,3,1367
OUTLANDER 850,2020-11-16,14,5,CO,US,19,1454
OUTLANDER 450,2020-11-16,5,12,CO,US,17,1360
OUTLANDER 1000,2020-11-23,12,3,CO,US,15,1382
OUTLANDER 850,2020-11-23,3,9,CO,US,12,1466
OUTLANDER 450,2020-11-23,0,13,CO,US,13,1373
OUTLANDER 1000,2020-11-30,8,7,CO,US,15,1397
OUTLANDER 850,2020-11-30,5,2,CO,US,7,1473
OUTLANDER 450,2020-11-30,6,13,CO,US,19,1392
OUTLANDER 1000,2020-12-07,1,0,CO,US,1,1398
OUTLANDER 850,2020-12-07,12,5,CO,US,17,1490
OUTLANDER 450,2020-12-07,13,1,CO,US,14,1406
OUTLANDER 1000,2020-12-14,2,10,CO,US,12,1410
OUTLANDER 850,2020-12-14,11,7,CO,US,18,1508
OUTLANDER 450,2020-12-14,14,3,CO,US,17,1423
OUTLANDER 1000,2020-12-21,3,7,CO,US,10,1420
OUTLANDER 850,2020-12-21,7,12,CO,US,19,1527
OUTLANDER 450,2020-12-21,4,7,CO,US,11,1434
OUTLANDER 1000,2020-12-28,3,10,CO,US,13,1433
OUTLANDER 850,2020-12-28,5,14,CO,US,19,1546
OUTLANDER 450,2020-12-28,3,14,CO,US,17,1451
OUTLANDER 1000,2021-01-04,11,10,CO,US,21,1454
OUTLANDER 850,2021-01-04,14,4,CO,US,18,1564
OUTLANDER 450,2021-01-04,4,7,CO,US,11,1462
OUTLANDER 1000,2021-01-11,2,2,CO,US,4,1458
OUTLANDER 850,2021-01-11,3,14,CO,US,17,1581
OUTLANDER 450,2021-01-11,13,2,CO,US,15,1477
OUTLANDER 1000,2021-01-18,13,3,CO,US,16,1474
OUTLANDER 850,2021-01-18,6,10,CO,US,16,1597
OUTLANDER 450,2021-01-18,7,4,CO,US,11,1488
OUTLANDER 1000,2021-01-25,4,14,CO,US,18,1492
OUTLANDER 850,2021-01-25,11,1,CO,US,12,1609
OUTLANDER 450,2021-01-25,0,14,CO,US,14,1502
OUTLANDER 1000,2021-02-01,11,14,CO,US,25,1517
OUTLANDER 850,2021-02-01,1,5,CO,US,6,1615
OUTLANDER 450,2021-02-01,2,9,CO,US,11,1513
OUTLANDER 1000,2021-02-08,3,12,CO,US,15,1532
OUTLANDER 850,2021-02-08,5,6,CO,US,11,1626
OUTLANDER 450,2021-02-08,1,14,CO,US,15,1528
OUTLANDER 1000,2021-02-15,13,1,CO,US,14,1546
OUTLANDER 850,2021-02-15,2,11,CO,US,13,1639
OUTLANDER 450,2021-02-15,7,10,CO,US,17,1545
OUTLANDER 1000,2021-02-22,12,11,CO,US,23,1569
OUTLANDER 850,2021-02-22,12,3,CO,US,15,1654
OUTLANDER 450,2021-02-22,12,4,CO,US,16,1561
OUTLANDER 1000,2021-03-01,10,14,CO,US,24,1593
OUTLANDER 850,2021-03-01,2,8,CO,US,10,1664
OUTLANDER 450,2021-03-01,3,6,CO,US,9,1570
OUTLANDER 1000,2021-03-08,10,14,CO,US,24,1617
OUTLANDER 850,2021-03-08,7,13,CO,US,20,1684
OUTLANDER 450,2021-03-08,14,10,CO,US,24,1594
OUTLANDER 1000,2021-03-15,6,15,CO,US,21,1638
OUTLANDER 850,2021-03-15,9,11,CO,US,20,1704
OUTLANDER 450,2021-03-15,13,7,CO,US,20,1614
OUTLANDER 1000,2021-03-22,9,9,CO,US,18,1656
OUTLANDER 850,2021-03-22,5,13,CO,US,18,1722
OUTLANDER 450,2021-03-22,15,14,CO,US,29,1643
OUTLANDER 1000,2021-03-29,8,6,CO,US,14,1670
OUTLANDER 850,2021-03-29,15,11,CO,US,26,1748
OUTLANDER 450,2021-03-29,2,2,CO,US,4,1647
OUTLANDER 1000,2021-04-05,0,8,CO,US,8,1678
OUTLANDER 850,2021-04-05,7,15,CO,US,22,1770
OUTLANDER 450,2021-04-05,5,3,CO,US,8,1655
OUTLANDER 1000,2021-04-12,7,4,CO,US,11,1689
OUTLANDER 850,2021-04-12,5,15,CO,US,20,1790
OUTLANDER 450,2021-04-12,7,6,CO,US,13,1668
OUTLANDER 1000,2021-04-19,12,6,CO,US,18,1707
OUTLANDER 850,2021-04-19,10,12,CO,US,22,1812
OUTLANDER 450,2021-04-19,7,9,CO,US,16,1684
OUTLANDER 1000,2021-04-26,6,3,CO,US,9,1716
OUTLANDER 850,2021-04-26,5,6,CO,US,11,1823
OUTLANDER 450,2021-04-26,8,7,CO,US,15,1699
OUTLANDER 1000,2021-05-03,5,13,CO,US,18,1734
OUTLANDER 850,2021-05-03,7,8,CO,US,15,1838
OUTLANDER 450,2021-05-03,14,2,CO,US,16,1715
OUTLANDER 1000,2021-05-10,1,0,CO,US,1,1735
OUTLANDER 850,2021-05-10,5,12,CO,US,17,1855
OUTLANDER 450,2021-05-10,9,13,CO,US,22,1737
OUTLANDER 1000,2021-05-17,13,11,CO,US,24,1759
OUTLANDER 850,2021-05-17,12,13,CO,US,25,1880
OUTLANDER 450,2021-05-17,4,10,CO,US,14,1751
OUTLANDER 1000,2021-05-24,8,8,CO,US,16,1775
OUTLANDER 850,2021-05-24,1,5,CO,US,6,1886
OUTLANDER 450,2021-05-24,14,2,CO,US,16,1767
OUTLANDER 1000,2021-05-31,6,4,CO,US,10,1785
OUTLANDER 850,2021-05-31,13,10,CO,US,23,1909
OUTLANDER 450,2021-05-31,5,14,CO,US,19,1786
OUTLANDER 1000,2021-06-07,3,6,CO,US,9,1794
OUTLANDER 850,2021-06-07,15,4,CO,US,19,1928
OUTLANDER 450,2021-06-07,2,7,CO,US,9,1795
OUTLANDER 1000,2021-06-14,8,13,CO,US,21,1815
OUTLANDER 850,2021-06-14,6,13,CO,US,19,1947
OUTLANDER 450,2021-06-14,9,2,CO,US,11,1806
OUTLANDER 1000,2021-06-21,12,7,CO,US,19,1834
OUTLANDER 850,2021-06-21,0,13,CO,US,13,1960
OUTLANDER 450,2021-06-21,4,9,CO,US,13,1819
OUTLANDER 1000,2021-06-28,8,4,CO,US,12,1846
OUTLANDER 850,2021-06-28,0,15,CO,US,15,1975
OUTLANDER 450,2021-06-28,13,10,CO,US,23,1842
OUTLANDER 1000,2021-07-05,14,2,CO,US,16,1862
OUTLANDER 850,2021-07-05,7,5,CO,US,12,1987
OUTLANDER 450,2021-07-05,15,1,CO,US,16,1858
OUTLANDER 1000,2021-07-12,10,14,CO,US,24,1886
OUTLANDER 850,2021-07-12,15,15,CO,US,30,2017
OUTLANDER 450,2021-07-12,6,10,CO,US,16,1874
OUTLANDER 1000,2021-07-19,14,12,CO,US,26,1912
OUTLANDER 850,2021-07-19,8,1,CO,US,9,2026
OUTLANDER 450,2021-07-19,12,12,CO,US,24,1898
OUTLANDER 1000,2021-07-26,12,10,CO,US,22,1934
OUTLANDER 850,2021-07-26,13,1,CO,US,14,2040
OUTLANDER 450,2021-07-26,6,1,CO,US,7,1905
OUTLANDER 1000,2021-08-02,12,12,CO,US,24,1958
OUTLANDER 850,2021-08-02,11,8,CO,US,19,2059
OUTLANDER 450,2021-08-02,13,6,CO,US,19,1924
OUTLANDER 1000,2021-08-09,9,6,CO,US,15,1973
OUTLANDER 850,2021-08-09,0,15,CO,US,15,2074
OUTLANDER 450,2021-08-09,14,4,CO,US,18,1942
OUTLANDER 1000,2021-08-16,3,10,CO,US,13,1986
OUTLANDER 850,2021-08-16,9,6,CO,US,15,2089
OUTLANDER 450,2021-08-16,4,14,CO,US,18,1960
OUTLANDER 1000,2021-08-23,1,12,CO,US,13,1999
OUTLANDER 850,2021-08-23,6,2,CO,US,8,2097
OUTLANDER 450,2021-08-23,9,14,CO,US,23,1983
OUTLANDER 1000,2021-08-30,14,10,CO,US,24,2023
OUTLANDER 850,2021-08-30,9,3,CO,US,12,2109
OUTLANDER 450,2021-08-30,7,4,CO,US,11,1994
OUTLANDER 1000,2021-09-06,5,6,CO,US,11,2034
OUTLANDER 850,2021-09-06,2,3,CO,US,5,2114
OUTLANDER 450,2021-09-06,7,13,CO,US,20,2014
OUTLANDER 1000,2021-09-13,12,1,CO,US,13,2047
OUTLANDER 850,2021-09-13,3,12,CO,US,15,2129
OUTLANDER 450,2021-09-13,4,0,CO,US,4,2018
OUTLANDER 1000,2021-09-20,4,14,CO,US,18,2065
OUTLANDER 850,2021-09-20,13,12,CO,US,25,2154
OUTLANDER 450,2021-09-20,13,15,CO,US,28,2046
OUTLANDER 1000,2021-09-27,11,6,CO,US,17,2082
OUTLANDER 850,2021-09-27,9,8,CO,US,17,2171
OUTLANDER 450,2021-09-27,5,6,CO,US,11,2057
OUTLANDER 1000,2021-10-04,8,10,CO,US,18,2100
OUTLANDER 850,2021-10-04,6,11,CO,US,17,2188
OUTLANDER 450,2021-10-04,15,0,CO,US,15,2072
OUTLANDER 1000,2021-10-11,4,14,CO,US,18,2118
OUTLANDER 850,2021-10-11,0,11,CO,US,11,2199
OUTLANDER 450,2021-10-11,3,4,CO,US,7,2079
OUTLANDER 1000,2021-10-18,14,2,CO,US,16,2134
OUTLANDER 850,2021-10-18,14,1,CO,US,15,2214
OUTLANDER 450,2021-10-18,2,12,CO,US,14,2093
OUTLANDER 1000,2021-10-25,14,11,CO,US,25,2159
OUTLANDER 850,2021-10-25,4,12,CO,US,16,2230
OUTLANDER 450,2021-10-25,1,2,CO,US,3,2096
OUTLANDER 1000,2021-11-01,10,3,CO,US,13,2172
OUTLANDER 850,2021-11-01,10,5,CO,US,15,2245
OUTLANDER 450,2021-11-01,7,11,CO,US,18,2114
OUTLANDER 1000,2021-11-08,1,1,CO,US,2,2174
OUTLANDER 850,2021-11-08,3,13,CO,US,16,2261
OUTLANDER 450,2021-11-08,10,3,CO,US,13,2127
OUTLANDER 1000,2021-11-15,11,3,CO,US,14,2188
OUTLANDER 850,2021-11-15,10,13,CO,US,23,2284
OUTLANDER 450,2021-11-15,1,5,CO,US,6,2133
OUTLANDER 1000,2021-11-22,15,4,CO,US,19,2207
OUTLANDER 850,2021-11-22,5,7,CO,US,12,2296
OUTLANDER 450,2021-11-22,9,13,CO,US,22,2155
OUTLANDER 1000,2021-11-29,2,6,CO,US,8,2215
OUTLANDER 850,2021-11-29,5,1,CO,US,6,2302
OUTLANDER 450,2021-11-29,15,6,CO,US,21,2176
OUTLANDER 1000,2021-12-06,13,3,CO,US,16,2231
OUTLANDER 850,2021-12-06,9,3,CO,US,12,2314
OUTLANDER 450,2021-12-06,1,4,CO,US,5,2181
OUTLANDER 1000,2021-12-13,7,14,CO,US,21,2252
OUTLANDER 850,2021-12-13,2,5,CO,US,7,2321
OUTLANDER 450,2021-12-13,9,5,CO,US,14,2195
OUTLANDER 1000,2021-12-20,13,7,CO,US,20,2272
OUTLANDER 850,2021-12-20,13,7,CO,US,20,2341
OUTLANDER 450,2021-12-20,8,12,CO,US,20,2215
OUTLANDER 1000,2021-12-27,8,0,CO,US,8,2280
OUTLANDER 850,2021-12-27,8,11,CO,US,19,2360
OUTLANDER 450,2021-12-27,8,2,CO,US,10,2225
OUTLANDER 1000,2019-01-07,5,5,CT,US,10,10
OUTLANDER 850,2019-01-07,3,1,CT,US,4,4
OUTLANDER 450,2019-01-07,8,9,CT,US,17,17
OUTLANDER 1000,2019-01-14,13,9,CT,US,22,32
OUTLANDER 850,2019-01-14,1,13,CT,US,14,18
OUTLANDER 450,2019-01-14,5,0,CT,US,5,22
OUTLANDER 1000,2019-01-21,11,10,CT,US,21,53
OUTLANDER 850,2019-01-21,2,8,CT,US,10,28
OUTLANDER 450,2019-01-21,3,8,CT,US,11,33
OUTLANDER 1000,2019-01-28,1,4,CT,US,5,58
OUTLANDER 850,2019-01-28,6,4,CT,US,10,38
OUTLANDER 450,2019-01-28,1,15,CT,US,16,49
OUTLANDER 1000,2019-02-04,7,15,CT,US,22,80
OUTLANDER 850,2019-02-04,1,10,CT,US,11,49
OUTLANDER 450,2019-02-04,8,11,CT,US,19,68
OUTLANDER 1000,2019-02-11,6,10,CT,US,16,96
OUTLANDER 850,2019-02-11,14,3,CT,US,17,66
OUTLANDER 450,2019-02-11,14,14,CT,US,28,96
OUTLANDER 1000,2019-02-18,6,11,CT,US,17,113
OUTLANDER 850,2019-02-18,13,11,CT,US,24,90
OUTLANDER 450,2019-02-18,14,11,CT,US,25,121
OUTLANDER 1000,2019-02-25,11,6,CT,US,17,130
OUTLANDER 850,2019-02-25,2,2,CT,US,4,94
OUTLANDER 450,2019-02-25,3,4,CT,US,7,128
OUTLANDER 1000,2019-03-04,1,8,CT,US,9,139
OUTLANDER 850,2019-03-04,14,4,CT,US,18,112
OUTLANDER 450,2019-03-04,4,2,CT,US,6,134
OUTLANDER 1000,2019-03-11,4,6,CT,US,10,149
OUTLANDER 850,2019-03-11,5,14,CT,US,19,131
OUTLANDER 450,2019-03-11,12,5,CT,US,17,151
OUTLANDER 1000,2019-03-18,13,6,CT,US,19,168
OUTLANDER 850,2019-03-18,13,1,CT,US,14,145
OUTLANDER 450,2019-03-18,10,4,CT,US,14,165
OUTLANDER 1000,2019-03-25,15,10,CT,US,25,193
OUTLANDER 850,2019-03-25,8,4,CT,US,12,157
OUTLANDER 450,2019-03-25,9,8,CT,US,17,182
OUTLANDER 1000,2019-04-01,5,9,CT,US,14,207
OUTLANDER 850,2019-04-01,7,2,CT,US,9,166
OUTLANDER 450,2019-04-01,13,4,CT,US,17,199
OUTLANDER 1000,2019-04-08,8,15,CT,US,23,230
OUTLANDER 850,2019-04-08,9,4,CT,US,13,179
OUTLANDER 450,2019-04-08,2,6,CT,US,8,207
OUTLANDER 1000,2019-04-15,10,10,CT,US,20,250
OUTLANDER 850,2019-04-15,9,5,CT,US,14,193
OUTLANDER 450,2019-04-15,14,9,CT,US,23,230
OUTLANDER 1000,2019-04-22,3,14,CT,US,17,267
OUTLANDER 850,2019-04-22,2,14,CT,US,16,209
OUTLANDER 450,2019-04-22,12,14,CT,US,26,256
OUTLANDER 1000,2019-04-29,10,6,CT,US,16,283
OUTLANDER 850,2019-04-29,4,9,CT,US,13,222
OUTLANDER 450,2019-04-29,13,1,CT,US,14,270
OUTLANDER 1000,2019-05-06,11,7,CT,US,18,301
OUTLANDER 850,2019-05-06,7,6,CT,US,13,235
OUTLANDER 450,2019-05-06,10,10,CT,US,20,290
OUTLANDER 1000,2019-05-13,2,8,CT,US,10,311
OUTLANDER 850,2019-05-13,7,3,CT,US,10,245
OUTLANDER 450,2019-05-13,14,0,CT,US,14,304
OUTLANDER 1000,2019-05-20,4,0,CT,US,4,315
OUTLANDER 850,2019-05-20,5,0,CT,US,5,250
OUTLANDER 450,2019-05-20,4,10,CT,US,14,318
OUTLANDER 1000,2019-05-27,11,15,CT,US,26,341
OUTLANDER 850,2019-05-27,11,5,CT,US,16,266
OUTLANDER 450,2019-05-27,1,7,CT,US,8,326
OUTLANDER 1000,2019-06-03,7,9,CT,US,16,357
OUTLANDER 850,2019-06-03,12,7,CT,US,19,285
OUTLANDER 450,2019-06-03,7,1,CT,US,8,334
OUTLANDER 1000,2019-06-10,4,2,CT,US,6,363
OUTLANDER 850,2019-06-10,3,13,CT,US,16,301
OUTLANDER 450,2019-06-10,4,2,CT,US,6,340
OUTLANDER 1000,2019-06-17,7,13,CT,US,20,383
OUTLANDER 850,2019-06-17,6,1,CT,US,7,308
OUTLANDER 450,2019-06-17,9,8,CT,US,17,357
OUTLANDER 1000,2019-06-24,4,10,CT,US,14,397
OUTLANDER 850,2019-06-24,7,4,CT,US,11,319
OUTLANDER 450,2019-06-24,1,11,CT,US,12,369
OUTLANDER 1000,2019-07-01,13,6,CT,US,19,416
OUTLANDER 850,2019-07-01,10,11,CT,US,21,340
OUTLANDER 450,2019-07-01,14,3,CT,US,17,386
OUTLANDER 1000,2019-07-08,3,7,CT,US,10,426
OUTLANDER 850,2019-07-08,6,1,CT,US,7,347
OUTLANDER 450,2019-07-08,1,1,CT,US,2,388
OUTLANDER 1000,2019-07-15,5,5,CT,US,10,436
OUTLANDER 850,2019-07-15,0,8,CT,US,8,355
OUTLANDER 450,2019-07-15,15,2,CT,US,17,405
OUTLANDER 1000,2019-07-22,5,4,CT,US,9,445
OUTLANDER 850,2019-07-22,3,10,CT,US,13,368
OUTLANDER 450,2019-07-22,15,14,CT,US,29,434
OUTLANDER 1000,2019-07-29,11,13,CT,US,24,469
OUTLANDER 850,2019-07-29,11,11,CT,US,22,390
OUTLANDER 450,2019-07-29,14,15,CT,US,29,463
OUTLANDER 1000,2019-08-05,10,14,CT,US,24,493
OUTLANDER 850,2019-08-05,14,14,CT,US,28,418
OUTLANDER 450,2019-08-05,10,1,CT,US,11,474
OUTLANDER 1000,2019-08-12,3,3,CT,US,6,499
OUTLANDER 850,2019-08-12,7,12,CT,US,19,437
OUTLANDER 450,2019-08-12,3,2,CT,US,5,479
OUTLANDER 1000,2019-08-19,0,4,CT,US,4,503
OUTLANDER 850,2019-08-19,7,2,CT,US,9,446
OUTLANDER 450,2019-08-19,3,0,CT,US,3,482
OUTLANDER 1000,2019-08-26,8,11,CT,US,19,522
OUTLANDER 850,2019-08-26,13,2,CT,US,15,461
OUTLANDER 450,2019-08-26,13,3,CT,US,16,498
OUTLANDER 1000,2019-09-02,1,2,CT,US,3,525
OUTLANDER 850,2019-09-02,5,5,CT,US,10,471
OUTLANDER 450,2019-09-02,8,6,CT,US,14,512
OUTLANDER 1000,2019-09-09,0,11,CT,US,11,536
OUTLANDER 850,2019-09-09,13,12,CT,US,25,496
OUTLANDER 450,2019-09-09,7,12,CT,US,19,531
OUTLANDER 1000,2019-09-16,15,15,CT,US,30,566
OUTLANDER 850,2019-09-16,10,11,CT,US,21,517
OUTLANDER 450,2019-09-16,13,5,CT,US,18,549
OUTLANDER 1000,2019-09-23,9,12,CT,US,21,587
OUTLANDER 850,2019-09-23,4,14,CT,US,18,535
OUTLANDER 450,2019-09-23,5,14,CT,US,19,568
OUTLANDER 1000,2019-09-30,12,9,CT,US,21,608
OUTLANDER 850,2019-09-30,11,3,CT,US,14,549
OUTLANDER 450,2019-09-30,15,4,CT,US,19,587
OUTLANDER 1000,2019-10-07,6,4,CT,US,10,618
OUTLANDER 850,2019-10-07,5,2,CT,US,7,556
OUTLANDER 450,2019-10-07,12,0,CT,US,12,599
OUTLANDER 1000,2019-10-14,6,6,CT,US,12,630
OUTLANDER 850,2019-10-14,6,15,CT,US,21,577
OUTLANDER 450,2019-10-14,11,14,CT,US,25,624
OUTLANDER 1000,2019-10-21,3,13,CT,US,16,646
OUTLANDER 850,2019-10-21,5,14,CT,US,19,596
OUTLANDER 450,2019-10-21,8,13,CT,US,21,645
OUTLANDER 1000,2019-10-28,5,1,CT,US,6,652
OUTLANDER 850,2019-10-28,2,15,CT,US,17,613
OUTLANDER 450,2019-10-28,8,11,CT,US,19,664
OUTLANDER 1000,2019-11-04,5,4,CT,US,9,661
OUTLANDER 850,2019-11-04,11,1,CT,US,12,625
OUTLANDER 450,2019-11-04,14,13,CT,US,27,691
OUTLANDER 1000,2019-11-11,7,5,CT,US,12,673
OUTLANDER 850,2019-11-11,13,1,CT,US,14,639
OUTLANDER 450,2019-11-11,0,7,CT,US,7,698
OUTLANDER 1000,2019-11-18,3,3,CT,US,6,679
OUTLANDER 850,2019-11-18,7,1,CT,US,8,647
OUTLANDER 450,2019-11-18,10,12,CT,US,22,720
OUTLANDER 1000,2019-11-25,4,12,CT,US,16,695
OUTLANDER 850,2019-11-25,1,8,CT,US,9,656
OUTLANDER 450,2019-11-25,5,4,CT,US,9,729
OUTLANDER 1000,2019-12-02,10,13,CT,US,23,718
OUTLANDER 850,2019-12-02,5,1,CT,US,6,662
OUTLANDER 450,2019-12-02,8,12,CT,US,20,749
OUTLANDER 1000,2019-12-09,10,6,CT,US,16,734
OUTLANDER 850,2019-12-09,7,1,CT,US,8,670
OUTLANDER 450,2019-12-09,15,11,CT,US,26,775
OUTLANDER 1000,2019-12-16,14,5,CT,US,19,753
OUTLANDER 850,2019-12-16,0,5,CT,US,5,675
OUTLANDER 450,2019-12-16,3,5,CT,US,8,783
OUTLANDER 1000,2019-12-23,1,6,CT,US,7,760
OUTLANDER 850,2019-12-23,10,8,CT,US,18,693
OUTLANDER 450,2019-12-23,9,0,CT,US,9,792
OUTLANDER 1000,2019-12-30,8,2,CT,US,10,770
OUTLANDER 850,2019-12-30,10,7,CT,US,17,710
OUTLANDER 450,2019-12-30,5,13,CT,US,18,810
OUTLANDER 1000,2020-01-06,12,10,CT,US,22,792
OUTLANDER 850,2020-01-06,9,1,CT,US,10,720
OUTLANDER 450,2020-01-06,6,13,CT,US,19,829
OUTLANDER 1000,2020-01-13,2,3,CT,US,5,797
OUTLANDER 850,2020-01-13,2,12,CT,US,14,734
OUTLANDER 450,2020-01-13,6,3,CT,US,9,838
OUTLANDER 1000,2020-01-20,1,9,CT,US,10,807
OUTLANDER 850,2020-01-20,0,9,CT,US,9,743
OUTLANDER 450,2020-01-20,9,11,CT,US,20,858
OUTLANDER 1000,2020-01-27,14,0,CT,US,14,821
OUTLANDER 850,2020-01-27,9,0,CT,US,9,752
OUTLANDER 450,2020-01-27,6,3,CT,US,9,867
OUTLANDER 1000,2020-02-03,1,8,CT,US,9,830
OUTLANDER 850,2020-02-03,9,8,CT,US,17,769
OUTLANDER 450,2020-02-03,9,13,CT,US,22,889
OUTLANDER 1000,2020-02-10,7,2,CT,US,9,839
OUTLANDER 850,2020-02-10,7,10,CT,US,17,786
OUTLANDER 450,2020-02-10,3,4,CT,US,7,896
OUTLANDER 1000,2020-02-17,11,3,CT,US,14,853
OUTLANDER 850,2020-02-17,9,11,CT,US,20,806
OUTLANDER 450,2020-02-17,2,4,CT,US,6,902
OUTLANDER 1000,2020-02-24,1,6,CT,US,7,860
OUTLANDER 850,2020-02-24,1,9,CT,US,10,816
OUTLANDER 450,2020-02-24,2,7,CT,US,9,911
OUTLANDER 1000,2020-03-02,1,6,CT,US,7,867
OUTLANDER 850,2020-03-02,9,2,CT,US,11,827
OUTLANDER 450,2020-03-02,10,1,CT,US,11,922
OUTLANDER 1000,2020-03-09,4,12,CT,US,16,883
OUTLANDER 850,2020-03-09,9,11,CT,US,20,847
OUTLANDER 450,2020-03-09,0,4,CT,US,4,926
OUTLANDER 1000,2020-03-16,9,4,CT,US,13,896
OUTLANDER 850,2020-03-16,11,9,CT,US,20,867
OUTLANDER 450,2020-03-16,9,9,CT,US,18,944
OUTLANDER 1000,2020-03-23,14,2,CT,US,16,912
OUTLANDER 850,2020-03-23,7,1,CT,US,8,875
OUTLANDER 450,2020-03-23,7,7,CT,US,14,958
OUTLANDER 1000,2020-03-30,5,12,CT,US,17,929
OUTLANDER 850,2020-03-30,11,14,CT,US,25,900
OUTLANDER 450,2020-03-30,6,5,CT,US,11,969
OUTLANDER 1000,2020-04-06,8,5,CT,US,13,942
OUTLANDER 850,2020-04-06,10,13,CT,US,23,923
OUTLANDER 450,2020-04-06,7,8,CT,US,15,984
OUTLANDER 1000,2020-04-13,10,2,CT,US,12,954
OUTLANDER 850,2020-04-13,1,12,CT,US,13,936
OUTLANDER 450,2020-04-13,7,1,CT,US,8,992
OUTLANDER 1000,2020-04-20,3,12,CT,US,15,969
OUTLANDER 850,2020-04-20,12,11,CT,US,23,959
OUTLANDER 450,2020-04-20,3,6,CT,US,9,1001
OUTLANDER 1000,2020-04-27,4,9,CT,US,13,982
OUTLANDER 850,2020-04-27,9,10,CT,US,19,978
OUTLANDER 450,2020-04-27,6,14,CT,US,20,1021
OUTLANDER 1000,2020-05-04,11,7,CT,US,18,1000
OUTLANDER 850,2020-05-04,7,14,CT,US,21,999
OUTLANDER 450,2020-05-04,14,2,CT,US,16,1037
OUTLANDER 1000,2020-05-11,13,15,CT,US,28,1028
OUTLANDER 850,2020-05-11,6,9,CT,US,15,1014
OUTLANDER 450,2020-05-11,4,1,CT,US,5,1042
OUTLANDER 1000,2020-05-18,7,1,CT,US,8,1036
OUTLANDER 850,2020-05-18,5,4,CT,US,9,1023
OUTLANDER 450,2020-05-18,9,1,CT,US,10,1052
OUTLANDER 1000,2020-05-25,14,4,CT,US,18,1054
OUTLANDER 850,2020-05-25,13,8,CT,US,21,1044
OUTLANDER 450,2020-05-25,14,13,CT,US,27,1079
OUTLANDER 1000,2020-06-01,11,3,CT,US,14,1068
OUTLANDER 850,2020-06-01,6,9,CT,US,15,1059
OUTLANDER 450,2020-06-01,3,15,CT,US,18,1097
OUTLANDER 1000,2020-06-08,6,13,CT,US,19,1087
OUTLANDER 850,2020-06-08,14,2,CT,US,16,1075
OUTLANDER 450,2020-06-08,13,8,CT,US,21,1118
OUTLANDER 1000,2020-06-15,3,3,CT,US,6,1093
OUTLANDER 850,2020-06-15,11,15,CT,US,26,1101
OUTLANDER 450,2020-06-15,2,4,CT,US,6,1124
OUTLANDER 1000,2020-06-22,4,14,CT,US,18,1111
OUTLANDER 850,2020-06-22,8,11,CT,US,19,1120
OUTLANDER 450,2020-06-22,4,3,CT,US,7,1131
OUTLANDER 1000,2020-06-29,0,8,CT,US,8,1119
OUTLANDER 850,2020-06-29,5,10,CT,US,15,1135
OUTLANDER 450,2020-06-29,14,7,CT,US,21,1152
OUTLANDER 1000,2020-07-06,5,0,CT,US,5,1124
OUTLANDER 850,2020-07-06,8,14,CT,US,22,1157
OUTLANDER 450,2020-07-06,1,11,CT,US,12,1164
OUTLANDER 1000,2020-07-13,9,6,CT,US,15,1139
OUTLANDER 850,2020-07-13,8,9,CT,US,17,1174
OUTLANDER 450,2020-07-13,14,5,CT,US,19,1183
OUTLANDER 1000,2020-07-20,12,1,CT,US,13,1152
OUTLANDER 850,2020-07-20,10,11,CT,US,21,1195
OUTLANDER 450,2020-07-20,3,11,CT,US,14,1197
OUTLANDER 1000,2020-07-27,2,6,CT,US,8,1160
OUTLANDER 850,2020-07-27,3,9,CT,US,12,1207
OUTLANDER 450,2020-07-27,10,8,CT,US,18,1215
OUTLANDER 1000,2020-08-03,3,2,CT,US,5,1165
OUTLANDER 850,2020-08-03,14,9,CT,US,23,1230
OUTLANDER 450,2020-08-03,10,0,CT,US,10,1225
OUTLANDER 1000,2020-08-10,12,8,CT,US,20,1185
OUTLANDER 850,2020-08-10,10,5,CT,US,15,1245
OUTLANDER 450,2020-08-10,14,6,CT,US,20,1245
OUTLANDER 1000,2020-08-17,4,9,CT,US,13,1198
OUTLANDER 850,2020-08-17,14,11,CT,US,25,1270
OUTLANDER 450,2020-08-17,2,7,CT,US,9,1254
OUTLANDER 1000,2020-08-24,5,14,CT,US,19,1217
OUTLANDER 850,2020-08-24,2,8,CT,US,10,1280
OUTLANDER 450,2020-08-24,8,10,CT,US,18,1272
OUTLANDER 1000,2020-08-31,13,9,CT,US,22,1239
OUTLANDER 850,2020-08-31,14,7,CT,US,21,1301
OUTLANDER 450,2020-08-31,9,7,CT,US,16,1288
OUTLANDER 1000,2020-09-07,14,14,CT,US,28,1267
OUTLANDER 850,2020-09-07,1,8,CT,US,9,1310
OUTLANDER 450,2020-09-07,1,7,CT,US,8,1296
OUTLANDER 1000,2020-09-14,1,13,CT,US,14,1281
OUTLANDER 850,2020-09-14,6,7,CT,US,13,1323
OUTLANDER 450,2020-09-14,9,2,CT,US,11,1307
OUTLANDER 1000,2020-09-21,3,5,CT,US,8,1289
OUTLANDER 850,2020-09-21,7,15,CT,US,22,1345
OUTLANDER 450,2020-09-21,5,3,CT,US,8,1315
OUTLANDER 1000,2020-09-28,7,11,CT,US,18,1307
OUTLANDER 850,2020-09-28,9,0,CT,US,9,1354
OUTLANDER 450,2020-09-28,11,8,CT,US,19,1334
OUTLANDER 1000,2020-10-05,10,1,CT,US,11,1318
OUTLANDER 850,2020-10-05,8,11,CT,US,19,1373
OUTLANDER 450,2020-10-05,4,2,CT,US,6,1340
OUTLANDER 1000,2020-10-12,8,7,CT,US,15,1333
OUTLANDER 850,2020-10-12,1,4,CT,US,5,1378
OUTLANDER 450,2020-10-12,9,13,CT,US,22,1362
OUTLANDER 1000,2020-10-19,13,13,CT,US,26,1359
OUTLANDER 850,2020-10-19,1,4,CT,US,5,1383
OUTLANDER 450,2020-10-19,14,3,CT,US,17,1379
OUTLANDER 1000,2020-10-26,9,2,CT,US,11,1370
OUTLANDER 850,2020-10-26,5,1,CT,US,6,1389
OUTLANDER 450,2020-10-26,12,2,CT,US,14,1393
OUTLANDER 1000,2020-11-02,9,1,CT,US,10,1380
OUTLANDER 850,2020-11-02,6,13,CT,US,19,1408
OUTLANDER 450,2020-11-02,9,15,CT,US,24,1417
OUTLANDER 1000,2020-11-09,10,15,CT,US,25,1405
OUTLANDER 850,2020-11-09,2,5,CT,US,7,1415
OUTLANDER 450,2020-11-09,3,7,CT,US,10,1427
OUTLANDER 1000,2020-11-16,10,11,CT,US,21,1426
OUTLANDER 850,2020-11-16,4,8,CT,US,12,1427
OUTLANDER 450,2020-11-16,4,14,CT,US,18,1445
OUTLANDER 1000,2020-11-23,7,9,CT,US,16,1442
OUTLANDER 850,2020-11-23,7,9,CT,US,16,1443
OUTLANDER 450,2020-11-23,12,4,CT,US,16,1461
OUTLANDER 1000,2020-11-30,9,13,CT,US,22,1464
OUTLANDER 850,2020-11-30,6,8,CT,US,14,1457
OUTLANDER 450,2020-11-30,8,6,CT,US,14,1475
OUTLANDER 1000,2020-12-07,3,4,CT,US,7,1471
OUTLANDER 850,2020-12-07,4,1,CT,US,5,1462
OUTLANDER 450,2020-12-07,13,9,CT,US,22,1497
OUTLANDER 1000,2020-12-14,5,15,CT,US,20,1491
OUTLANDER 850,2020-12-14,3,8,CT,US,11,1473
OUTLANDER 450,2020-12-14,7,3,CT,US,10,1507
OUTLANDER 1000,2020-12-21,2,13,CT,US,15,1506
OUTLANDER 850,2020-12-21,8,8,CT,US,16,1489
OUTLANDER 450,2020-12-21,3,13,CT,US,16,1523
OUTLANDER 1000,2020-12-28,12,3,CT,US,15,1521
OUTLANDER 850,2020-12-28,14,11,CT,US,25,1514
OUTLANDER 450,2020-12-28,11,4,CT,US,15,1538
OUTLANDER 1000,2021-01-04,14,12,CT,US,26,1547
OUTLANDER 850,2021-01-04,9,3,CT,US,12,1526
OUTLANDER 450,2021-01-04,10,3,CT,US,13,1551
OUTLANDER 1000,2021-01-11,4,6,CT,US,10,1557
OUTLANDER 850,2021-01-11,12,10,CT,US,22,1548
OUTLANDER 450,2021-01-11,3,10,CT,US,13,1564
OUTLANDER 1000,2021-01-18,11,3,CT,US,14,1571
OUTLANDER 850,2021-01-18,9,4,CT,US,13,1561
OUTLANDER 450,2021-01-18,1,8,CT,US,9,1573
OUTLANDER 1000,2021-01-25,10,4,CT,US,14,1585
OUTLANDER 850,2021-01-25,8,1,CT,US,9,1570
OUTLANDER 450,2021-01-25,12,8,CT,US,20,1593
OUTLANDER 1000,2021-02-01,7,4,CT,US,11,1596
OUTLANDER 850,2021-02-01,4,7,CT,US,11,1581
OUTLANDER 450,2021-02-01,6,3,CT,US,9,1602
OUTLANDER 1000,2021-02-08,6,10,CT,US,16,1612
OUTLANDER 850,2021-02-08,4,4,CT,US,8,1589
OUTLANDER 450,2021-02-08,3,7,CT,US,10,1612
OUTLANDER 1000,2021-02-15,7,10,CT,US,17,1629
OUTLANDER 850,2021-02-15,2,15,CT,US,17,1606
OUTLANDER 450,2021-02-15,6,1,CT,US,7,1619
OUTLANDER 1000,2021-02-22,14,0,CT,US,14,1643
OUTLANDER 850,2021-02-22,6,7,CT,US,13,1619
OUTLANDER 450,2021-02-22,7,11,CT,US,18,1637
OUTLANDER 1000,2021-03-01,12,14,CT,US,26,1669
OUTLANDER 850,2021-03-01,9,8,CT,US,17,1636
OUTLANDER 450,2021-03-01,6,9,CT,US,15,1652
OUTLANDER 1000,2021-03-08,1,10,CT,US,11,1680
OUTLANDER 850,2021-03-08,13,7,CT,US,20,1656
OUTLANDER 450,2021-03-08,8,9,CT,US,17,1669
OUTLANDER 1000,2021-03-15,3,6,CT,US,9,1689
OUTLANDER 850,2021-03-15,8,3,CT,US,11,1667
OUTLANDER 450,2021-03-15,14,12,CT,US,26,1695
OUTLANDER 1000,2021-03-22,10,0,CT,US,10,1699
OUTLANDER 850,2021-03-22,13,8,CT,US,21,1688
OUTLANDER 450,2021-03-22,6,5,CT,US,11,1706
OUTLANDER 1000,2021-03-29,3,12,CT,US,15,1714
OUTLANDER 850,2021-03-29,4,7,CT,US,11,1699
OUTLANDER 450,2021-03-29,5,12,CT,US,17,1723
OUTLANDER 1000,2021-04-05,4,11,CT,US,15,1729
OUTLANDER 850,2021-04-05,3,6,CT,US,9,1708
OUTLANDER 450,2021-04-05,7,10,CT,US,17,1740
OUTLANDER 1000,2021-04-12,13,3,CT,US,16,1745
OUTLANDER 850,2021-04-12,6,15,CT,US,21,1729
OUTLANDER 450,2021-04-12,6,8,CT,US,14,1754
OUTLANDER 1000,2021-04-19,3,0,CT,US,3,1748
OUTLANDER 850,2021-04-19,1,12,CT,US,13,1742
OUTLANDER 450,2021-04-19,1,3,CT,US,4,1758
OUTLANDER 1000,2021-04-26,9,4,CT,US,13,1761
OUTLANDER 850,2021-04-26,13,9,CT,US,22,1764
OUTLANDER 450,2021-04-26,0,3,CT,US,3,1761
OUTLANDER 1000,2021-05-03,5,9,CT,US,14,1775
OUTLANDER 850,2021-05-03,13,9,CT,US,22,1786
OUTLANDER 450,2021-05-03,2,5,CT,US,7,1768
OUTLANDER 1000,2021-05-10,5,3,CT,US,8,1783
OUTLANDER 850,2021-05-10,1,8,CT,US,9,1795
OUTLANDER 450,2021-05-10,13,5,CT,US,18,1786
OUTLANDER 1000,2021-05-17,12,8,CT,US,20,1803
OUTLANDER 850,2021-05-17,4,14,CT,US,18,1813
OUTLANDER 450,2021-05-17,11,1,CT,US,12,1798
OUTLANDER 1000,2021-05-24,1,6,CT,US,7,1810
OUTLANDER 850,2021-05-24,5,5,CT,US,10,1823
OUTLANDER 450,2021-05-24,13,6,CT,US,19,1817
OUTLANDER 1000,2021-05-31,10,6,CT,US,16,1826
OUTLANDER 850,2021-05-31,9,12,CT,US,21,1844
OUTLANDER 450,2021-05-31,9,0,CT,US,9,1826
OUTLANDER 1000,2021-06-07,7,13,CT,US,20,1846
OUTLANDER 850,2021-06-07,8,6,CT,US,14,1858
OUTLANDER 450,2021-06-07,12,2,CT,US,14,1840
OUTLANDER 1000,2021-06-14,13,5,CT,US,18,1864
OUTLANDER 850,2021-06-14,11,7,CT,US,18,1876
OUTLANDER 450,2021-06-14,5,4,CT,US,9,1849
OUTLANDER 1000,2021-06-21,9,11,CT,US,20,1884
OUTLANDER 850,2021-06-21,8,6,CT,US,14,1890
OUTLANDER 450,2021-06-21,9,9,CT,US,18,1867
OUTLANDER 1000,2021-06-28,6,12,CT,US,18,1902
OUTLANDER 850,2021-06-28,15,2,CT,US,17,1907
OUTLANDER 450,2021-06-28,10,0,CT,US,10,1877
OUTLANDER 1000,2021-07-05,14,4,CT,US,18,1920
OUTLANDER 850,2021-07-05,13,6,CT,US,19,1926
OUTLANDER 450,2021-07-05,1,14,CT,US,15,1892
OUTLANDER 1000,2021-07-12,12,6,CT,US,18,1938
OUTLANDER 850,2021-07-12,14,14,CT,US,28,1954
OUTLANDER 450,2021-07-12,1,11,CT,US,12,1904
OUTLANDER 1000,2021-07-19,5,14,CT,US,19,1957
OUTLANDER 850,2021-07-19,6,12,CT,US,18,1972
OUTLANDER 450,2021-07-19,7,9,CT,US,16,1920
OUTLANDER 1000,2021-07-26,12,4,CT,US,16,1973
OUTLANDER 850,2021-07-26,14,4,CT,US,18,1990
OUTLANDER 450,2021-07-26,8,2,CT,US,10,1930
OUTLANDER 1000,2021-08-02,11,10,CT,US,21,1994
OUTLANDER 850,2021-08-02,7,6,CT,US,13,2003
OUTLANDER 450,2021-08-02,14,12,CT,US,26,1956
OUTLANDER 1000,2021-08-09,14,8,CT,US,22,2016
OUTLANDER 850,2021-08-09,4,0,CT,US,4,2007
OUTLANDER 450,2021-08-09,2,13,CT,US,15,1971
OUTLANDER 1000,2021-08-16,14,7,CT,US,21,2037
OUTLANDER 850,2021-08-16,8,8,CT,US,16,2023
OUTLANDER 450,2021-08-16,13,9,CT,US,22,1993
OUTLANDER 1000,2021-08-23,9,14,CT,US,23,2060
OUTLANDER 850,2021-08-23,11,12,CT,US,23,2046
OUTLANDER 450,2021-08-23,9,5,CT,US,14,2007
OUTLANDER 1000,2021-08-30,7,13,CT,US,20,2080
OUTLANDER 850,2021-08-30,14,13,CT,US,27,2073
OUTLANDER 450,2021-08-30,13,5,CT,US,18,2025
OUTLANDER 1000,2021-09-06,6,4,CT,US,10,2090
OUTLANDER 850,2021-09-06,4,9,CT,US,13,2086
OUTLANDER 450,2021-09-06,10,4,CT,US,14,2039
OUTLANDER 1000,2021-09-13,2,7,CT,US,9,2099
OUTLANDER 850,2021-09-13,14,6,CT,US,20,2106
OUTLANDER 450,2021-09-13,7,6,CT,US,13,2052
OUTLANDER 1000,2021-09-20,2,5,CT,US,7,2106
OUTLANDER 850,2021-09-20,10,11,CT,US,21,2127
OUTLANDER 450,2021-09-20,8,12,CT,US,20,2072
OUTLANDER 1000,2021-09-27,8,9,CT,US,17,2123
OUTLANDER 850,2021-09-27,11,15,CT,US,26,2153
OUTLANDER 450,2021-09-27,10,4,CT,US,14,2086
OUTLANDER 1000,2021-10-04,2,8,CT,US,10,2133
OUTLANDER 850,2021-10-04,13,3,CT,US,16,2169
OUTLANDER 450,2021-10-04,10,3,CT,US,13,2099
OUTLANDER 1000,2021-10-11,3,2,CT,US,5,2138
OUTLANDER 850,2021-10-11,8,11,CT,US,19,2188
OUTLANDER 450,2021-10-11,7,1,CT,US,8,2107
OUTLANDER 1000,2021-10-18,7,7,CT,US,14,2152
OUTLANDER 850,2021-10-18,13,14,CT,US,27,2215
OUTLANDER 450,2021-10-18,3,9,CT,US,12,2119
OUTLANDER 1000,2021-10-25,11,9,CT,US,20,2172
OUTLANDER 850,2021-10-25,9,9,CT,US,18,2233
OUTLANDER 450,2021-10-25,8,15,CT,US,23,2142
OUTLANDER 1000,2021-11-01,14,14,CT,US,28,2200
OUTLANDER 850,2021-11-01,14,9,CT,US,23,2256
OUTLANDER 450,2021-11-01,2,6,CT,US,8,2150
OUTLANDER 1000,2021-11-08,5,1,CT,US,6,2206
OUTLANDER 850,2021-11-08,10,11,CT,US,21,2277
OUTLANDER 450,2021-11-08,3,1,CT,US,4,2154
OUTLANDER 1000,2021-11-15,6,3,CT,US,9,2215
OUTLANDER 850,2021-11-15,13,6,CT,US,19,2296
OUTLANDER 450,2021-11-15,1,1,CT,US,2,2156
OUTLANDER 1000,2021-11-22,1,15,CT,US,16,2231
OUTLANDER 850,2021-11-22,7,10,CT,US,17,2313
OUTLANDER 450,2021-11-22,15,3,CT,US,18,2174
OUTLANDER 1000,2021-11-29,9,4,CT,US,13,2244
OUTLANDER 850,2021-11-29,9,12,CT,US,21,2334
OUTLANDER 450,2021-11-29,4,14,CT,US,18,2192
OUTLANDER 1000,2021-12-06,12,5,CT,US,17,2261
OUTLANDER 850,2021-12-06,1,4,CT,US,5,2339
OUTLANDER 450,2021-12-06,7,4,CT,US,11,2203
OUTLANDER 1000,2021-12-13,5,14,CT,US,19,2280
OUTLANDER 850,2021-12-13,9,5,CT,US,14,2353
OUTLANDER 450,2021-12-13,13,10,CT,US,23,2226
OUTLANDER 1000,2021-12-20,11,14,CT,US,25,2305
OUTLANDER 850,2021-12-20,7,12,CT,US,19,2372
OUTLANDER 450,2021-12-20,11,13,CT,US,24,2250
OUTLANDER 1000,2021-12-27,5,11,CT,US,16,2321
OUTLANDER 850,2021-12-27,0,12,CT,US,12,2384
OUTLANDER 450,2021-12-27,11,13,CT,US,24,2274
OUTLANDER 1000,2019-01-07,11,9,DE,US,20,20
OUTLANDER 850,2019-01-07,13,11,DE,US,24,24
OUTLANDER 450,2019-01-07,4,12,DE,US,16,16
OUTLANDER 1000,2019-01-14,7,1,DE,US,8,28
OUTLANDER 850,2019-01-14,11,12,DE,US,23,47
OUTLANDER 450,2019-01-14,8,6,DE,US,14,30
OUTLANDER 1000,2019-01-21,11,14,DE,US,25,53
OUTLANDER 850,2019-01-21,7,1,DE,US,8,55
OUTLANDER 450,2019-01-21,2,13,DE,US,15,45
OUTLANDER 1000,2019-01-28,6,1,DE,US,7,60
OUTLANDER 850,2019-01-28,11,11,DE,US,22,77
OUTLANDER 450,2019-01-28,8,3,DE,US,11,56
OUTLANDER 1000,2019-02-04,2,8,DE,US,10,70
OUTLANDER 850,2019-02-04,14,0,DE,US,14,91
OUTLANDER 450,2019-02-04,4,6,DE,US,10,66
OUTLANDER 1000,2019-02-11,7,12,DE,US,19,89
OUTLANDER 850,2019-02-11,3,1,DE,US,4,95
OUTLANDER 450,2019-02-11,1,15,DE,US,16,82
OUTLANDER 1000,2019-02-18,11,7,DE,US,18,107
OUTLANDER 850,2019-02-18,8,8,DE,US,16,111
OUTLANDER 450,2019-02-18,9,2,DE,US,11,93
OUTLANDER 1000,2019-02-25,9,3,DE,US,12,119
OUTLANDER 850,2019-02-25,10,9,DE,US,19,130
OUTLANDER 450,2019-02-25,6,14,DE,US,20,113
OUTLANDER 1000,2019-03-04,5,4,DE,US,9,128
OUTLANDER 850,2019-03-04,7,0,DE,US,7,137
OUTLANDER 450,2019-03-04,15,5,DE,US,20,133
OUTLANDER 1000,2019-03-11,3,13,DE,US,16,144
OUTLANDER 850,2019-03-11,12,8,DE,US,20,157
OUTLANDER 450,2019-03-11,3,4,DE,US,7,140
OUTLANDER 1000,2019-03-18,9,6,DE,US,15,159
OUTLANDER 850,2019-03-18,14,5,DE,US,19,176
OUTLANDER 450,2019-03-18,12,12,DE,US,24,164
OUTLANDER 1000,2019-03-25,9,14,DE,US,23,182
OUTLANDER 850,2019-03-25,4,10,DE,US,14,190
OUTLANDER 450,2019-03-25,3,11,DE,US,14,178
OUTLANDER 1000,2019-04-01,7,13,DE,US,20,202
OUTLANDER 850,2019-04-01,14,15,DE,US,29,219
OUTLANDER 450,2019-04-01,1,9,DE,US,10,188
OUTLANDER 1000,2019-04-08,5,7,DE,US,12,214
OUTLANDER 850,2019-04-08,10,3,DE,US,13,232
OUTLANDER 450,2019-04-08,5,13,DE,US,18,206
OUTLANDER 1000,2019-04-15,1,7,DE,US,8,222
OUTLANDER 850,2019-04-15,7,7,DE,US,14,246
OUTLANDER 450,2019-04-15,4,9,DE,US,13,219
OUTLANDER 1000,2019-04-22,14,7,DE,US,21,243
OUTLANDER 850,2019-04-22,12,2,DE,US,14,260
OUTLANDER 450,2019-04-22,9,10,DE,US,19,238
OUTLANDER 1000,2019-04-29,13,14,DE,US,27,270
OUTLANDER 850,2019-04-29,9,11,DE,US,20,280
OUTLANDER 450,2019-04-29,9,1,DE,US,10,248
OUTLANDER 1000,2019-05-06,4,13,DE,US,17,287
OUTLANDER 850,2019-05-06,8,10,DE,US,18,298
OUTLANDER 450,2019-05-06,11,2,DE,US,13,261
OUTLANDER 1000,2019-05-13,8,12,DE,US,20,307
OUTLANDER 850,2019-05-13,1,12,DE,US,13,311
OUTLANDER 450,2019-05-13,12,8,DE,US,20,281
OUTLANDER 1000,2019-05-20,8,7,DE,US,15,322
OUTLANDER 850,2019-05-20,10,6,DE,US,16,327
OUTLANDER 450,2019-05-20,4,11,DE,US,15,296
OUTLANDER 1000,2019-05-27,5,13,DE,US,18,340
OUTLANDER 850,2019-05-27,11,8,DE,US,19,346
OUTLANDER 450,2019-05-27,9,13,DE,US,22,318
OUTLANDER 1000,2019-06-03,4,13,DE,US,17,357
OUTLANDER 850,2019-06-03,14,2,DE,US,16,362
OUTLANDER 450,2019-06-03,8,2,DE,US,10,328
OUTLANDER 1000,2019-06-10,5,13,DE,US,18,375
OUTLANDER 850,2019-06-10,14,7,DE,US,21,383
OUTLANDER 450,2019-06-10,14,11,DE,US,25,353
OUTLANDER 1000,2019-06-17,3,15,DE,US,18,393
OUTLANDER 850,2019-06-17,8,15,DE,US,23,406
OUTLANDER 450,2019-06-17,15,5,DE,US,20,373
OUTLANDER 1000,2019-06-24,6,11,DE,US,17,410
OUTLANDER 850,2019-06-24,1,3,DE,US,4,410
OUTLANDER 450,2019-06-24,13,4,DE,US,17,390
OUTLANDER 1000,2019-07-01,12,10,DE,US,22,432
OUTLANDER 850,2019-07-01,0,10,DE,US,10,420
OUTLANDER 450,2019-07-01,4,3,DE,US,7,397
OUTLANDER 1000,2019-07-08,8,8,DE,US,16,448
OUTLANDER 850,2019-07-08,13,4,DE,US,17,437
OUTLANDER 450,2019-07-08,13,12,DE,US,25,422
OUTLANDER 1000,2019-07-15,13,0,DE,US,13,461
OUTLANDER 850,2019-07-15,8,6,DE,US,14,451
OUTLANDER 450,2019-07-15,12,3,DE,US,15,437
OUTLANDER 1000,2019-07-22,6,1,DE,US,7,468
OUTLANDER 850,2019-07-22,10,5,DE,US,15,466
OUTLANDER 450,2019-07-22,8,8,DE,US,16,453
OUTLANDER 1000,2019-07-29,5,5,DE,US,10,478
OUTLANDER 850,2019-07-29,9,0,DE,US,9,475
OUTLANDER 450,2019-07-29,11,7,DE,US,18,471
OUTLANDER 1000,2019-08-05,9,12,DE,US,21,499
OUTLANDER 850,2019-08-05,3,3,DE,US,6,481
OUTLANDER 450,2019-08-05,10,10,DE,US,20,491
OUTLANDER 1000,2019-08-12,9,1,DE,US,10,509
OUTLANDER 850,2019-08-12,14,8,DE,US,22,503
OUTLANDER 450,2019-08-12,9,6,DE,US,15,506
OUTLANDER 1000,2019-08-19,6,7,DE,US,13,522
OUTLANDER 850,2019-08-19,4,0,DE,US,4,507
OUTLANDER 450,2019-08-19,13,3,DE,US,16,522
OUTLANDER 1000,2019-08-26,14,0,DE,US,14,536
OUTLANDER 850,2019-08-26,9,5,DE,US,14,521
OUTLANDER 450,2019-08-26,14,1,DE,US,15,537
OUTLANDER 1000,2019-09-02,3,2,DE,US,5,541
OUTLANDER 850,2019-09-02,4,14,DE,US,18,539
OUTLANDER 450,2019-09-02,3,14,DE,US,17,554
OUTLANDER 1000,2019-09-09,14,13,DE,US,27,568
OUTLANDER 850,2019-09-09,7,7,DE,US,14,553
OUTLANDER 450,2019-09-09,13,4,DE,US,17,571
OUTLANDER 1000,2019-09-16,8,0,DE,US,8,576
OUTLANDER 850,2019-09-16,7,14,DE,US,21,574
OUTLANDER 450,2019-09-16,14,4,DE,US,18,589
OUTLANDER 1000,2019-09-23,2,8,DE,US,10,586
OUTLANDER 850,2019-09-23,3,4,DE,US,7,581
OUTLANDER 450,2019-09-23,5,0,DE,US,5,594
OUTLANDER 1000,2019-09-30,4,2,DE,US,6,592
OUTLANDER 850,2019-09-30,1,6,DE,US,7,588
OUTLANDER 450,2019-09-30,10,2,DE,US,12,606
OUTLANDER 1000,2019-10-07,13,5,DE,US,18,610
OUTLANDER 850,2019-10-07,2,1,DE,US,3,591
OUTLANDER 450,2019-10-07,14,11,DE,US,25,631
OUTLANDER 1000,2019-10-14,0,11,DE,US,11,621
OUTLANDER 850,2019-10-14,7,0,DE,US,7,598
OUTLANDER 450,2019-10-14,6,6,DE,US,12,643
OUTLANDER 1000,2019-10-21,0,8,DE,US,8,629
OUTLANDER 850,2019-10-21,12,6,DE,US,18,616
OUTLANDER 450,2019-10-21,15,1,DE,US,16,659
OUTLANDER 1000,2019-10-28,1,3,DE,US,4,633
OUTLANDER 850,2019-10-28,13,5,DE,US,18,634
OUTLANDER 450,2019-10-28,12,4,DE,US,16,675
OUTLANDER 1000,2019-11-04,11,10,DE,US,21,654
OUTLANDER 850,2019-11-04,14,10,DE,US,24,658
OUTLANDER 450,2019-11-04,0,3,DE,US,3,678
OUTLANDER 1000,2019-11-11,0,13,DE,US,13,667
OUTLANDER 850,2019-11-11,6,2,DE,US,8,666
OUTLANDER 450,2019-11-11,11,15,DE,US,26,704
OUTLANDER 1000,2019-11-18,14,4,DE,US,18,685
OUTLANDER 850,2019-11-18,10,8,DE,US,18,684
OUTLANDER 450,2019-11-18,12,6,DE,US,18,722
OUTLANDER 1000,2019-11-25,11,14,DE,US,25,710
OUTLANDER 850,2019-11-25,14,13,DE,US,27,711
OUTLANDER 450,2019-11-25,7,11,DE,US,18,740
OUTLANDER 1000,2019-12-02,11,9,DE,US,20,730
OUTLANDER 850,2019-12-02,10,4,DE,US,14,725
OUTLANDER 450,2019-12-02,12,9,DE,US,21,761
OUTLANDER 1000,2019-12-09,12,3,DE,US,15,745
OUTLANDER 850,2019-12-09,7,2,DE,US,9,734
OUTLANDER 450,2019-12-09,15,3,DE,US,18,779
OUTLANDER 1000,2019-12-16,4,11,DE,US,15,760
OUTLANDER 850,2019-12-16,12,9,DE,US,21,755
OUTLANDER 450,2019-12-16,6,8,DE,US,14,793
OUTLANDER 1000,2019-12-23,12,5,DE,US,17,777
OUTLANDER 850,2019-12-23,10,15,DE,US,25,780
OUTLANDER 450,2019-12-23,4,12,DE,US,16,809
OUTLANDER 1000,2019-12-30,5,4,DE,US,9,786
OUTLANDER 850,2019-12-30,13,12,DE,US,25,805
OUTLANDER 450,2019-12-30,15,13,DE,US,28,837
OUTLANDER 1000,2020-01-06,2,6,DE,US,8,794
OUTLANDER 850,2020-01-06,2,12,DE,US,14,819
OUTLANDER 450,2020-01-06,5,11,DE,US,16,853
OUTLANDER 1000,2020-01-13,6,5,DE,US,11,805
OUTLANDER 850,2020-01-13,6,13,DE,US,19,838
OUTLANDER 450,2020-01-13,7,0,DE,US,7,860
OUTLANDER 1000,2020-01-20,11,7,DE,US,18,823
OUTLANDER 850,2020-01-20,8,6,DE,US,14,852
OUTLANDER 450,2020-01-20,1,14,DE,US,15,875
OUTLANDER 1000,2020-01-27,3,8,DE,US,11,834
OUTLANDER 850,2020-01-27,1,13,DE,US,14,866
OUTLANDER 450,2020-01-27,13,1,DE,US,14,889
OUTLANDER 1000,2020-02-03,7,2,DE,US,9,843
OUTLANDER 850,2020-02-03,9,2,DE,US,11,877
OUTLANDER 450,2020-02-03,11,8,DE,US,19,908
OUTLANDER 1000,2020-02-10,6,14,DE,US,20,863
OUTLANDER 850,2020-02-10,11,3,DE,US,14,891
OUTLANDER 450,2020-02-10,13,3,DE,US,16,924
OUTLANDER 1000,2020-02-17,12,3,DE,US,15,878
OUTLANDER 850,2020-02-17,10,5,DE,US,15,906
OUTLANDER 450,2020-02-17,3,14,DE,US,17,941
OUTLANDER 1000,2020-02-24,11,10,DE,US,21,899
OUTLANDER 850,2020-02-24,14,3,DE,US,17,923
OUTLANDER 450,2020-02-24,0,1,DE,US,1,942
OUTLANDER 1000,2020-03-02,10,9,DE,US,19,918
OUTLANDER 850,2020-03-02,7,13,DE,US,20,943
OUTLANDER 450,2020-03-02,11,12,DE,US,23,965
OUTLANDER 1000,2020-03-09,10,8,DE,US,18,936
OUTLANDER 850,2020-03-09,5,11,DE,US,16,959
OUTLANDER 450,2020-03-09,6,2,DE,US,8,973
OUTLANDER 1000,2020-03-16,0,9,DE,US,9,945
OUTLANDER 850,2020-03-16,4,14,DE,US,18,977
OUTLANDER 450,2020-03-16,3,0,DE,US,3,976
OUTLANDER 1000,2020-03-23,8,13,DE,US,21,966
OUTLANDER 850,2020-03-23,6,1,DE,US,7,984
OUTLANDER 450,2020-03-23,2,13,DE,US,15,991
OUTLANDER 1000,2020-03-30,3,5,DE,US,8,974
OUTLANDER 850,2020-03-30,0,7,DE,US,7,991
OUTLANDER 450,2020-03-30,6,15,DE,US,21,1012
OUTLANDER 1000,2020-04-06,5,11,DE,US,16,990
OUTLANDER 850,2020-04-06,1,11,DE,US,12,1003
OUTLANDER 450,2020-04-06,2,12,DE,US,14,1026
OUTLANDER 1000,2020-04-13,3,15,DE,US,18,1008
OUTLANDER 850,2020-04-13,14,4,DE,US,18,1021
OUTLANDER 450,2020-04-13,8,13,DE,US,21,1047
OUTLANDER 1000,2020-04-20,9,3,DE,US,12,1020
OUTLANDER 850,2020-04-20,9,13,DE,US,22,1043
OUTLANDER 450,2020-04-20,9,12,DE,US,21,1068
OUTLANDER 1000,2020-04-27,12,10,DE,US,22,1042
OUTLANDER 850,2020-04-27,12,6,DE,US,18,1061
OUTLANDER 450,2020-04-27,2,10,DE,US,12,1080
OUTLANDER 1000,2020-05-04,4,1,DE,US,5,1047
OUTLANDER 850,2020-05-04,2,9,DE,US,11,1072
OUTLANDER 450,2020-05-04,1,3,DE,US,4,1084
OUTLANDER 1000,2020-05-11,6,12,DE,US,18,1065
OUTLANDER 850,2020-05-11,2,2,DE,US,4,1076
OUTLANDER 450,2020-05-11,4,10,DE,US,14,1098
OUTLANDER 1000,2020-05-18,12,7,DE,US,19,1084
OUTLANDER 850,2020-05-18,12,3,DE,US,15,1091
OUTLANDER 450,2020-05-18,5,9,DE,US,14,1112
OUTLANDER 1000,2020-05-25,9,9,DE,US,18,1102
OUTLANDER 850,2020-05-25,0,0,DE,US,0,1091
OUTLANDER 450,2020-05-25,11,13,DE,US,24,1136
OUTLANDER 1000,2020-06-01,3,12,DE,US,15,1117
OUTLANDER 850,2020-06-01,2,9,DE,US,11,1102
OUTLANDER 450,2020-06-01,13,1,DE,US,14,1150
OUTLANDER 1000,2020-06-08,13,10,DE,US,23,1140
OUTLANDER 850,2020-06-08,5,0,DE,US,5,1107
OUTLANDER 450,2020-06-08,2,5,DE,US,7,1157
OUTLANDER 1000,2020-06-15,10,6,DE,US,16,1156
OUTLANDER 850,2020-06-15,2,2,DE,US,4,1111
OUTLANDER 450,2020-06-15,2,14,DE,US,16,1173
OUTLANDER 1000,2020-06-22,12,4,DE,US,16,1172
OUTLANDER 850,2020-06-22,8,14,DE,US,22,1133
OUTLANDER 450,2020-06-22,0,4,DE,US,4,1177
OUTLANDER 1000,2020-06-29,7,10,DE,US,17,1189
OUTLANDER 850,2020-06-29,12,10,DE,US,22,1155
OUTLANDER 450,2020-06-29,8,11,DE,US,19,1196
OUTLANDER 1000,2020-07-06,15,7,DE,US,22,1211
OUTLANDER 850,2020-07-06,13,1,DE,US,14,1169
OUTLANDER 450,2020-07-06,12,10,DE,US,22,1218
OUTLANDER 1000,2020-07-13,12,3,DE,US,15,1226
OUTLANDER 850,2020-07-13,12,10,DE,US,22,1191
OUTLANDER 450,2020-07-13,2,12,DE,US,14,1232
OUTLANDER 1000,2020-07-20,9,4,DE,US,13,1239
OUTLANDER 850,2020-07-20,4,10,DE,US,14,1205
OUTLANDER 450,2020-07-20,2,14,DE,US,16,1248
OUTLANDER 1000,2020-07-27,4,12,DE,US,16,1255
OUTLANDER 850,2020-07-27,11,2,DE,US,13,1218
OUTLANDER 450,2020-07-27,10,8,DE,US,18,1266
OUTLANDER 1000,2020-08-03,2,10,DE,US,12,1267
OUTLANDER 850,2020-08-03,6,1,DE,US,7,1225
OUTLANDER 450,2020-08-03,7,13,DE,US,20,1286
OUTLANDER 1000,2020-08-10,10,3,DE,US,13,1280
OUTLANDER 850,2020-08-10,14,2,DE,US,16,1241
OUTLANDER 450,2020-08-10,2,12,DE,US,14,1300
OUTLANDER 1000,2020-08-17,12,6,DE,US,18,1298
OUTLANDER 850,2020-08-17,14,3,DE,US,17,1258
OUTLANDER 450,2020-08-17,2,4,DE,US,6,1306
OUTLANDER 1000,2020-08-24,0,12,DE,US,12,1310
OUTLANDER 850,2020-08-24,14,1,DE,US,15,1273
OUTLANDER 450,2020-08-24,6,2,DE,US,8,1314
OUTLANDER 1000,2020-08-31,2,7,DE,US,9,1319
OUTLANDER 850,2020-08-31,7,7,DE,US,14,1287
OUTLANDER 450,2020-08-31,6,2,DE,US,8,1322
OUTLANDER 1000,2020-09-07,5,6,DE,US,11,1330
OUTLANDER 850,2020-09-07,8,10,DE,US,18,1305
OUTLANDER 450,2020-09-07,3,14,DE,US,17,1339
OUTLANDER 1000,2020-09-14,5,12,DE,US,17,1347
OUTLANDER 850,2020-09-14,0,7,DE,US,7,1312
OUTLANDER 450,2020-09-14,4,11,DE,US,15,1354
OUTLANDER 1000,2020-09-21,11,12,DE,US,23,1370
OUTLANDER 850,2020-09-21,2,14,DE,US,16,1328
OUTLANDER 450,2020-09-21,3,12,DE,US,15,1369
OUTLANDER 1000,2020-09-28,4,11,DE,US,15,1385
OUTLANDER 850,2020-09-28,0,5,DE,US,5,1333
OUTLANDER 450,2020-09-28,1,7,DE,US,8,1377
OUTLANDER 1000,2020-10-05,15,6,DE,US,21,1406
OUTLANDER 850,2020-10-05,5,5,DE,US,10,1343
OUTLANDER 450,2020-10-05,4,13,DE,US,17,1394
OUTLANDER 1000,2020-10-12,15,5,DE,US,20,1426
OUTLANDER 850,2020-10-12,1,12,DE,US,13,1356
OUTLANDER 450,2020-10-12,8,14,DE,US,22,1416
OUTLANDER 1000,2020-10-19,9,6,DE,US,15,1441
OUTLANDER 850,2020-10-19,11,3,DE,US,14,1370
OUTLANDER 450,2020-10-19,2,14,DE,US,16,1432
OUTLANDER 1000,2020-10-26,3,12,DE,US,15,1456
OUTLANDER 850,2020-10-26,10,5,DE,US,15,1385
OUTLANDER 450,2020-10-26,6,14,DE,US,20,1452
OUTLANDER 1000,2020-11-02,10,5,DE,US,15,1471
OUTLANDER 850,2020-11-02,3,15,DE,US,18,1403
OUTLANDER 450,2020-11-02,5,9,DE,US,14,1466
OUTLANDER 1000,2020-11-09,8,6,DE,US,14,1485
OUTLANDER 850,2020-11-09,8,3,DE,US,11,1414
OUTLANDER 450,2020-11-09,14,3,DE,US,17,1483
OUTLANDER 1000,2020-11-16,8,14,DE,US,22,1507
OUTLANDER 850,2020-11-16,3,14,DE,US,17,1431
OUTLANDER 450,2020-11-16,4,5,DE,US,9,1492
OUTLANDER 1000,2020-11-23,1,8,DE,US,9,1516
OUTLANDER 850,2020-11-23,8,15,DE,US,23,1454
OUTLANDER 450,2020-11-23,8,15,DE,US,23,1515
OUTLANDER 1000,2020-11-30,2,11,DE,US,13,1529
OUTLANDER 850,2020-11-30,4,10,DE,US,14,1468
OUTLANDER 450,2020-11-30,5,14,DE,US,19,1534
OUTLANDER 1000,2020-12-07,9,4,DE,US,13,1542
OUTLANDER 850,2020-12-07,10,1,DE,US,11,1479
OUTLANDER 450,2020-12-07,1,10,DE,US,11,1545
OUTLANDER 1000,2020-12-14,14,2,DE,US,16,1558
OUTLANDER 850,2020-12-14,3,11,DE,US,14,1493
OUTLANDER 450,2020-12-14,3,9,DE,US,12,1557
OUTLANDER 1000,2020-12-21,5,13,DE,US,18,1576
OUTLANDER 850,2020-12-21,13,10,DE,US,23,1516
OUTLANDER 450,2020-12-21,15,7,DE,US,22,1579
OUTLANDER 1000,2020-12-28,4,2,DE,US,6,1582
OUTLANDER 850,2020-12-28,9,1,DE,US,10,1526
OUTLANDER 450,2020-12-28,7,6,DE,US,13,1592
OUTLANDER 1000,2021-01-04,10,4,DE,US,14,1596
OUTLANDER 850,2021-01-04,0,8,DE,US,8,1534
OUTLANDER 450,2021-01-04,14,10,DE,US,24,1616
OUTLANDER 1000,2021-01-11,14,3,DE,US,17,1613
OUTLANDER 850,2021-01-11,3,9,DE,US,12,1546
OUTLANDER 450,2021-01-11,13,11,DE,US,24,1640
OUTLANDER 1000,2021-01-18,8,4,DE,US,12,1625
OUTLANDER 850,2021-01-18,9,7,DE,US,16,1562
OUTLANDER 450,2021-01-18,9,6,DE,US,15,1655
OUTLANDER 1000,2021-01-25,11,6,DE,US,17,1642
OUTLANDER 850,2021-01-25,2,5,DE,US,7,1569
OUTLANDER 450,2021-01-25,8,10,DE,US,18,1673
OUTLANDER 1000,2021-02-01,7,11,DE,US,18,1660
OUTLANDER 850,2021-02-01,6,9,DE,US,15,1584
OUTLANDER 450,2021-02-01,5,1,DE,US,6,1679
OUTLANDER 1000,2021-02-08,11,13,DE,US,24,1684
OUTLANDER 850,2021-02-08,5,7,DE,US,12,1596
OUTLANDER 450,2021-02-08,12,0,DE,US,12,1691
OUTLANDER 1000,2021-02-15,7,3,DE,US,10,1694
OUTLANDER 850,2021-02-15,14,3,DE,US,17,1613
OUTLANDER 450,2021-02-15,1,6,DE,US,7,1698
OUTLANDER 1000,2021-02-22,11,2,DE,US,13,1707
OUTLANDER 850,2021-02-22,15,5,DE,US,20,1633
OUTLANDER 450,2021-02-22,0,3,DE,US,3,1701
OUTLANDER 1000,2021-03-01,1,15,DE,US,16,1723
OUTLANDER 850,2021-03-01,3,1,DE,US,4,1637
OUTLANDER 450,2021-03-01,4,14,DE,US,18,1719
OUTLANDER 1000,2021-03-08,14,11,DE,US,25,1748
OUTLANDER 850,2021-03-08,2,10,DE,US,12,1649
OUTLANDER 450,2021-03-08,8,14,DE,US,22,1741
OUTLANDER 1000,2021-03-15,2,15,DE,US,17,1765
OUTLANDER 850,2021-03-15,0,3,DE,US,3,1652
OUTLANDER 450,2021-03-15,2,8,DE,US,10,1751
OUTLANDER 1000,2021-03-22,4,7,DE,US,11,1776
OUTLANDER 850,2021-03-22,11,5,DE,US,16,1668
OUTLANDER 450,2021-03-22,4,2,DE,US,6,1757
OUTLANDER 1000,2021-03-29,5,3,DE,US,8,1784
OUTLANDER 850,2021-03-29,12,5,DE,US,17,1685
OUTLANDER 450,2021-03-29,4,2,DE,US,6,1763
OUTLANDER 1000,2021-04-05,9,5,DE,US,14,1798
OUTLANDER 850,2021-04-05,14,5,DE,US,19,1704
OUTLANDER 450,2021-04-05,13,12,DE,US,25,1788
OUTLANDER 1000,2021-04-12,7,12,DE,US,19,1817
OUTLANDER 850,2021-04-12,8,12,DE,US,20,1724
OUTLANDER 450,2021-04-12,6,3,DE,US,9,1797
OUTLANDER 1000,2021-04-19,13,8,DE,US,21,1838
OUTLANDER 850,2021-04-19,7,13,DE,US,20,1744
OUTLANDER 450,2021-04-19,11,8,DE,US,19,1816
OUTLANDER 1000,2021-04-26,1,2,DE,US,3,1841
OUTLANDER 850,2021-04-26,9,3,DE,US,12,1756
OUTLANDER 450,2021-04-26,11,6,DE,US,17,1833
OUTLANDER 1000,2021-05-03,1,4,DE,US,5,1846
OUTLANDER 850,2021-05-03,14,6,DE,US,20,1776
OUTLANDER 450,2021-05-03,3,3,DE,US,6,1839
OUTLANDER 1000,2021-05-10,12,14,DE,US,26,1872
OUTLANDER 850,2021-05-10,12,5,DE,US,17,1793
OUTLANDER 450,2021-05-10,8,0,DE,US,8,1847
OUTLANDER 1000,2021-05-17,14,13,DE,US,27,1899
OUTLANDER 850,2021-05-17,7,7,DE,US,14,1807
OUTLANDER 450,2021-05-17,11,3,DE,US,14,1861
OUTLANDER 1000,2021-05-24,14,2,DE,US,16,1915
OUTLANDER 850,2021-05-24,13,9,DE,US,22,1829
OUTLANDER 450,2021-05-24,12,6,DE,US,18,1879
OUTLANDER 1000,2021-05-31,11,9,DE,US,20,1935
OUTLANDER 850,2021-05-31,3,2,DE,US,5,1834
OUTLANDER 450,2021-05-31,14,8,DE,US,22,1901
OUTLANDER 1000,2021-06-07,14,3,DE,US,17,1952
OUTLANDER 850,2021-06-07,11,1,DE,US,12,1846
OUTLANDER 450,2021-06-07,13,13,DE,US,26,1927
OUTLANDER 1000,2021-06-14,2,12,DE,US,14,1966
OUTLANDER 850,2021-06-14,8,13,DE,US,21,1867
OUTLANDER 450,2021-06-14,10,4,DE,US,14,1941
OUTLANDER 1000,2021-06-21,9,12,DE,US,21,1987
OUTLANDER 850,2021-06-21,11,2,DE,US,13,1880
OUTLANDER 450,2021-06-21,8,8,DE,US,16,1957
OUTLANDER 1000,2021-06-28,9,15,DE,US,24,2011
OUTLANDER 850,2021-06-28,13,10,DE,US,23,1903
OUTLANDER 450,2021-06-28,4,2,DE,US,6,1963
OUTLANDER 1000,2021-07-05,14,12,DE,US,26,2037
OUTLANDER 850,2021-07-05,1,14,DE,US,15,1918
OUTLANDER 450,2021-07-05,1,2,DE,US,3,1966
OUTLANDER 1000,2021-07-12,2,11,DE,US,13,2050
OUTLANDER 850,2021-07-12,3,1,DE,US,4,1922
OUTLANDER 450,2021-07-12,2,3,DE,US,5,1971
OUTLANDER 1000,2021-07-19,2,3,DE,US,5,2055
OUTLANDER 850,2021-07-19,10,3,DE,US,13,1935
OUTLANDER 450,2021-07-19,6,1,DE,US,7,1978
OUTLANDER 1000,2021-07-26,2,6,DE,US,8,2063
OUTLANDER 850,2021-07-26,14,2,DE,US,16,1951
OUTLANDER 450,2021-07-26,1,5,DE,US,6,1984
OUTLANDER 1000,2021-08-02,9,11,DE,US,20,2083
OUTLANDER 850,2021-08-02,8,3,DE,US,11,1962
OUTLANDER 450,2021-08-02,10,5,DE,US,15,1999
OUTLANDER 1000,2021-08-09,13,4,DE,US,17,2100
OUTLANDER 850,2021-08-09,12,11,DE,US,23,1985
OUTLANDER 450,2021-08-09,1,14,DE,US,15,2014
OUTLANDER 1000,2021-08-16,7,6,DE,US,13,2113
OUTLANDER 850,2021-08-16,8,1,DE,US,9,1994
OUTLANDER 450,2021-08-16,1,3,DE,US,4,2018
OUTLANDER 1000,2021-08-23,4,13,DE,US,17,2130
OUTLANDER 850,2021-08-23,6,11,DE,US,17,2011
OUTLANDER 450,2021-08-23,5,14,DE,US,19,2037
OUTLANDER 1000,2021-08-30,9,8,DE,US,17,2147
OUTLANDER 850,2021-08-30,10,12,DE,US,22,2033
OUTLANDER 450,2021-08-30,8,6,DE,US,14,2051
OUTLANDER 1000,2021-09-06,4,0,DE,US,4,2151
OUTLANDER 850,2021-09-06,6,9,DE,US,15,2048
OUTLANDER 450,2021-09-06,8,12,DE,US,20,2071
OUTLANDER 1000,2021-09-13,11,11,DE,US,22,2173
OUTLANDER 850,2021-09-13,12,3,DE,US,15,2063
OUTLANDER 450,2021-09-13,11,1,DE,US,12,2083
OUTLANDER 1000,2021-09-20,11,7,DE,US,18,2191
OUTLANDER 850,2021-09-20,4,8,DE,US,12,2075
OUTLANDER 450,2021-09-20,3,13,DE,US,16,2099
OUTLANDER 1000,2021-09-27,7,3,DE,US,10,2201
OUTLANDER 850,2021-09-27,8,5,DE,US,13,2088
OUTLANDER 450,2021-09-27,12,10,DE,US,22,2121
OUTLANDER 1000,2021-10-04,11,7,DE,US,18,2219
OUTLANDER 850,2021-10-04,7,3,DE,US,10,2098
OUTLANDER 450,2021-10-04,8,1,DE,US,9,2130
OUTLANDER 1000,2021-10-11,12,7,DE,US,19,2238
OUTLANDER 850,2021-10-11,5,7,DE,US,12,2110
OUTLANDER 450,2021-10-11,7,10,DE,US,17,2147
OUTLANDER 1000,2021-10-18,10,6,DE,US,16,2254
OUTLANDER 850,2021-10-18,3,3,DE,US,6,2116
OUTLANDER 450,2021-10-18,15,14,DE,US,29,2176
OUTLANDER 1000,2021-10-25,6,8,DE,US,14,2268
OUTLANDER 850,2021-10-25,9,4,DE,US,13,2129
OUTLANDER 450,2021-10-25,13,4,DE,US,17,2193
OUTLANDER 1000,2021-11-01,7,12,DE,US,19,2287
OUTLANDER 850,2021-11-01,15,4,DE,US,19,2148
OUTLANDER 450,2021-11-01,15,1,DE,US,16,2209
OUTLANDER 1000,2021-11-08,12,13,DE,US,25,2312
OUTLANDER 850,2021-11-08,8,4,DE,US,12,2160
OUTLANDER 450,2021-11-08,9,6,DE,US,15,2224
OUTLANDER 1000,2021-11-15,2,14,DE,US,16,2328
OUTLANDER 850,2021-11-15,4,13,DE,US,17,2177
OUTLANDER 450,2021-11-15,13,15,DE,US,28,2252
OUTLANDER 1000,2021-11-22,6,12,DE,US,18,2346
OUTLANDER 850,2021-11-22,11,13,DE,US,24,2201
OUTLANDER 450,2021-11-22,4,2,DE,US,6,2258
OUTLANDER 1000,2021-11-29,4,2,DE,US,6,2352
OUTLANDER 850,2021-11-29,1,13,DE,US,14,2215
OUTLANDER 450,2021-11-29,3,6,DE,US,9,2267
OUTLANDER 1000,2021-12-06,3,12,DE,US,15,2367
OUTLANDER 850,2021-12-06,1,10,DE,US,11,2226
OUTLANDER 450,2021-12-06,7,1,DE,US,8,2275
OUTLANDER 1000,2021-12-13,1,3,DE,US,4,2371
OUTLANDER 850,2021-12-13,10,11,DE,US,21,2247
OUTLANDER 450,2021-12-13,8,5,DE,US,13,2288
OUTLANDER 1000,2021-12-20,1,13,DE,US,14,2385
OUTLANDER 850,2021-12-20,8,6,DE,US,14,2261
OUTLANDER 450,2021-12-20,11,1,DE,US,12,2300
OUTLANDER 1000,2021-12-27,11,10,DE,US,21,2406
OUTLANDER 850,2021-12-27,8,6,DE,US,14,2275
OUTLANDER 450,2021-12-27,8,2,DE,US,10,2310
OUTLANDER 1000,2019-01-07,13,13,FL,US,26,26
OUTLANDER 850,2019-01-07,11,14,FL,US,25,25
OUTLANDER 450,2019-01-07,13,11,FL,US,24,24
OUTLANDER 1000,2019-01-14,13,10,FL,US,23,49
OUTLANDER 850,2019-01-14,11,9,FL,US,20,45
OUTLANDER 450,2019-01-14,9,1,FL,US,10,34
OUTLANDER 1000,2019-01-21,8,9,FL,US,17,66
OUTLANDER 850,2019-01-21,1,13,FL,US,14,59
OUTLANDER 450,2019-01-21,6,10,FL,US,16,50
OUTLANDER 1000,2019-01-28,3,13,FL,US,16,82
OUTLANDER 850,2019-01-28,5,6,FL,US,11,70
OUTLANDER 450,2019-01-28,12,7,FL,US,19,69
OUTLANDER 1000,2019-02-04,10,5,FL,US,15,97
OUTLANDER 850,2019-02-04,9,3,FL,US,12,82
OUTLANDER 450,2019-02-04,13,9,FL,US,22,91
OUTLANDER 1000,2019-02-11,2,2,FL,US,4,101
OUTLANDER 850,2019-02-11,8,3,FL,US,11,93
OUTLANDER 450,2019-02-11,4,5,FL,US,9,100
OUTLANDER 1000,2019-02-18,5,9,FL,US,14,115
OUTLANDER 850,2019-02-18,4,12,FL,US,16,109
OUTLANDER 450,2019-02-18,8,10,FL,US,18,118
OUTLANDER 1000,2019-02-25,13,7,FL,US,20,135
OUTLANDER 850,2019-02-25,13,13,FL,US,26,135
OUTLANDER 450,2019-02-25,12,5,FL,US,17,135
OUTLANDER 1000,2019-03-04,4,6,FL,US,10,145
OUTLANDER 850,2019-03-04,0,12,FL,US,12,147
OUTLANDER 450,2019-03-04,9,1,FL,US,10,145
OUTLANDER 1000,2019-03-11,5,1,FL,US,6,151
OUTLANDER 850,2019-03-11,4,8,FL,US,12,159
OUTLANDER 450,2019-03-11,10,7,FL,US,17,162
OUTLANDER 1000,2019-03-18,1,6,FL,US,7,158
OUTLANDER 850,2019-03-18,12,12,FL,US,24,183
OUTLANDER 450,2019-03-18,8,0,FL,US,8,170
OUTLANDER 1000,2019-03-25,10,8,FL,US,18,176
OUTLANDER 850,2019-03-25,15,7,FL,US,22,205
OUTLANDER 450,2019-03-25,3,15,FL,US,18,188
OUTLANDER 1000,2019-04-01,7,15,FL,US,22,198
OUTLANDER 850,2019-04-01,4,3,FL,US,7,212
OUTLANDER 450,2019-04-01,7,11,FL,US,18,206
OUTLANDER 1000,2019-04-08,12,13,FL,US,25,223
OUTLANDER 850,2019-04-08,10,12,FL,US,22,234
OUTLANDER 450,2019-04-08,14,10,FL,US,24,230
OUTLANDER 1000,2019-04-15,5,13,FL,US,18,241
OUTLANDER 850,2019-04-15,7,5,FL,US,12,246
OUTLANDER 450,2019-04-15,14,7,FL,US,21,251
OUTLANDER 1000,2019-04-22,8,8,FL,US,16,257
OUTLANDER 850,2019-04-22,1,0,FL,US,1,247
OUTLANDER 450,2019-04-22,9,0,FL,US,9,260
OUTLANDER 1000,2019-04-29,12,10,FL,US,22,279
OUTLANDER 850,2019-04-29,10,12,FL,US,22,269
OUTLANDER 450,2019-04-29,2,2,FL,US,4,264
OUTLANDER 1000,2019-05-06,12,13,FL,US,25,304
OUTLANDER 850,2019-05-06,1,14,FL,US,15,284
OUTLANDER 450,2019-05-06,4,5,FL,US,9,273
OUTLANDER 1000,2019-05-13,10,6,FL,US,16,320
OUTLANDER 850,2019-05-13,4,10,FL,US,14,298
OUTLANDER 450,2019-05-13,13,10,FL,US,23,296
OUTLANDER 1000,2019-05-20,9,14,FL,US,23,343
OUTLANDER 850,2019-05-20,5,3,FL,US,8,306
OUTLANDER 450,2019-05-20,2,6,FL,US,8,304
OUTLANDER 1000,2019-05-27,13,15,FL,US,28,371
OUTLANDER 850,2019-05-27,9,11,FL,US,20,326
OUTLANDER 450,2019-05-27,11,14,FL,US,25,329
OUTLANDER 1000,2019-06-03,3,8,FL,US,11,382
OUTLANDER 850,2019-06-03,11,5,FL,US,16,342
OUTLANDER 450,2019-06-03,10,13,FL,US,23,352
OUTLANDER 1000,2019-06-10,7,8,FL,US,15,397
OUTLANDER 850,2019-06-10,13,7,FL,US,20,362
OUTLANDER 450,2019-06-10,2,12,FL,US,14,366
OUTLANDER 1000,2019-06-17,13,10,FL,US,23,420
OUTLANDER 850,2019-06-17,11,9,FL,US,20,382
OUTLANDER 450,2019-06-17,7,0,FL,US,7,373
OUTLANDER 1000,2019-06-24,14,7,FL,US,21,441
OUTLANDER 850,2019-06-24,5,15,FL,US,20,402
OUTLANDER 450,2019-06-24,7,3,FL,US,10,383
OUTLANDER 1000,2019-07-01,3,6,FL,US,9,450
OUTLANDER 850,2019-07-01,8,13,FL,US,21,423
OUTLANDER 450,2019-07-01,4,4,FL,US,8,391
OUTLANDER 1000,2019-07-08,3,11,FL,US,14,464
OUTLANDER 850,2019-07-08,11,8,FL,US,19,442
OUTLANDER 450,2019-07-08,2,7,FL,US,9,400
OUTLANDER 1000,2019-07-15,10,6,FL,US,16,480
OUTLANDER 850,2019-07-15,10,10,FL,US,20,462
OUTLANDER 450,2019-07-15,7,3,FL,US,10,410
OUTLANDER 1000,2019-07-22,1,12,FL,US,13,493
OUTLANDER 850,2019-07-22,14,10,FL,US,24,486
OUTLANDER 450,2019-07-22,14,2,FL,US,16,426
OUTLANDER 1000,2019-07-29,7,2,FL,US,9,502
OUTLANDER 850,2019-07-29,7,11,FL,US,18,504
OUTLANDER 450,2019-07-29,11,7,FL,US,18,444
OUTLANDER 1000,2019-08-05,5,5,FL,US,10,512
OUTLANDER 850,2019-08-05,15,8,FL,US,23,527
OUTLANDER 450,2019-08-05,9,1,FL,US,10,454
OUTLANDER 1000,2019-08-12,5,4,FL,US,9,521
OUTLANDER 850,2019-08-12,8,1,FL,US,9,536
OUTLANDER 450,2019-08-12,12,0,FL,US,12,466
OUTLANDER 1000,2019-08-19,5,7,FL,US,12,533
OUTLANDER 850,2019-08-19,4,9,FL,US,13,549
OUTLANDER 450,2019-08-19,11,8,FL,US,19,485
OUTLANDER 1000,2019-08-26,0,10,FL,US,10,543
OUTLANDER 850,2019-08-26,10,2,FL,US,12,561
OUTLANDER 450,2019-08-26,5,1,FL,US,6,491
OUTLANDER 1000,2019-09-02,7,7,FL,US,14,557
OUTLANDER 850,2019-09-02,4,13,FL,US,17,578
OUTLANDER 450,2019-09-02,7,8,FL,US,15,506
OUTLANDER 1000,2019-09-09,10,0,FL,US,10,567
OUTLANDER 850,2019-09-09,1,0,FL,US,1,579
OUTLANDER 450,2019-09-09,9,9,FL,US,18,524
OUTLANDER 1000,2019-09-16,4,5,FL,US,9,576
OUTLANDER 850,2019-09-16,12,5,FL,US,17,596
OUTLANDER 450,2019-09-16,0,13,FL,US,13,537
OUTLANDER 1000,2019-09-23,9,6,FL,US,15,591
OUTLANDER 850,2019-09-23,1,11,FL,US,12,608
OUTLANDER 450,2019-09-23,4,11,FL,US,15,552
OUTLANDER 1000,2019-09-30,9,11,FL,US,20,611
OUTLANDER 850,2019-09-30,2,13,FL,US,15,623
OUTLANDER 450,2019-09-30,12,13,FL,US,25,577
OUTLANDER 1000,2019-10-07,11,13,FL,US,24,635
OUTLANDER 850,2019-10-07,12,10,FL,US,22,645
OUTLANDER 450,2019-10-07,14,2,FL,US,16,593
OUTLANDER 1000,2019-10-14,3,1,FL,US,4,639
OUTLANDER 850,2019-10-14,4,7,FL,US,11,656
OUTLANDER 450,2019-10-14,5,11,FL,US,16,609
OUTLANDER 1000,2019-10-21,14,14,FL,US,28,667
OUTLANDER 850,2019-10-21,3,0,FL,US,3,659
OUTLANDER 450,2019-10-21,2,8,FL,US,10,619
OUTLANDER 1000,2019-10-28,12,12,FL,US,24,691
OUTLANDER 850,2019-10-28,14,4,FL,US,18,677
OUTLANDER 450,2019-10-28,4,1,FL,US,5,624
OUTLANDER 1000,2019-11-04,7,13,FL,US,20,711
OUTLANDER 850,2019-11-04,8,11,FL,US,19,696
OUTLANDER 450,2019-11-04,5,13,FL,US,18,642
OUTLANDER 1000,2019-11-11,14,7,FL,US,21,732
OUTLANDER 850,2019-11-11,4,0,FL,US,4,700
OUTLANDER 450,2019-11-11,1,10,FL,US,11,653
OUTLANDER 1000,2019-11-18,14,11,FL,US,25,757
OUTLANDER 850,2019-11-18,4,6,FL,US,10,710
OUTLANDER 450,2019-11-18,0,6,FL,US,6,659
OUTLANDER 1000,2019-11-25,13,8,FL,US,21,778
OUTLANDER 850,2019-11-25,0,15,FL,US,15,725
OUTLANDER 450,2019-11-25,3,5,FL,US,8,667
OUTLANDER 1000,2019-12-02,8,8,FL,US,16,794
OUTLANDER 850,2019-12-02,3,5,FL,US,8,733
OUTLANDER 450,2019-12-02,2,2,FL,US,4,671
OUTLANDER 1000,2019-12-09,1,1,FL,US,2,796
OUTLANDER 850,2019-12-09,10,11,FL,US,21,754
OUTLANDER 450,2019-12-09,14,8,FL,US,22,693
OUTLANDER 1000,2019-12-16,3,10,FL,US,13,809
OUTLANDER 850,2019-12-16,4,8,FL,US,12,766
OUTLANDER 450,2019-12-16,8,15,FL,US,23,716
OUTLANDER 1000,2019-12-23,6,3,FL,US,9,818
OUTLANDER 850,2019-12-23,2,10,FL,US,12,778
OUTLANDER 450,2019-12-23,6,11,FL,US,17,733
OUTLANDER 1000,2019-12-30,3,9,FL,US,12,830
OUTLANDER 850,2019-12-30,8,13,FL,US,21,799
OUTLANDER 450,2019-12-30,14,13,FL,US,27,760
OUTLANDER 1000,2020-01-06,0,10,FL,US,10,840
OUTLANDER 850,2020-01-06,6,5,FL,US,11,810
OUTLANDER 450,2020-01-06,12,9,FL,US,21,781
OUTLANDER 1000,2020-01-13,10,5,FL,US,15,855
OUTLANDER 850,2020-01-13,11,4,FL,US,15,825
OUTLANDER 450,2020-01-13,7,6,FL,US,13,794
OUTLANDER 1000,2020-01-20,13,3,FL,US,16,871
OUTLANDER 850,2020-01-20,15,14,FL,US,29,854
OUTLANDER 450,2020-01-20,14,1,FL,US,15,809
OUTLANDER 1000,2020-01-27,3,8,FL,US,11,882
OUTLANDER 850,2020-01-27,13,11,FL,US,24,878
OUTLANDER 450,2020-01-27,14,6,FL,US,20,829
OUTLANDER 1000,2020-02-03,8,0,FL,US,8,890
OUTLANDER 850,2020-02-03,0,2,FL,US,2,880
OUTLANDER 450,2020-02-03,10,10,FL,US,20,849
OUTLANDER 1000,2020-02-10,14,2,FL,US,16,906
OUTLANDER 850,2020-02-10,3,13,FL,US,16,896
OUTLANDER 450,2020-02-10,2,8,FL,US,10,859
OUTLANDER 1000,2020-02-17,8,12,FL,US,20,926
OUTLANDER 850,2020-02-17,7,9,FL,US,16,912
OUTLANDER 450,2020-02-17,2,1,FL,US,3,862
OUTLANDER 1000,2020-02-24,11,1,FL,US,12,938
OUTLANDER 850,2020-02-24,3,8,FL,US,11,923
OUTLANDER 450,2020-02-24,12,13,FL,US,25,887
OUTLANDER 1000,2020-03-02,5,1,FL,US,6,944
OUTLANDER 850,2020-03-02,7,7,FL,US,14,937
OUTLANDER 450,2020-03-02,11,6,FL,US,17,904
OUTLANDER 1000,2020-03-09,2,9,FL,US,11,955
OUTLANDER 850,2020-03-09,11,14,FL,US,25,962
OUTLANDER 450,2020-03-09,11,11,FL,US,22,926
OUTLANDER 1000,2020-03-16,13,3,FL,US,16,971
OUTLANDER 850,2020-03-16,10,7,FL,US,17,979
OUTLANDER 450,2020-03-16,10,8,FL,US,18,944
OUTLANDER 1000,2020-03-23,12,3,FL,US,15,986
OUTLANDER 850,2020-03-23,6,6,FL,US,12,991
OUTLANDER 450,2020-03-23,12,9,FL,US,21,965
OUTLANDER 1000,2020-03-30,5,14,FL,US,19,1005
OUTLANDER 850,2020-03-30,12,14,FL,US,26,1017
OUTLANDER 450,2020-03-30,1,9,FL,US,10,975
OUTLANDER 1000,2020-04-06,7,8,FL,US,15,1020
OUTLANDER 850,2020-04-06,4,4,FL,US,8,1025
OUTLANDER 450,2020-04-06,10,12,FL,US,22,997
OUTLANDER 1000,2020-04-13,5,0,FL,US,5,1025
OUTLANDER 850,2020-04-13,14,8,FL,US,22,1047
OUTLANDER 450,2020-04-13,0,6,FL,US,6,1003
OUTLANDER 1000,2020-04-20,8,3,FL,US,11,1036
OUTLANDER 850,2020-04-20,13,7,FL,US,20,1067
OUTLANDER 450,2020-04-20,12,13,FL,US,25,1028
OUTLANDER 1000,2020-04-27,13,1,FL,US,14,1050
OUTLANDER 850,2020-04-27,2,5,FL,US,7,1074
OUTLANDER 450,2020-04-27,7,2,FL,US,9,1037
OUTLANDER 1000,2020-05-04,12,14,FL,US,26,1076
OUTLANDER 850,2020-05-04,9,5,FL,US,14,1088
OUTLANDER 450,2020-05-04,10,0,FL,US,10,1047
OUTLANDER 1000,2020-05-11,10,14,FL,US,24,1100
OUTLANDER 850,2020-05-11,12,14,FL,US,26,1114
OUTLANDER 450,2020-05-11,4,4,FL,US,8,1055
OUTLANDER 1000,2020-05-18,10,6,FL,US,16,1116
OUTLANDER 850,2020-05-18,3,14,FL,US,17,1131
OUTLANDER 450,2020-05-18,3,10,FL,US,13,1068
OUTLANDER 1000,2020-05-25,10,5,FL,US,15,1131
OUTLANDER 850,2020-05-25,2,3,FL,US,5,1136
OUTLANDER 450,2020-05-25,10,3,FL,US,13,1081
OUTLANDER 1000,2020-06-01,9,4,FL,US,13,1144
OUTLANDER 850,2020-06-01,6,15,FL,US,21,1157
OUTLANDER 450,2020-06-01,11,8,FL,US,19,1100
OUTLANDER 1000,2020-06-08,10,14,FL,US,24,1168
OUTLANDER 850,2020-06-08,10,5,FL,US,15,1172
OUTLANDER 450,2020-06-08,14,13,FL,US,27,1127
OUTLANDER 1000,2020-06-15,11,13,FL,US,24,1192
OUTLANDER 850,2020-06-15,5,0,FL,US,5,1177
OUTLANDER 450,2020-06-15,2,7,FL,US,9,1136
OUTLANDER 1000,2020-06-22,4,12,FL,US,16,1208
OUTLANDER 850,2020-06-22,7,3,FL,US,10,1187
OUTLANDER 450,2020-06-22,3,1,FL,US,4,1140
OUTLANDER 1000,2020-06-29,10,8,FL,US,18,1226
OUTLANDER 850,2020-06-29,6,11,FL,US,17,1204
OUTLANDER 450,2020-06-29,8,7,FL,US,15,1155
OUTLANDER 1000,2020-07-06,2,2,FL,US,4,1230
OUTLANDER 850,2020-07-06,9,6,FL,US,15,1219
OUTLANDER 450,2020-07-06,3,8,FL,US,11,1166
OUTLANDER 1000,2020-07-13,2,9,FL,US,11,1241
OUTLANDER 850,2020-07-13,13,6,FL,US,19,1238
OUTLANDER 450,2020-07-13,5,2,FL,US,7,1173
OUTLANDER 1000,2020-07-20,9,5,FL,US,14,1255
OUTLANDER 850,2020-07-20,7,0,FL,US,7,1245
OUTLANDER 450,2020-07-20,10,3,FL,US,13,1186
OUTLANDER 1000,2020-07-27,5,9,FL,US,14,1269
OUTLANDER 850,2020-07-27,4,2,FL,US,6,1251
OUTLANDER 450,2020-07-27,2,12,FL,US,14,1200
OUTLANDER 1000,2020-08-03,10,10,FL,US,20,1289
OUTLANDER 850,2020-08-03,8,0,FL,US,8,1259
OUTLANDER 450,2020-08-03,10,14,FL,US,24,1224
OUTLANDER 1000,2020-08-10,2,15,FL,US,17,1306
OUTLANDER 850,2020-08-10,4,0,FL,US,4,1263
OUTLANDER 450,2020-08-10,5,10,FL,US,15,1239
OUTLANDER 1000,2020-08-17,12,3,FL,US,15,1321
OUTLANDER 850,2020-08-17,12,7,FL,US,19,1282
OUTLANDER 450,2020-08-17,8,3,FL,US,11,1250
OUTLANDER 1000,2020-08-24,11,6,FL,US,17,1338
OUTLANDER 850,2020-08-24,11,7,FL,US,18,1300
OUTLANDER 450,2020-08-24,5,2,FL,US,7,1257
OUTLANDER 1000,2020-08-31,6,12,FL,US,18,1356
OUTLANDER 850,2020-08-31,8,9,FL,US,17,1317
OUTLANDER 450,2020-08-31,5,10,FL,US,15,1272
OUTLANDER 1000,2020-09-07,13,11,FL,US,24,1380
OUTLANDER 850,2020-09-07,7,5,FL,US,12,1329
OUTLANDER 450,2020-09-07,1,10,FL,US,11,1283
OUTLANDER 1000,2020-09-14,2,7,FL,US,9,1389
OUTLANDER 850,2020-09-14,7,2,FL,US,9,1338
OUTLANDER 450,2020-09-14,9,11,FL,US,20,1303
OUTLANDER 1000,2020-09-21,7,9,FL,US,16,1405
OUTLANDER 850,2020-09-21,14,2,FL,US,16,1354
OUTLANDER 450,2020-09-21,0,9,FL,US,9,1312
OUTLANDER 1000,2020-09-28,5,6,FL,US,11,1416
OUTLANDER 850,2020-09-28,11,10,FL,US,21,1375
OUTLANDER 450,2020-09-28,7,10,FL,US,17,1329
OUTLANDER 1000,2020-10-05,2,14,FL,US,16,1432
OUTLANDER 850,2020-10-05,13,5,FL,US,18,1393
OUTLANDER 450,2020-10-05,4,6,FL,US,10,1339
OUTLANDER 1000,2020-10-12,1,2,FL,US,3,1435
OUTLANDER 850,2020-10-12,10,8,FL,US,18,1411
OUTLANDER 450,2020-10-12,6,5,FL,US,11,1350
OUTLANDER 1000,2020-10-19,9,13,FL,US,22,1457
OUTLANDER 850,2020-10-19,13,7,FL,US,20,1431
OUTLANDER 450,2020-10-19,9,2,FL,US,11,1361
OUTLANDER 1000,2020-10-26,5,14,FL,US,19,1476
OUTLANDER 850,2020-10-26,3,8,FL,US,11,1442
OUTLANDER 450,2020-10-26,1,9,FL,US,10,1371
OUTLANDER 1000,2020-11-02,3,8,FL,US,11,1487
OUTLANDER 850,2020-11-02,7,1,FL,US,8,1450
OUTLANDER 450,2020-11-02,13,10,FL,US,23,1394
OUTLANDER 1000,2020-11-09,6,2,FL,US,8,1495
OUTLANDER 850,2020-11-09,15,9,FL,US,24,1474
OUTLANDER 450,2020-11-09,1,1,FL,US,2,1396
OUTLANDER 1000,2020-11-16,9,2,FL,US,11,1506
OUTLANDER 850,2020-11-16,4,1,FL,US,5,1479
OUTLANDER 450,2020-11-16,11,4,FL,US,15,1411
OUTLANDER 1000,2020-11-23,12,2,FL,US,14,1520
OUTLANDER 850,2020-11-23,4,11,FL,US,15,1494
OUTLANDER 450,2020-11-23,1,12,FL,US,13,1424
OUTLANDER 1000,2020-11-30,6,15,FL,US,21,1541
OUTLANDER 850,2020-11-30,5,2,FL,US,7,1501
OUTLANDER 450,2020-11-30,5,7,FL,US,12,1436
OUTLANDER 1000,2020-12-07,14,14,FL,US,28,1569
OUTLANDER 850,2020-12-07,10,8,FL,US,18,1519
OUTLANDER 450,2020-12-07,9,9,FL,US,18,1454
OUTLANDER 1000,2020-12-14,4,5,FL,US,9,1578
OUTLANDER 850,2020-12-14,10,11,FL,US,21,1540
OUTLANDER 450,2020-12-14,2,14,FL,US,16,1470
OUTLANDER 1000,2020-12-21,6,11,FL,US,17,1595
OUTLANDER 850,2020-12-21,7,11,FL,US,18,1558
OUTLANDER 450,2020-12-21,5,6,FL,US,11,1481
OUTLANDER 1000,2020-12-28,13,6,FL,US,19,1614
OUTLANDER 850,2020-12-28,12,13,FL,US,25,1583
OUTLANDER 450,2020-12-28,4,1,FL,US,5,1486
OUTLANDER 1000,2021-01-04,13,8,FL,US,21,1635
OUTLANDER 850,2021-01-04,9,2,FL,US,11,1594
OUTLANDER 450,2021-01-04,12,12,FL,US,24,1510
OUTLANDER 1000,2021-01-11,7,9,FL,US,16,1651
OUTLANDER 850,2021-01-11,13,0,FL,US,13,1607
OUTLANDER 450,2021-01-11,9,9,FL,US,18,1528
OUTLANDER 1000,2021-01-18,15,10,FL,US,25,1676
OUTLANDER 850,2021-01-18,2,10,FL,US,12,1619
OUTLANDER 450,2021-01-18,9,6,FL,US,15,1543
OUTLANDER 1000,2021-01-25,0,7,FL,US,7,1683
OUTLANDER 850,2021-01-25,8,14,FL,US,22,1641
OUTLANDER 450,2021-01-25,7,6,FL,US,13,1556
OUTLANDER 1000,2021-02-01,6,7,FL,US,13,1696
OUTLANDER 850,2021-02-01,1,6,FL,US,7,1648
OUTLANDER 450,2021-02-01,9,4,FL,US,13,1569
OUTLANDER 1000,2021-02-08,12,2,FL,US,14,1710
OUTLANDER 850,2021-02-08,3,13,FL,US,16,1664
OUTLANDER 450,2021-02-08,10,5,FL,US,15,1584
OUTLANDER 1000,2021-02-15,4,8,FL,US,12,1722
OUTLANDER 850,2021-02-15,14,10,FL,US,24,1688
OUTLANDER 450,2021-02-15,6,5,FL,US,11,1595
OUTLANDER 1000,2021-02-22,1,4,FL,US,5,1727
OUTLANDER 850,2021-02-22,14,7,FL,US,21,1709
OUTLANDER 450,2021-02-22,1,14,FL,US,15,1610
OUTLANDER 1000,2021-03-01,3,8,FL,US,11,1738
OUTLANDER 850,2021-03-01,1,4,FL,US,5,1714
OUTLANDER 450,2021-03-01,8,13,FL,US,21,1631
OUTLANDER 1000,2021-03-08,7,2,FL,US,9,1747
OUTLANDER 850,2021-03-08,14,7,FL,US,21,1735
OUTLANDER 450,2021-03-08,10,6,FL,US,16,1647
OUTLANDER 1000,2021-03-15,4,2,FL,US,6,1753
OUTLANDER 850,2021-03-15,4,13,FL,US,17,1752
OUTLANDER 450,2021-03-15,3,3,FL,US,6,1653
OUTLANDER 1000,2021-03-22,8,14,FL,US,22,1775
OUTLANDER 850,2021-03-22,8,7,FL,US,15,1767
OUTLANDER 450,2021-03-22,4,6,FL,US,10,1663
OUTLANDER 1000,2021-03-29,4,0,FL,US,4,1779
OUTLANDER 850,2021-03-29,5,8,FL,US,13,1780
OUTLANDER 450,2021-03-29,14,11,FL,US,25,1688
OUTLANDER 1000,2021-04-05,2,13,FL,US,15,1794
OUTLANDER 850,2021-04-05,3,13,FL,US,16,1796
OUTLANDER 450,2021-04-05,5,7,FL,US,12,1700
OUTLANDER 1000,2021-04-12,11,4,FL,US,15,1809
OUTLANDER 850,2021-04-12,13,6,FL,US,19,1815
OUTLANDER 450,2021-04-12,6,6,FL,US,12,1712
OUTLANDER 1000,2021-04-19,4,1,FL,US,5,1814
OUTLANDER 850,2021-04-19,5,13,FL,US,18,1833
OUTLANDER 450,2021-04-19,2,15,FL,US,17,1729
OUTLANDER 1000,2021-04-26,0,5,FL,US,5,1819
OUTLANDER 850,2021-04-26,1,8,FL,US,9,1842
OUTLANDER 450,2021-04-26,12,7,FL,US,19,1748
OUTLANDER 1000,2021-05-03,12,13,FL,US,25,1844
OUTLANDER 850,2021-05-03,13,0,FL,US,13,1855
OUTLANDER 450,2021-05-03,13,9,FL,US,22,1770
OUTLANDER 1000,2021-05-10,9,15,FL,US,24,1868
OUTLANDER 850,2021-05-10,14,8,FL,US,22,1877
OUTLANDER 450,2021-05-10,8,4,FL,US,12,1782
OUTLANDER 1000,2021-05-17,9,4,FL,US,13,1881
OUTLANDER 850,2021-05-17,1,14,FL,US,15,1892
OUTLANDER 450,2021-05-17,9,7,FL,US,16,1798
OUTLANDER 1000,2021-05-24,6,6,FL,US,12,1893
OUTLANDER 850,2021-05-24,5,9,FL,US,14,1906
OUTLANDER 450,2021-05-24,14,8,FL,US,22,1820
OUTLANDER 1000,2021-05-31,13,5,FL,US,18,1911
OUTLANDER 850,2021-05-31,15,14,FL,US,29,1935
OUTLANDER 450,2021-05-31,0,15,FL,US,15,1835
OUTLANDER 1000,2021-06-07,13,5,FL,US,18,1929
OUTLANDER 850,2021-06-07,6,9,FL,US,15,1950
OUTLANDER 450,2021-06-07,4,7,FL,US,11,1846
OUTLANDER 1000,2021-06-14,7,11,FL,US,18,1947
OUTLANDER 850,2021-06-14,7,10,FL,US,17,1967
OUTLANDER 450,2021-06-14,12,0,FL,US,12,1858
OUTLANDER 1000,2021-06-21,3,11,FL,US,14,1961
OUTLANDER 850,2021-06-21,9,11,FL,US,20,1987
OUTLANDER 450,2021-06-21,13,7,FL,US,20,1878
OUTLANDER 1000,2021-06-28,10,13,FL,US,23,1984
OUTLANDER 850,2021-06-28,11,4,FL,US,15,2002
OUTLANDER 450,2021-06-28,5,12,FL,US,17,1895
OUTLANDER 1000,2021-07-05,7,2,FL,US,9,1993
OUTLANDER 850,2021-07-05,5,9,FL,US,14,2016
OUTLANDER 450,2021-07-05,7,8,FL,US,15,1910
OUTLANDER 1000,2021-07-12,5,7,FL,US,12,2005
OUTLANDER 850,2021-07-12,8,8,FL,US,16,2032
OUTLANDER 450,2021-07-12,12,10,FL,US,22,1932
OUTLANDER 1000,2021-07-19,14,7,FL,US,21,2026
OUTLANDER 850,2021-07-19,11,15,FL,US,26,2058
OUTLANDER 450,2021-07-19,6,13,FL,US,19,1951
OUTLANDER 1000,2021-07-26,3,4,FL,US,7,2033
OUTLANDER 850,2021-07-26,12,12,FL,US,24,2082
OUTLANDER 450,2021-07-26,9,3,FL,US,12,1963
OUTLANDER 1000,2021-08-02,5,13,FL,US,18,2051
OUTLANDER 850,2021-08-02,1,13,FL,US,14,2096
OUTLANDER 450,2021-08-02,12,2,FL,US,14,1977
OUTLANDER 1000,2021-08-09,1,7,FL,US,8,2059
OUTLANDER 850,2021-08-09,13,7,FL,US,20,2116
OUTLANDER 450,2021-08-09,14,14,FL,US,28,2005
OUTLANDER 1000,2021-08-16,14,10,FL,US,24,2083
OUTLANDER 850,2021-08-16,3,11,FL,US,14,2130
OUTLANDER 450,2021-08-16,10,9,FL,US,19,2024
OUTLANDER 1000,2021-08-23,12,13,FL,US,25,2108
OUTLANDER 850,2021-08-23,9,1,FL,US,10,2140
OUTLANDER 450,2021-08-23,12,14,FL,US,26,2050
OUTLANDER 1000,2021-08-30,10,10,FL,US,20,2128
OUTLANDER 850,2021-08-30,15,0,FL,US,15,2155
OUTLANDER 450,2021-08-30,13,14,FL,US,27,2077
OUTLANDER 1000,2021-09-06,5,2,FL,US,7,2135
OUTLANDER 850,2021-09-06,2,4,FL,US,6,2161
OUTLANDER 450,2021-09-06,15,5,FL,US,20,2097
OUTLANDER 1000,2021-09-13,14,11,FL,US,25,2160
OUTLANDER 850,2021-09-13,5,3,FL,US,8,2169
OUTLANDER 450,2021-09-13,11,9,FL,US,20,2117
OUTLANDER 1000,2021-09-20,14,9,FL,US,23,2183
OUTLANDER 850,2021-09-20,5,10,FL,US,15,2184
OUTLANDER 450,2021-09-20,7,4,FL,US,11,2128
OUTLANDER 1000,2021-09-27,0,0,FL,US,0,2183
OUTLANDER 850,2021-09-27,8,2,FL,US,10,2194
OUTLANDER 450,2021-09-27,7,12,FL,US,19,2147
OUTLANDER 1000,2021-10-04,2,11,FL,US,13,2196
OUTLANDER 850,2021-10-04,0,2,FL,US,2,2196
OUTLANDER 450,2021-10-04,14,11,FL,US,25,2172
OUTLANDER 1000,2021-10-11,9,10,FL,US,19,2215
OUTLANDER 850,2021-10-11,2,7,FL,US,9,2205
OUTLANDER 450,2021-10-11,13,6,FL,US,19,2191
OUTLANDER 1000,2021-10-18,8,12,FL,US,20,2235
OUTLANDER 850,2021-10-18,11,2,FL,US,13,2218
OUTLANDER 450,2021-10-18,6,15,FL,US,21,2212
OUTLANDER 1000,2021-10-25,2,4,FL,US,6,2241
OUTLANDER 850,2021-10-25,12,2,FL,US,14,2232
OUTLANDER 450,2021-10-25,8,1,FL,US,9,2221
OUTLANDER 1000,2021-11-01,0,2,FL,US,2,2243
OUTLANDER 850,2021-11-01,15,3,FL,US,18,2250
OUTLANDER 450,2021-11-01,1,8,FL,US,9,2230
OUTLANDER 1000,2021-11-08,11,6,FL,US,17,2260
OUTLANDER 850,2021-11-08,6,2,FL,US,8,2258
OUTLANDER 450,2021-11-08,14,1,FL,US,15,2245
OUTLANDER 1000,2021-11-15,10,8,FL,US,18,2278
OUTLANDER 850,2021-11-15,7,12,FL,US,19,2277
OUTLANDER 450,2021-11-15,10,6,FL,US,16,2261
OUTLANDER 1000,2021-11-22,14,9,FL,US,23,2301
OUTLANDER 850,2021-11-22,10,13,FL,US,23,2300
OUTLANDER 450,2021-11-22,8,4,FL,US,12,2273
OUTLANDER 1000,2021-11-29,10,2,FL,US,12,2313
OUTLANDER 850,2021-11-29,3,3,FL,US,6,2306
OUTLANDER 450,2021-11-29,3,3,FL,US,6,2279
OUTLANDER 1000,2021-12-06,14,7,FL,US,21,2334
OUTLANDER 850,2021-12-06,3,9,FL,US,12,2318
OUTLANDER 450,2021-12-06,2,11,FL,US,13,2292
OUTLANDER 1000,2021-12-13,15,7,FL,US,22,2356
OUTLANDER 850,2021-12-13,7,11,FL,US,18,2336
OUTLANDER 450,2021-12-13,2,14,FL,US,16,2308
OUTLANDER 1000,2021-12-20,5,14,FL,US,19,2375
OUTLANDER 850,2021-12-20,8,12,FL,US,20,2356
OUTLANDER 450,2021-12-20,10,12,FL,US,22,2330
OUTLANDER 1000,2021-12-27,12,5,FL,US,17,2392
OUTLANDER 850,2021-12-27,12,0,FL,US,12,2368
OUTLANDER 450,2021-12-27,15,5,FL,US,20,2350
OUTLANDER 1000,2019-01-07,4,13,GA,US,17,17
OUTLANDER 850,2019-01-07,1,5,GA,US,6,6
OUTLANDER 450,2019-01-07,7,8,GA,US,15,15
OUTLANDER 1000,2019-01-14,1,11,GA,US,12,29
OUTLANDER 850,2019-01-14,9,6,GA,US,15,21
OUTLANDER 450,2019-01-14,10,9,GA,US,19,34
OUTLANDER 1000,2019-01-21,9,2,GA,US,11,40
OUTLANDER 850,2019-01-21,3,3,GA,US,6,27
OUTLANDER 450,2019-01-21,14,3,GA,US,17,51
OUTLANDER 1000,2019-01-28,0,0,GA,US,0,40
OUTLANDER 850,2019-01-28,12,1,GA,US,13,40
OUTLANDER 450,2019-01-28,10,0,GA,US,10,61
OUTLANDER 1000,2019-02-04,1,10,GA,US,11,51
OUTLANDER 850,2019-02-04,13,15,GA,US,28,68
OUTLANDER 450,2019-02-04,0,4,GA,US,4,65
OUTLANDER 1000,2019-02-11,12,12,GA,US,24,75
OUTLANDER 850,2019-02-11,2,12,GA,US,14,82
OUTLANDER 450,2019-02-11,11,10,GA,US,21,86
OUTLANDER 1000,2019-02-18,8,10,GA,US,18,93
OUTLANDER 850,2019-02-18,14,8,GA,US,22,104
OUTLANDER 450,2019-02-18,10,2,GA,US,12,98
OUTLANDER 1000,2019-02-25,2,0,GA,US,2,95
OUTLANDER 850,2019-02-25,7,14,GA,US,21,125
OUTLANDER 450,2019-02-25,2,3,GA,US,5,103
OUTLANDER 1000,2019-03-04,14,5,GA,US,19,114
OUTLANDER 850,2019-03-04,2,14,GA,US,16,141
OUTLANDER 450,2019-03-04,5,9,GA,US,14,117
OUTLANDER 1000,2019-03-11,13,8,GA,US,21,135
OUTLANDER 850,2019-03-11,1,5,GA,US,6,147
OUTLANDER 450,2019-03-11,9,5,GA,US,14,131
OUTLANDER 1000,2019-03-18,1,8,GA,US,9,144
OUTLANDER 850,2019-03-18,11,9,GA,US,20,167
OUTLANDER 450,2019-03-18,4,1,GA,US,5,136
OUTLANDER 1000,2019-03-25,9,7,GA,US,16,160
OUTLANDER 850,2019-03-25,13,10,GA,US,23,190
OUTLANDER 450,2019-03-25,13,13,GA,US,26,162
OUTLANDER 1000,2019-04-01,9,6,GA,US,15,175
OUTLANDER 850,2019-04-01,0,9,GA,US,9,199
OUTLANDER 450,2019-04-01,3,7,GA,US,10,172
OUTLANDER 1000,2019-04-08,4,8,GA,US,12,187
OUTLANDER 850,2019-04-08,12,5,GA,US,17,216
OUTLANDER 450,2019-04-08,8,7,GA,US,15,187
OUTLANDER 1000,2019-04-15,8,10,GA,US,18,205
OUTLANDER 850,2019-04-15,3,11,GA,US,14,230
OUTLANDER 450,2019-04-15,6,6,GA,US,12,199
OUTLANDER 1000,2019-04-22,5,8,GA,US,13,218
OUTLANDER 850,2019-04-22,0,1,GA,US,1,231
OUTLANDER 450,2019-04-22,7,4,GA,US,11,210
OUTLANDER 1000,2019-04-29,12,13,GA,US,25,243
OUTLANDER 850,2019-04-29,11,11,GA,US,22,253
OUTLANDER 450,2019-04-29,8,9,GA,US,17,227
OUTLANDER 1000,2019-05-06,3,8,GA,US,11,254
OUTLANDER 850,2019-05-06,1,2,GA,US,3,256
OUTLANDER 450,2019-05-06,5,8,GA,US,13,240
OUTLANDER 1000,2019-05-13,4,10,GA,US,14,268
OUTLANDER 850,2019-05-13,14,8,GA,US,22,278
OUTLANDER 450,2019-05-13,7,5,GA,US,12,252
OUTLANDER 1000,2019-05-20,7,6,GA,US,13,281
OUTLANDER 850,2019-05-20,10,3,GA,US,13,291
OUTLANDER 450,2019-05-20,9,6,GA,US,15,267
OUTLANDER 1000,2019-05-27,4,9,GA,US,13,294
OUTLANDER 850,2019-05-27,7,15,GA,US,22,313
OUTLANDER 450,2019-05-27,11,8,GA,US,19,286
OUTLANDER 1000,2019-06-03,12,2,GA,US,14,308
OUTLANDER 850,2019-06-03,14,9,GA,US,23,336
OUTLANDER 450,2019-06-03,9,7,GA,US,16,302
OUTLANDER 1000,2019-06-10,10,3,GA,US,13,321
OUTLANDER 850,2019-06-10,11,7,GA,US,18,354
OUTLANDER 450,2019-06-10,12,8,GA,US,20,322
OUTLANDER 1000,2019-06-17,10,15,GA,US,25,346
OUTLANDER 850,2019-06-17,9,11,GA,US,20,374
OUTLANDER 450,2019-06-17,7,15,GA,US,22,344
OUTLANDER 1000,2019-06-24,8,0,GA,US,8,354
OUTLANDER 850,2019-06-24,1,1,GA,US,2,376
OUTLANDER 450,2019-06-24,12,1,GA,US,13,357
OUTLANDER 1000,2019-07-01,14,9,GA,US,23,377
OUTLANDER 850,2019-07-01,9,3,GA,US,12,388
OUTLANDER 450,2019-07-01,12,8,GA,US,20,377
OUTLANDER 1000,2019-07-08,2,4,GA,US,6,383
OUTLANDER 850,2019-07-08,10,13,GA,US,23,411
OUTLANDER 450,2019-07-08,4,4,GA,US,8,385
OUTLANDER 1000,2019-07-15,14,3,GA,US,17,400
OUTLANDER 850,2019-07-15,9,5,GA,US,14,425
OUTLANDER 450,2019-07-15,4,11,GA,US,15,400
OUTLANDER 1000,2019-07-22,7,4,GA,US,11,411
OUTLANDER 850,2019-07-22,14,10,GA,US,24,449
OUTLANDER 450,2019-07-22,1,1,GA,US,2,402
OUTLANDER 1000,2019-07-29,7,12,GA,US,19,430
OUTLANDER 850,2019-07-29,0,7,GA,US,7,456
OUTLANDER 450,2019-07-29,7,9,GA,US,16,418
OUTLANDER 1000,2019-08-05,2,2,GA,US,4,434
OUTLANDER 850,2019-08-05,7,15,GA,US,22,478
OUTLANDER 450,2019-08-05,3,1,GA,US,4,422
OUTLANDER 1000,2019-08-12,8,7,GA,US,15,449
OUTLANDER 850,2019-08-12,8,10,GA,US,18,496
OUTLANDER 450,2019-08-12,7,13,GA,US,20,442
OUTLANDER 1000,2019-08-19,11,1,GA,US,12,461
OUTLANDER 850,2019-08-19,11,6,GA,US,17,513
OUTLANDER 450,2019-08-19,3,10,GA,US,13,455
OUTLANDER 1000,2019-08-26,13,7,GA,US,20,481
OUTLANDER 850,2019-08-26,3,1,GA,US,4,517
OUTLANDER 450,2019-08-26,9,4,GA,US,13,468
OUTLANDER 1000,2019-09-02,12,14,GA,US,26,507
OUTLANDER 850,2019-09-02,10,3,GA,US,13,530
OUTLANDER 450,2019-09-02,11,4,GA,US,15,483
OUTLANDER 1000,2019-09-09,5,7,GA,US,12,519
OUTLANDER 850,2019-09-09,10,1,GA,US,11,541
OUTLANDER 450,2019-09-09,12,4,GA,US,16,499
OUTLANDER 1000,2019-09-16,8,14,GA,US,22,541
OUTLANDER 850,2019-09-16,6,4,GA,US,10,551
OUTLANDER 450,2019-09-16,10,6,GA,US,16,515
OUTLANDER 1000,2019-09-23,3,14,GA,US,17,558
OUTLANDER 850,2019-09-23,4,2,GA,US,6,557
OUTLANDER 450,2019-09-23,13,13,GA,US,26,541
OUTLANDER 1000,2019-09-30,1,8,GA,US,9,567
OUTLANDER 850,2019-09-30,2,9,GA,US,11,568
OUTLANDER 450,2019-09-30,4,14,GA,US,18,559
OUTLANDER 1000,2019-10-07,9,14,GA,US,23,590
OUTLANDER 850,2019-10-07,8,3,GA,US,11,579
OUTLANDER 450,2019-10-07,2,8,GA,US,10,569
OUTLANDER 1000,2019-10-14,1,10,GA,US,11,601
OUTLANDER 850,2019-10-14,15,13,GA,US,28,607
OUTLANDER 450,2019-10-14,9,4,GA,US,13,582
OUTLANDER 1000,2019-10-21,8,9,GA,US,17,618
OUTLANDER 850,2019-10-21,5,2,GA,US,7,614
OUTLANDER 450,2019-10-21,11,1,GA,US,12,594
OUTLANDER 1000,2019-10-28,0,5,GA,US,5,623
OUTLANDER 850,2019-10-28,2,2,GA,US,4,618
OUTLANDER 450,2019-10-28,13,1,GA,US,14,608
OUTLANDER 1000,2019-11-04,11,4,GA,US,15,638
OUTLANDER 850,2019-11-04,13,13,GA,US,26,644
OUTLANDER 450,2019-11-04,2,6,GA,US,8,616
OUTLANDER 1000,2019-11-11,8,13,GA,US,21,659
OUTLANDER 850,2019-11-11,3,14,GA,US,17,661
OUTLANDER 450,2019-11-11,9,10,GA,US,19,635
OUTLANDER 1000,2019-11-18,10,12,GA,US,22,681
OUTLANDER 850,2019-11-18,12,3,GA,US,15,676
OUTLANDER 450,2019-11-18,13,4,GA,US,17,652
OUTLANDER 1000,2019-11-25,9,11,GA,US,20,701
OUTLANDER 850,2019-11-25,3,2,GA,US,5,681
OUTLANDER 450,2019-11-25,7,6,GA,US,13,665
OUTLANDER 1000,2019-12-02,8,4,GA,US,12,713
OUTLANDER 850,2019-12-02,2,1,GA,US,3,684
OUTLANDER 450,2019-12-02,6,12,GA,US,18,683
OUTLANDER 1000,2019-12-09,14,6,GA,US,20,733
OUTLANDER 850,2019-12-09,14,12,GA,US,26,710
OUTLANDER 450,2019-12-09,2,13,GA,US,15,698
OUTLANDER 1000,2019-12-16,2,11,GA,US,13,746
OUTLANDER 850,2019-12-16,7,2,GA,US,9,719
OUTLANDER 450,2019-12-16,1,13,GA,US,14,712
OUTLANDER 1000,2019-12-23,5,12,GA,US,17,763
OUTLANDER 850,2019-12-23,15,15,GA,US,30,749
OUTLANDER 450,2019-12-23,14,10,GA,US,24,736
OUTLANDER 1000,2019-12-30,6,7,GA,US,13,776
OUTLANDER 850,2019-12-30,14,13,GA,US,27,776
OUTLANDER 450,2019-12-30,14,7,GA,US,21,757
OUTLANDER 1000,2020-01-06,7,8,GA,US,15,791
OUTLANDER 850,2020-01-06,7,1,GA,US,8,784
OUTLANDER 450,2020-01-06,14,5,GA,US,19,776
OUTLANDER 1000,2020-01-13,12,9,GA,US,21,812
OUTLANDER 850,2020-01-13,11,1,GA,US,12,796
OUTLANDER 450,2020-01-13,3,14,GA,US,17,793
OUTLANDER 1000,2020-01-20,6,6,GA,US,12,824
OUTLANDER 850,2020-01-20,10,3,GA,US,13,809
OUTLANDER 450,2020-01-20,5,5,GA,US,10,803
OUTLANDER 1000,2020-01-27,1,12,GA,US,13,837
OUTLANDER 850,2020-01-27,12,13,GA,US,25,834
OUTLANDER 450,2020-01-27,4,14,GA,US,18,821
OUTLANDER 1000,2020-02-03,8,8,GA,US,16,853
OUTLANDER 850,2020-02-03,6,5,GA,US,11,845
OUTLANDER 450,2020-02-03,14,15,GA,US,29,850
OUTLANDER 1000,2020-02-10,2,1,GA,US,3,856
OUTLANDER 850,2020-02-10,14,5,GA,US,19,864
OUTLANDER 450,2020-02-10,1,7,GA,US,8,858
OUTLANDER 1000,2020-02-17,3,14,GA,US,17,873
OUTLANDER 850,2020-02-17,3,14,GA,US,17,881
OUTLANDER 450,2020-02-17,14,6,GA,US,20,878
OUTLANDER 1000,2020-02-24,8,10,GA,US,18,891
OUTLANDER 850,2020-02-24,3,14,GA,US,17,898
OUTLANDER 450,2020-02-24,6,15,GA,US,21,899
OUTLANDER 1000,2020-03-02,8,8,GA,US,16,907
OUTLANDER 850,2020-03-02,7,13,GA,US,20,918
OUTLANDER 450,2020-03-02,6,15,GA,US,21,920
OUTLANDER 1000,2020-03-09,13,7,GA,US,20,927
OUTLANDER 850,2020-03-09,1,5,GA,US,6,924
OUTLANDER 450,2020-03-09,6,13,GA,US,19,939
OUTLANDER 1000,2020-03-16,0,6,GA,US,6,933
OUTLANDER 850,2020-03-16,12,5,GA,US,17,941
OUTLANDER 450,2020-03-16,1,5,GA,US,6,945
OUTLANDER 1000,2020-03-23,15,7,GA,US,22,955
OUTLANDER 850,2020-03-23,6,5,GA,US,11,952
OUTLANDER 450,2020-03-23,7,3,GA,US,10,955
OUTLANDER 1000,2020-03-30,15,7,GA,US,22,977
OUTLANDER 850,2020-03-30,0,1,GA,US,1,953
OUTLANDER 450,2020-03-30,6,1,GA,US,7,962
OUTLANDER 1000,2020-04-06,8,6,GA,US,14,991
OUTLANDER 850,2020-04-06,10,10,GA,US,20,973
OUTLANDER 450,2020-04-06,11,2,GA,US,13,975
OUTLANDER 1000,2020-04-13,6,3,GA,US,9,1000
OUTLANDER 850,2020-04-13,5,5,GA,US,10,983
OUTLANDER 450,2020-04-13,5,11,GA,US,16,991
OUTLANDER 1000,2020-04-20,6,8,GA,US,14,1014
OUTLANDER 850,2020-04-20,11,4,GA,US,15,998
OUTLANDER 450,2020-04-20,6,4,GA,US,10,1001
OUTLANDER 1000,2020-04-27,3,4,GA,US,7,1021
OUTLANDER 850,2020-04-27,13,10,GA,US,23,1021
OUTLANDER 450,2020-04-27,11,10,GA,US,21,1022
OUTLANDER 1000,2020-05-04,2,9,GA,US,11,1032
OUTLANDER 850,2020-05-04,7,3,GA,US,10,1031
OUTLANDER 450,2020-05-04,11,6,GA,US,17,1039
OUTLANDER 1000,2020-05-11,13,7,GA,US,20,1052
OUTLANDER 850,2020-05-11,3,6,GA,US,9,1040
OUTLANDER 450,2020-05-11,1,2,GA,US,3,1042
OUTLANDER 1000,2020-05-18,7,11,GA,US,18,1070
OUTLANDER 850,2020-05-18,3,13,GA,US,16,1056
OUTLANDER 450,2020-05-18,0,9,GA,US,9,1051
OUTLANDER 1000,2020-05-25,12,1,GA,US,13,1083
OUTLANDER 850,2020-05-25,4,5,GA,US,9,1065
OUTLANDER 450,2020-05-25,9,14,GA,US,23,1074
OUTLANDER 1000,2020-06-01,11,1,GA,US,12,1095
OUTLANDER 850,2020-06-01,4,0,GA,US,4,1069
OUTLANDER 450,2020-06-01,3,7,GA,US,10,1084
OUTLANDER 1000,2020-06-08,9,2,GA,US,11,1106
OUTLANDER 850,2020-06-08,0,5,GA,US,5,1074
OUTLANDER 450,2020-06-08,12,1,GA,US,13,1097
OUTLANDER 1000,2020-06-15,9,6,GA,US,15,1121
OUTLANDER 850,2020-06-15,0,13,GA,US,13,1087
OUTLANDER 450,2020-06-15,14,12,GA,US,26,1123
OUTLANDER 1000,2020-06-22,5,6,GA,US,11,1132
OUTLANDER 850,2020-06-22,8,3,GA,US,11,1098
OUTLANDER 450,2020-06-22,7,12,GA,US,19,1142
OUTLANDER 1000,2020-06-29,7,6,GA,US,13,1145
OUTLANDER 850,2020-06-29,3,9,GA,US,12,1110
OUTLANDER 450,2020-06-29,2,1,GA,US,3,1145
OUTLANDER 1000,2020-07-06,12,10,GA,US,22,1167
OUTLANDER 850,2020-07-06,6,12,GA,US,18,1128
OUTLANDER 450,2020-07-06,7,6,GA,US,13,1158
OUTLANDER 1000,2020-07-13,6,10,GA,US,16,1183
OUTLANDER 850,2020-07-13,8,10,GA,US,18,1146
OUTLANDER 450,2020-07-13,7,2,GA,US,9,1167
OUTLANDER 1000,2020-07-20,8,9,GA,US,17,1200
OUTLANDER 850,2020-07-20,3,10,GA,US,13,1159
OUTLANDER 450,2020-07-20,2,7,GA,US,9,1176
OUTLANDER 1000,2020-07-27,14,12,GA,US,26,1226
OUTLANDER 850,2020-07-27,6,13,GA,US,19,1178
OUTLANDER 450,2020-07-27,5,14,GA,US,19,1195
OUTLANDER 1000,2020-08-03,9,13,GA,US,22,1248
OUTLANDER 850,2020-08-03,7,8,GA,US,15,1193
OUTLANDER 450,2020-08-03,1,6,GA,US,7,1202
OUTLANDER 1000,2020-08-10,8,7,GA,US,15,1263
OUTLANDER 850,2020-08-10,11,3,GA,US,14,1207
OUTLANDER 450,2020-08-10,7,4,GA,US,11,1213
OUTLANDER 1000,2020-08-17,6,11,GA,US,17,1280
OUTLANDER 850,2020-08-17,15,8,GA,US,23,1230
OUTLANDER 450,2020-08-17,3,9,GA,US,12,1225
OUTLANDER 1000,2020-08-24,6,11,GA,US,17,1297
OUTLANDER 850,2020-08-24,4,5,GA,US,9,1239
OUTLANDER 450,2020-08-24,11,2,GA,US,13,1238
OUTLANDER 1000,2020-08-31,10,2,GA,US,12,1309
OUTLANDER 850,2020-08-31,3,4,GA,US,7,1246
OUTLANDER 450,2020-08-31,10,15,GA,US,25,1263
OUTLANDER 1000,2020-09-07,12,13,GA,US,25,1334
OUTLANDER 850,2020-09-07,3,6,GA,US,9,1255
OUTLANDER 450,2020-09-07,7,11,GA,US,18,1281
OUTLANDER 1000,2020-09-14,4,15,GA,US,19,1353
OUTLANDER 850,2020-09-14,11,12,GA,US,23,1278
OUTLANDER 450,2020-09-14,8,13,GA,US,21,1302
OUTLANDER 1000,2020-09-21,14,12,GA,US,26,1379
OUTLANDER 850,2020-09-21,14,14,GA,US,28,1306
OUTLANDER 450,2020-09-21,0,13,GA,US,13,1315
OUTLANDER 1000,2020-09-28,8,9,GA,US,17,1396
OUTLANDER 850,2020-09-28,3,7,GA,US,10,1316
OUTLANDER 450,2020-09-28,11,11,GA,US,22,1337
OUTLANDER 1000,2020-10-05,4,5,GA,US,9,1405
OUTLANDER 850,2020-10-05,9,1,GA,US,10,1326
OUTLANDER 450,2020-10-05,3,10,GA,US,13,1350
OUTLANDER 1000,2020-10-12,9,12,GA,US,21,1426
OUTLANDER 850,2020-10-12,12,13,GA,US,25,1351
OUTLANDER 450,2020-10-12,4,1,GA,US,5,1355
OUTLANDER 1000,2020-10-19,14,9,GA,US,23,1449
OUTLANDER 850,2020-10-19,1,13,GA,US,14,1365
OUTLANDER 450,2020-10-19,9,10,GA,US,19,1374
OUTLANDER 1000,2020-10-26,10,5,GA,US,15,1464
OUTLANDER 850,2020-10-26,9,10,GA,US,19,1384
OUTLANDER 450,2020-10-26,11,7,GA,US,18,1392
OUTLANDER 1000,2020-11-02,6,10,GA,US,16,1480
OUTLANDER 850,2020-11-02,8,1,GA,US,9,1393
OUTLANDER 450,2020-11-02,5,7,GA,US,12,1404
OUTLANDER 1000,2020-11-09,6,13,GA,US,19,1499
OUTLANDER 850,2020-11-09,5,1,GA,US,6,1399
OUTLANDER 450,2020-11-09,10,7,GA,US,17,1421
OUTLANDER 1000,2020-11-16,7,5,GA,US,12,1511
OUTLANDER 850,2020-11-16,5,13,GA,US,18,1417
OUTLANDER 450,2020-11-16,1,3,GA,US,4,1425
OUTLANDER 1000,2020-11-23,12,13,GA,US,25,1536
OUTLANDER 850,2020-11-23,8,1,GA,US,9,1426
OUTLANDER 450,2020-11-23,10,7,GA,US,17,1442
OUTLANDER 1000,2020-11-30,7,0,GA,US,7,1543
OUTLANDER 850,2020-11-30,2,7,GA,US,9,1435
OUTLANDER 450,2020-11-30,14,2,GA,US,16,1458
OUTLANDER 1000,2020-12-07,5,14,GA,US,19,1562
OUTLANDER 850,2020-12-07,13,4,GA,US,17,1452
OUTLANDER 450,2020-12-07,3,6,GA,US,9,1467
OUTLANDER 1000,2020-12-14,6,14,GA,US,20,1582
OUTLANDER 850,2020-12-14,2,14,GA,US,16,1468
OUTLANDER 450,2020-12-14,10,1,GA,US,11,1478
OUTLANDER 1000,2020-12-21,5,10,GA,US,15,1597
OUTLANDER 850,2020-12-21,11,13,GA,US,24,1492
OUTLANDER 450,2020-12-21,3,10,GA,US,13,1491
OUTLANDER 1000,2020-12-28,10,9,GA,US,19,1616
OUTLANDER 850,2020-12-28,7,9,GA,US,16,1508
OUTLANDER 450,2020-12-28,4,14,GA,US,18,1509
OUTLANDER 1000,2021-01-04,5,12,GA,US,17,1633
OUTLANDER 850,2021-01-04,1,12,GA,US,13,1521
OUTLANDER 450,2021-01-04,5,10,GA,US,15,1524
OUTLANDER 1000,2021-01-11,4,4,GA,US,8,1641
OUTLANDER 850,2021-01-11,5,13,GA,US,18,1539
OUTLANDER 450,2021-01-11,7,2,GA,US,9,1533
OUTLANDER 1000,2021-01-18,5,13,GA,US,18,1659
OUTLANDER 850,2021-01-18,6,8,GA,US,14,1553
OUTLANDER 450,2021-01-18,2,9,GA,US,11,1544
OUTLANDER 1000,2021-01-25,0,9,GA,US,9,1668
OUTLANDER 850,2021-01-25,11,11,GA,US,22,1575
OUTLANDER 450,2021-01-25,12,3,GA,US,15,1559
OUTLANDER 1000,2021-02-01,3,12,GA,US,15,1683
OUTLANDER 850,2021-02-01,8,4,GA,US,12,1587
OUTLANDER 450,2021-02-01,1,9,GA,US,10,1569
OUTLANDER 1000,2021-02-08,11,8,GA,US,19,1702
OUTLANDER 850,2021-02-08,11,1,GA,US,12,1599
OUTLANDER 450,2021-02-08,10,2,GA,US,12,1581
OUTLANDER 1000,2021-02-15,7,5,GA,US,12,1714
OUTLANDER 850,2021-02-15,12,10,GA,US,22,1621
OUTLANDER 450,2021-02-15,7,13,GA,US,20,1601
OUTLANDER 1000,2021-02-22,5,11,GA,US,16,1730
OUTLANDER 850,2021-02-22,7,14,GA,US,21,1642
OUTLANDER 450,2021-02-22,13,6,GA,US,19,1620
OUTLANDER 1000,2021-03-01,1,12,GA,US,13,1743
OUTLANDER 850,2021-03-01,8,12,GA,US,20,1662
OUTLANDER 450,2021-03-01,5,14,GA,US,19,1639
OUTLANDER 1000,2021-03-08,7,9,GA,US,16,1759
OUTLANDER 850,2021-03-08,7,10,GA,US,17,1679
OUTLANDER 450,2021-03-08,5,9,GA,US,14,1653
OUTLANDER 1000,2021-03-15,0,13,GA,US,13,1772
OUTLANDER 850,2021-03-15,14,11,GA,US,25,1704
OUTLANDER 450,2021-03-15,8,2,GA,US,10,1663
OUTLANDER 1000,2021-03-22,6,7,GA,US,13,1785
OUTLANDER 850,2021-03-22,3,14,GA,US,17,1721
OUTLANDER 450,2021-03-22,6,3,GA,US,9,1672
OUTLANDER 1000,2021-03-29,11,4,GA,US,15,1800
OUTLANDER 850,2021-03-29,1,15,GA,US,16,1737
OUTLANDER 450,2021-03-29,1,1,GA,US,2,1674
OUTLANDER 1000,2021-04-05,4,9,GA,US,13,1813
OUTLANDER 850,2021-04-05,14,11,GA,US,25,1762
OUTLANDER 450,2021-04-05,0,3,GA,US,3,1677
OUTLANDER 1000,2021-04-12,8,6,GA,US,14,1827
OUTLANDER 850,2021-04-12,13,4,GA,US,17,1779
OUTLANDER 450,2021-04-12,2,6,GA,US,8,1685
OUTLANDER 1000,2021-04-19,15,12,GA,US,27,1854
OUTLANDER 850,2021-04-19,6,5,GA,US,11,1790
OUTLANDER 450,2021-04-19,13,0,GA,US,13,1698
OUTLANDER 1000,2021-04-26,13,10,GA,US,23,1877
OUTLANDER 850,2021-04-26,9,1,GA,US,10,1800
OUTLANDER 450,2021-04-26,3,15,GA,US,18,1716
OUTLANDER 1000,2021-05-03,8,2,GA,US,10,1887
OUTLANDER 850,2021-05-03,5,15,GA,US,20,1820
OUTLANDER 450,2021-05-03,14,1,GA,US,15,1731
OUTLANDER 1000,2021-05-10,9,3,GA,US,12,1899
OUTLANDER 850,2021-05-10,14,0,GA,US,14,1834
OUTLANDER 450,2021-05-10,10,6,GA,US,16,1747
OUTLANDER 1000,2021-05-17,11,12,GA,US,23,1922
OUTLANDER 850,2021-05-17,2,11,GA,US,13,1847
OUTLANDER 450,2021-05-17,12,15,GA,US,27,1774
OUTLANDER 1000,2021-05-24,9,4,GA,US,13,1935
OUTLANDER 850,2021-05-24,15,7,GA,US,22,1869
OUTLANDER 450,2021-05-24,11,2,GA,US,13,1787
OUTLANDER 1000,2021-05-31,8,14,GA,US,22,1957
OUTLANDER 850,2021-05-31,13,5,GA,US,18,1887
OUTLANDER 450,2021-05-31,10,14,GA,US,24,1811
OUTLANDER 1000,2021-06-07,4,6,GA,US,10,1967
OUTLANDER 850,2021-06-07,14,0,GA,US,14,1901
OUTLANDER 450,2021-06-07,9,9,GA,US,18,1829
OUTLANDER 1000,2021-06-14,9,12,GA,US,21,1988
OUTLANDER 850,2021-06-14,9,5,GA,US,14,1915
OUTLANDER 450,2021-06-14,5,0,GA,US,5,1834
OUTLANDER 1000,2021-06-21,9,8,GA,US,17,2005
OUTLANDER 850,2021-06-21,9,1,GA,US,10,1925
OUTLANDER 450,2021-06-21,3,5,GA,US,8,1842
OUTLANDER 1000,2021-06-28,11,1,GA,US,12,2017
OUTLANDER 850,2021-06-28,8,13,GA,US,21,1946
OUTLANDER 450,2021-06-28,5,9,GA,US,14,1856
OUTLANDER 1000,2021-07-05,9,8,GA,US,17,2034
OUTLANDER 850,2021-07-05,7,0,GA,US,7,1953
OUTLANDER 450,2021-07-05,6,5,GA,US,11,1867
OUTLANDER 1000,2021-07-12,4,12,GA,US,16,2050
OUTLANDER 850,2021-07-12,4,4,GA,US,8,1961
OUTLANDER 450,2021-07-12,7,6,GA,US,13,1880
OUTLANDER 1000,2021-07-19,4,15,GA,US,19,2069
OUTLANDER 850,2021-07-19,2,1,GA,US,3,1964
OUTLANDER 450,2021-07-19,11,14,GA,US,25,1905
OUTLANDER 1000,2021-07-26,10,12,GA,US,22,2091
OUTLANDER 850,2021-07-26,2,2,GA,US,4,1968
OUTLANDER 450,2021-07-26,6,0,GA,US,6,1911
OUTLANDER 1000,2021-08-02,3,2,GA,US,5,2096
OUTLANDER 850,2021-08-02,1,8,GA,US,9,1977
OUTLANDER 450,2021-08-02,9,11,GA,US,20,1931
OUTLANDER 1000,2021-08-09,6,9,GA,US,15,2111
OUTLANDER 850,2021-08-09,10,7,GA,US,17,1994
OUTLANDER 450,2021-08-09,13,2,GA,US,15,1946
OUTLANDER 1000,2021-08-16,13,13,GA,US,26,2137
OUTLANDER 850,2021-08-16,12,0,GA,US,12,2006
OUTLANDER 450,2021-08-16,4,0,GA,US,4,1950
OUTLANDER 1000,2021-08-23,12,12,GA,US,24,2161
OUTLANDER 850,2021-08-23,15,0,GA,US,15,2021
OUTLANDER 450,2021-08-23,2,6,GA,US,8,1958
OUTLANDER 1000,2021-08-30,11,1,GA,US,12,2173
OUTLANDER 850,2021-08-30,0,3,GA,US,3,2024
OUTLANDER 450,2021-08-30,11,9,GA,US,20,1978
OUTLANDER 1000,2021-09-06,11,10,GA,US,21,2194
OUTLANDER 850,2021-09-06,4,0,GA,US,4,2028
OUTLANDER 450,2021-09-06,13,4,GA,US,17,1995
OUTLANDER 1000,2021-09-13,13,1,GA,US,14,2208
OUTLANDER 850,2021-09-13,2,8,GA,US,10,2038
OUTLANDER 450,2021-09-13,14,7,GA,US,21,2016
OUTLANDER 1000,2021-09-20,4,12,GA,US,16,2224
OUTLANDER 850,2021-09-20,8,13,GA,US,21,2059
OUTLANDER 450,2021-09-20,15,15,GA,US,30,2046
OUTLANDER 1000,2021-09-27,10,15,GA,US,25,2249
OUTLANDER 850,2021-09-27,12,11,GA,US,23,2082
OUTLANDER 450,2021-09-27,7,6,GA,US,13,2059
OUTLANDER 1000,2021-10-04,4,13,GA,US,17,2266
OUTLANDER 850,2021-10-04,11,13,GA,US,24,2106
OUTLANDER 450,2021-10-04,2,3,GA,US,5,2064
OUTLANDER 1000,2021-10-11,0,9,GA,US,9,2275
OUTLANDER 850,2021-10-11,13,9,GA,US,22,2128
OUTLANDER 450,2021-10-11,15,11,GA,US,26,2090
OUTLANDER 1000,2021-10-18,14,6,GA,US,20,2295
OUTLANDER 850,2021-10-18,0,2,GA,US,2,2130
OUTLANDER 450,2021-10-18,8,10,GA,US,18,2108
OUTLANDER 1000,2021-10-25,9,14,GA,US,23,2318
OUTLANDER 850,2021-10-25,4,14,GA,US,18,2148
OUTLANDER 450,2021-10-25,5,2,GA,US,7,2115
OUTLANDER 1000,2021-11-01,10,14,GA,US,24,2342
OUTLANDER 850,2021-11-01,1,2,GA,US,3,2151
OUTLANDER 450,2021-11-01,13,14,GA,US,27,2142
OUTLANDER 1000,2021-11-08,8,14,GA,US,22,2364
OUTLANDER 850,2021-11-08,2,3,GA,US,5,2156
OUTLANDER 450,2021-11-08,9,8,GA,US,17,2159
OUTLANDER 1000,2021-11-15,3,1,GA,US,4,2368
OUTLANDER 850,2021-11-15,3,2,GA,US,5,2161
OUTLANDER 450,2021-11-15,8,14,GA,US,22,2181
OUTLANDER 1000,2021-11-22,10,15,GA,US,25,2393
OUTLANDER 850,2021-11-22,3,7,GA,US,10,2171
OUTLANDER 450,2021-11-22,10,15,GA,US,25,2206
OUTLANDER 1000,2021-11-29,3,6,GA,US,9,2402
OUTLANDER 850,2021-11-29,11,11,GA,US,22,2193
OUTLANDER 450,2021-11-29,1,12,GA,US,13,2219
OUTLANDER 1000,2021-12-06,11,1,GA,US,12,2414
OUTLANDER 850,2021-12-06,12,7,GA,US,19,2212
OUTLANDER 450,2021-12-06,4,0,GA,US,4,2223
OUTLANDER 1000,2021-12-13,12,14,GA,US,26,2440
OUTLANDER 850,2021-12-13,7,3,GA,US,10,2222
OUTLANDER 450,2021-12-13,14,13,GA,US,27,2250
OUTLANDER 1000,2021-12-20,12,14,GA,US,26,2466
OUTLANDER 850,2021-12-20,14,0,GA,US,14,2236
OUTLANDER 450,2021-12-20,12,1,GA,US,13,2263
OUTLANDER 1000,2021-12-27,11,5,GA,US,16,2482
OUTLANDER 850,2021-12-27,3,15,GA,US,18,2254
OUTLANDER 450,2021-12-27,13,13,GA,US,26,2289
OUTLANDER 1000,2019-01-07,2,4,HI,US,6,6
OUTLANDER 850,2019-01-07,14,8,HI,US,22,22
OUTLANDER 450,2019-01-07,8,4,HI,US,12,12
OUTLANDER 1000,2019-01-14,1,14,HI,US,15,21
OUTLANDER 850,2019-01-14,9,6,HI,US,15,37
OUTLANDER 450,2019-01-14,14,1,HI,US,15,27
OUTLANDER 1000,2019-01-21,11,1,HI,US,12,33
OUTLANDER 850,2019-01-21,10,13,HI,US,23,60
OUTLANDER 450,2019-01-21,6,10,HI,US,16,43
OUTLANDER 1000,2019-01-28,6,9,HI,US,15,48
OUTLANDER 850,2019-01-28,2,12,HI,US,14,74
OUTLANDER 450,2019-01-28,11,11,HI,US,22,65
OUTLANDER 1000,2019-02-04,10,11,HI,US,21,69
OUTLANDER 850,2019-02-04,11,5,HI,US,16,90
OUTLANDER 450,2019-02-04,7,10,HI,US,17,82
OUTLANDER 1000,2019-02-11,4,4,HI,US,8,77
OUTLANDER 850,2019-02-11,13,9,HI,US,22,112
OUTLANDER 450,2019-02-11,7,1,HI,US,8,90
OUTLANDER 1000,2019-02-18,11,10,HI,US,21,98
OUTLANDER 850,2019-02-18,14,3,HI,US,17,129
OUTLANDER 450,2019-02-18,3,7,HI,US,10,100
OUTLANDER 1000,2019-02-25,10,3,HI,US,13,111
OUTLANDER 850,2019-02-25,0,14,HI,US,14,143
OUTLANDER 450,2019-02-25,10,3,HI,US,13,113
OUTLANDER 1000,2019-03-04,9,7,HI,US,16,127
OUTLANDER 850,2019-03-04,14,5,HI,US,19,162
OUTLANDER 450,2019-03-04,12,8,HI,US,20,133
OUTLANDER 1000,2019-03-11,7,5,HI,US,12,139
OUTLANDER 850,2019-03-11,12,5,HI,US,17,179
OUTLANDER 450,2019-03-11,0,10,HI,US,10,143
OUTLANDER 1000,2019-03-18,5,13,HI,US,18,157
OUTLANDER 850,2019-03-18,5,0,HI,US,5,184
OUTLANDER 450,2019-03-18,3,12,HI,US,15,158
OUTLANDER 1000,2019-03-25,7,13,HI,US,20,177
OUTLANDER 850,2019-03-25,6,6,HI,US,12,196
OUTLANDER 450,2019-03-25,2,1,HI,US,3,161
OUTLANDER 1000,2019-04-01,8,10,HI,US,18,195
OUTLANDER 850,2019-04-01,3,7,HI,US,10,206
OUTLANDER 450,2019-04-01,8,3,HI,US,11,172
OUTLANDER 1000,2019-04-08,11,2,HI,US,13,208
OUTLANDER 850,2019-04-08,5,9,HI,US,14,220
OUTLANDER 450,2019-04-08,3,14,HI,US,17,189
OUTLANDER 1000,2019-04-15,5,12,HI,US,17,225
OUTLANDER 850,2019-04-15,2,11,HI,US,13,233
OUTLANDER 450,2019-04-15,2,6,HI,US,8,197
OUTLANDER 1000,2019-04-22,14,5,HI,US,19,244
OUTLANDER 850,2019-04-22,1,0,HI,US,1,234
OUTLANDER 450,2019-04-22,6,2,HI,US,8,205
OUTLANDER 1000,2019-04-29,13,8,HI,US,21,265
OUTLANDER 850,2019-04-29,10,4,HI,US,14,248
OUTLANDER 450,2019-04-29,3,2,HI,US,5,210
OUTLANDER 1000,2019-05-06,14,0,HI,US,14,279
OUTLANDER 850,2019-05-06,5,12,HI,US,17,265
OUTLANDER 450,2019-05-06,7,12,HI,US,19,229
OUTLANDER 1000,2019-05-13,12,9,HI,US,21,300
OUTLANDER 850,2019-05-13,15,2,HI,US,17,282
OUTLANDER 450,2019-05-13,13,7,HI,US,20,249
OUTLANDER 1000,2019-05-20,14,6,HI,US,20,320
OUTLANDER 850,2019-05-20,12,5,HI,US,17,299
OUTLANDER 450,2019-05-20,8,2,HI,US,10,259
OUTLANDER 1000,2019-05-27,7,14,HI,US,21,341
OUTLANDER 850,2019-05-27,1,9,HI,US,10,309
OUTLANDER 450,2019-05-27,10,2,HI,US,12,271
OUTLANDER 1000,2019-06-03,0,13,HI,US,13,354
OUTLANDER 850,2019-06-03,4,2,HI,US,6,315
OUTLANDER 450,2019-06-03,4,0,HI,US,4,275
OUTLANDER 1000,2019-06-10,10,12,HI,US,22,376
OUTLANDER 850,2019-06-10,14,15,HI,US,29,344
OUTLANDER 450,2019-06-10,4,13,HI,US,17,292
OUTLANDER 1000,2019-06-17,10,1,HI,US,11,387
OUTLANDER 850,2019-06-17,6,10,HI,US,16,360
OUTLANDER 450,2019-06-17,13,6,HI,US,19,311
OUTLANDER 1000,2019-06-24,9,10,HI,US,19,406
OUTLANDER 850,2019-06-24,6,1,HI,US,7,367
OUTLANDER 450,2019-06-24,6,5,HI,US,11,322
OUTLANDER 1000,2019-07-01,11,8,HI,US,19,425
OUTLANDER 850,2019-07-01,7,9,HI,US,16,383
OUTLANDER 450,2019-07-01,3,4,HI,US,7,329
OUTLANDER 1000,2019-07-08,9,10,HI,US,19,444
OUTLANDER 850,2019-07-08,2,5,HI,US,7,390
OUTLANDER 450,2019-07-08,8,4,HI,US,12,341
OUTLANDER 1000,2019-07-15,8,9,HI,US,17,461
OUTLANDER 850,2019-07-15,3,5,HI,US,8,398
OUTLANDER 450,2019-07-15,6,10,HI,US,16,357
OUTLANDER 1000,2019-07-22,8,8,HI,US,16,477
OUTLANDER 850,2019-07-22,13,2,HI,US,15,413
OUTLANDER 450,2019-07-22,8,11,HI,US,19,376
OUTLANDER 1000,2019-07-29,6,3,HI,US,9,486
OUTLANDER 850,2019-07-29,7,8,HI,US,15,428
OUTLANDER 450,2019-07-29,14,8,HI,US,22,398
OUTLANDER 1000,2019-08-05,1,0,HI,US,1,487
OUTLANDER 850,2019-08-05,7,4,HI,US,11,439
OUTLANDER 450,2019-08-05,12,6,HI,US,18,416
OUTLANDER 1000,2019-08-12,8,8,HI,US,16,503
OUTLANDER 850,2019-08-12,2,1,HI,US,3,442
OUTLANDER 450,2019-08-12,14,5,HI,US,19,435
OUTLANDER 1000,2019-08-19,8,7,HI,US,15,518
OUTLANDER 850,2019-08-19,15,1,HI,US,16,458
OUTLANDER 450,2019-08-19,5,12,HI,US,17,452
OUTLANDER 1000,2019-08-26,12,5,HI,US,17,535
OUTLANDER 850,2019-08-26,6,12,HI,US,18,476
OUTLANDER 450,2019-08-26,3,8,HI,US,11,463
OUTLANDER 1000,2019-09-02,0,2,HI,US,2,537
OUTLANDER 850,2019-09-02,13,3,HI,US,16,492
OUTLANDER 450,2019-09-02,11,12,HI,US,23,486
OUTLANDER 1000,2019-09-09,8,12,HI,US,20,557
OUTLANDER 850,2019-09-09,11,13,HI,US,24,516
OUTLANDER 450,2019-09-09,11,7,HI,US,18,504
OUTLANDER 1000,2019-09-16,9,6,HI,US,15,572
OUTLANDER 850,2019-09-16,6,1,HI,US,7,523
OUTLANDER 450,2019-09-16,8,1,HI,US,9,513
OUTLANDER 1000,2019-09-23,10,1,HI,US,11,583
OUTLANDER 850,2019-09-23,10,11,HI,US,21,544
OUTLANDER 450,2019-09-23,7,13,HI,US,20,533
OUTLANDER 1000,2019-09-30,12,5,HI,US,17,600
OUTLANDER 850,2019-09-30,5,11,HI,US,16,560
OUTLANDER 450,2019-09-30,12,13,HI,US,25,558
OUTLANDER 1000,2019-10-07,4,10,HI,US,14,614
OUTLANDER 850,2019-10-07,2,7,HI,US,9,569
OUTLANDER 450,2019-10-07,3,5,HI,US,8,566
OUTLANDER 1000,2019-10-14,10,0,HI,US,10,624
OUTLANDER 850,2019-10-14,5,6,HI,US,11,580
OUTLANDER 450,2019-10-14,8,1,HI,US,9,575
OUTLANDER 1000,2019-10-21,1,5,HI,US,6,630
OUTLANDER 850,2019-10-21,14,4,HI,US,18,598
OUTLANDER 450,2019-10-21,11,4,HI,US,15,590
OUTLANDER 1000,2019-10-28,11,11,HI,US,22,652
OUTLANDER 850,2019-10-28,0,2,HI,US,2,600
OUTLANDER 450,2019-10-28,0,7,HI,US,7,597
OUTLANDER 1000,2019-11-04,2,5,HI,US,7,659
OUTLANDER 850,2019-11-04,4,5,HI,US,9,609
OUTLANDER 450,2019-11-04,4,6,HI,US,10,607
OUTLANDER 1000,2019-11-11,10,5,HI,US,15,674
OUTLANDER 850,2019-11-11,4,11,HI,US,15,624
OUTLANDER 450,2019-11-11,8,3,HI,US,11,618
OUTLANDER 1000,2019-11-18,8,13,HI,US,21,695
OUTLANDER 850,2019-11-18,3,6,HI,US,9,633
OUTLANDER 450,2019-11-18,2,5,HI,US,7,625
OUTLANDER 1000,2019-11-25,10,8,HI,US,18,713
OUTLANDER 850,2019-11-25,4,9,HI,US,13,646
OUTLANDER 450,2019-11-25,12,7,HI,US,19,644
OUTLANDER 1000,2019-12-02,10,10,HI,US,20,733
OUTLANDER 850,2019-12-02,14,14,HI,US,28,674
OUTLANDER 450,2019-12-02,4,3,HI,US,7,651
OUTLANDER 1000,2019-12-09,13,14,HI,US,27,760
OUTLANDER 850,2019-12-09,2,6,HI,US,8,682
OUTLANDER 450,2019-12-09,4,15,HI,US,19,670
OUTLANDER 1000,2019-12-16,4,13,HI,US,17,777
OUTLANDER 850,2019-12-16,15,5,HI,US,20,702
OUTLANDER 450,2019-12-16,14,12,HI,US,26,696
OUTLANDER 1000,2019-12-23,7,14,HI,US,21,798
OUTLANDER 850,2019-12-23,13,7,HI,US,20,722
OUTLANDER 450,2019-12-23,11,6,HI,US,17,713
OUTLANDER 1000,2019-12-30,1,15,HI,US,16,814
OUTLANDER 850,2019-12-30,14,13,HI,US,27,749
OUTLANDER 450,2019-12-30,7,4,HI,US,11,724
OUTLANDER 1000,2020-01-06,4,8,HI,US,12,826
OUTLANDER 850,2020-01-06,7,4,HI,US,11,760
OUTLANDER 450,2020-01-06,9,7,HI,US,16,740
OUTLANDER 1000,2020-01-13,11,8,HI,US,19,845
OUTLANDER 850,2020-01-13,1,3,HI,US,4,764
OUTLANDER 450,2020-01-13,6,14,HI,US,20,760
OUTLANDER 1000,2020-01-20,3,4,HI,US,7,852
OUTLANDER 850,2020-01-20,7,8,HI,US,15,779
OUTLANDER 450,2020-01-20,7,12,HI,US,19,779
OUTLANDER 1000,2020-01-27,6,9,HI,US,15,867
OUTLANDER 850,2020-01-27,6,12,HI,US,18,797
OUTLANDER 450,2020-01-27,13,13,HI,US,26,805
OUTLANDER 1000,2020-02-03,15,12,HI,US,27,894
OUTLANDER 850,2020-02-03,13,0,HI,US,13,810
OUTLANDER 450,2020-02-03,3,10,HI,US,13,818
OUTLANDER 1000,2020-02-10,2,3,HI,US,5,899
OUTLANDER 850,2020-02-10,13,11,HI,US,24,834
OUTLANDER 450,2020-02-10,11,4,HI,US,15,833
OUTLANDER 1000,2020-02-17,11,12,HI,US,23,922
OUTLANDER 850,2020-02-17,8,9,HI,US,17,851
OUTLANDER 450,2020-02-17,6,5,HI,US,11,844
OUTLANDER 1000,2020-02-24,7,5,HI,US,12,934
OUTLANDER 850,2020-02-24,5,9,HI,US,14,865
OUTLANDER 450,2020-02-24,14,14,HI,US,28,872
OUTLANDER 1000,2020-03-02,7,13,HI,US,20,954
OUTLANDER 850,2020-03-02,0,8,HI,US,8,873
OUTLANDER 450,2020-03-02,6,8,HI,US,14,886
OUTLANDER 1000,2020-03-09,1,1,HI,US,2,956
OUTLANDER 850,2020-03-09,12,12,HI,US,24,897
OUTLANDER 450,2020-03-09,6,9,HI,US,15,901
OUTLANDER 1000,2020-03-16,8,14,HI,US,22,978
OUTLANDER 850,2020-03-16,10,11,HI,US,21,918
OUTLANDER 450,2020-03-16,8,4,HI,US,12,913
OUTLANDER 1000,2020-03-23,14,15,HI,US,29,1007
OUTLANDER 850,2020-03-23,14,5,HI,US,19,937
OUTLANDER 450,2020-03-23,9,2,HI,US,11,924
OUTLANDER 1000,2020-03-30,7,13,HI,US,20,1027
OUTLANDER 850,2020-03-30,6,8,HI,US,14,951
OUTLANDER 450,2020-03-30,11,1,HI,US,12,936
OUTLANDER 1000,2020-04-06,11,1,HI,US,12,1039
OUTLANDER 850,2020-04-06,7,4,HI,US,11,962
OUTLANDER 450,2020-04-06,11,9,HI,US,20,956
OUTLANDER 1000,2020-04-13,15,13,HI,US,28,1067
OUTLANDER 850,2020-04-13,3,11,HI,US,14,976
OUTLANDER 450,2020-04-13,7,12,HI,US,19,975
OUTLANDER 1000,2020-04-20,10,6,HI,US,16,1083
OUTLANDER 850,2020-04-20,1,14,HI,US,15,991
OUTLANDER 450,2020-04-20,3,13,HI,US,16,991
OUTLANDER 1000,2020-04-27,15,11,HI,US,26,1109
OUTLANDER 850,2020-04-27,2,3,HI,US,5,996
OUTLANDER 450,2020-04-27,7,13,HI,US,20,1011
OUTLANDER 1000,2020-05-04,12,13,HI,US,25,1134
OUTLANDER 850,2020-05-04,14,4,HI,US,18,1014
OUTLANDER 450,2020-05-04,10,12,HI,US,22,1033
OUTLANDER 1000,2020-05-11,15,5,HI,US,20,1154
OUTLANDER 850,2020-05-11,11,13,HI,US,24,1038
OUTLANDER 450,2020-05-11,9,7,HI,US,16,1049
OUTLANDER 1000,2020-05-18,12,1,HI,US,13,1167
OUTLANDER 850,2020-05-18,8,8,HI,US,16,1054
OUTLANDER 450,2020-05-18,3,2,HI,US,5,1054
OUTLANDER 1000,2020-05-25,13,0,HI,US,13,1180
OUTLANDER 850,2020-05-25,4,11,HI,US,15,1069
OUTLANDER 450,2020-05-25,2,6,HI,US,8,1062
OUTLANDER 1000,2020-06-01,11,11,HI,US,22,1202
OUTLANDER 850,2020-06-01,9,11,HI,US,20,1089
OUTLANDER 450,2020-06-01,12,9,HI,US,21,1083
OUTLANDER 1000,2020-06-08,3,3,HI,US,6,1208
OUTLANDER 850,2020-06-08,3,9,HI,US,12,1101
OUTLANDER 450,2020-06-08,5,14,HI,US,19,1102
OUTLANDER 1000,2020-06-15,3,10,HI,US,13,1221
OUTLANDER 850,2020-06-15,0,2,HI,US,2,1103
OUTLANDER 450,2020-06-15,13,9,HI,US,22,1124
OUTLANDER 1000,2020-06-22,3,4,HI,US,7,1228
OUTLANDER 850,2020-06-22,14,12,HI,US,26,1129
OUTLANDER 450,2020-06-22,4,8,HI,US,12,1136
OUTLANDER 1000,2020-06-29,3,7,HI,US,10,1238
OUTLANDER 850,2020-06-29,0,1,HI,US,1,1130
OUTLANDER 450,2020-06-29,9,4,HI,US,13,1149
OUTLANDER 1000,2020-07-06,12,5,HI,US,17,1255
OUTLANDER 850,2020-07-06,10,9,HI,US,19,1149
OUTLANDER 450,2020-07-06,6,9,HI,US,15,1164
OUTLANDER 1000,2020-07-13,10,14,HI,US,24,1279
OUTLANDER 850,2020-07-13,6,9,HI,US,15,1164
OUTLANDER 450,2020-07-13,13,11,HI,US,24,1188
OUTLANDER 1000,2020-07-20,10,10,HI,US,20,1299
OUTLANDER 850,2020-07-20,3,12,HI,US,15,1179
OUTLANDER 450,2020-07-20,5,10,HI,US,15,1203
OUTLANDER 1000,2020-07-27,1,9,HI,US,10,1309
OUTLANDER 850,2020-07-27,4,8,HI,US,12,1191
OUTLANDER 450,2020-07-27,6,13,HI,US,19,1222
OUTLANDER 1000,2020-08-03,1,15,HI,US,16,1325
OUTLANDER 850,2020-08-03,14,7,HI,US,21,1212
OUTLANDER 450,2020-08-03,15,14,HI,US,29,1251
OUTLANDER 1000,2020-08-10,15,5,HI,US,20,1345
OUTLANDER 850,2020-08-10,9,11,HI,US,20,1232
OUTLANDER 450,2020-08-10,14,2,HI,US,16,1267
OUTLANDER 1000,2020-08-17,2,10,HI,US,12,1357
OUTLANDER 850,2020-08-17,15,6,HI,US,21,1253
OUTLANDER 450,2020-08-17,5,9,HI,US,14,1281
OUTLANDER 1000,2020-08-24,8,6,HI,US,14,1371
OUTLANDER 850,2020-08-24,5,7,HI,US,12,1265
OUTLANDER 450,2020-08-24,4,11,HI,US,15,1296
OUTLANDER 1000,2020-08-31,6,12,HI,US,18,1389
OUTLANDER 850,2020-08-31,7,1,HI,US,8,1273
OUTLANDER 450,2020-08-31,14,6,HI,US,20,1316
OUTLANDER 1000,2020-09-07,10,3,HI,US,13,1402
OUTLANDER 850,2020-09-07,12,6,HI,US,18,1291
OUTLANDER 450,2020-09-07,4,0,HI,US,4,1320
OUTLANDER 1000,2020-09-14,6,11,HI,US,17,1419
OUTLANDER 850,2020-09-14,6,8,HI,US,14,1305
OUTLANDER 450,2020-09-14,9,6,HI,US,15,1335
OUTLANDER 1000,2020-09-21,6,2,HI,US,8,1427
OUTLANDER 850,2020-09-21,3,11,HI,US,14,1319
OUTLANDER 450,2020-09-21,0,6,HI,US,6,1341
OUTLANDER 1000,2020-09-28,9,9,HI,US,18,1445
OUTLANDER 850,2020-09-28,12,6,HI,US,18,1337
OUTLANDER 450,2020-09-28,3,3,HI,US,6,1347
OUTLANDER 1000,2020-10-05,6,10,HI,US,16,1461
OUTLANDER 850,2020-10-05,11,12,HI,US,23,1360
OUTLANDER 450,2020-10-05,14,3,HI,US,17,1364
OUTLANDER 1000,2020-10-12,4,6,HI,US,10,1471
OUTLANDER 850,2020-10-12,14,0,HI,US,14,1374
OUTLANDER 450,2020-10-12,8,9,HI,US,17,1381
OUTLANDER 1000,2020-10-19,8,9,HI,US,17,1488
OUTLANDER 850,2020-10-19,1,2,HI,US,3,1377
OUTLANDER 450,2020-10-19,13,5,HI,US,18,1399
OUTLANDER 1000,2020-10-26,1,7,HI,US,8,1496
OUTLANDER 850,2020-10-26,3,12,HI,US,15,1392
OUTLANDER 450,2020-10-26,10,11,HI,US,21,1420
OUTLANDER 1000,2020-11-02,5,14,HI,US,19,1515
OUTLANDER 850,2020-11-02,2,12,HI,US,14,1406
OUTLANDER 450,2020-11-02,11,14,HI,US,25,1445
OUTLANDER 1000,2020-11-09,1,8,HI,US,9,1524
OUTLANDER 850,2020-11-09,5,7,HI,US,12,1418
OUTLANDER 450,2020-11-09,12,14,HI,US,26,1471
OUTLANDER 1000,2020-11-16,14,10,HI,US,24,1548
OUTLANDER 850,2020-11-16,14,5,HI,US,19,1437
OUTLANDER 450,2020-11-16,9,15,HI,US,24,1495
OUTLANDER 1000,2020-11-23,4,14,HI,US,18,1566
OUTLANDER 850,2020-11-23,10,7,HI,US,17,1454
OUTLANDER 450,2020-11-23,4,1,HI,US,5,1500
OUTLANDER 1000,2020-11-30,14,10,HI,US,24,1590
OUTLANDER 850,2020-11-30,8,3,HI,US,11,1465
OUTLANDER 450,2020-11-30,9,6,HI,US,15,1515
OUTLANDER 1000,2020-12-07,8,14,HI,US,22,1612
OUTLANDER 850,2020-12-07,7,8,HI,US,15,1480
OUTLANDER 450,2020-12-07,10,1,HI,US,11,1526
OUTLANDER 1000,2020-12-14,8,6,HI,US,14,1626
OUTLANDER 850,2020-12-14,9,7,HI,US,16,1496
OUTLANDER 450,2020-12-14,13,0,HI,US,13,1539
OUTLANDER 1000,2020-12-21,1,9,HI,US,10,1636
OUTLANDER 850,2020-12-21,1,8,HI,US,9,1505
OUTLANDER 450,2020-12-21,11,1,HI,US,12,1551
OUTLANDER 1000,2020-12-28,3,12,HI,US,15,1651
OUTLANDER 850,2020-12-28,0,13,HI,US,13,1518
OUTLANDER 450,2020-12-28,3,1,HI,US,4,1555
OUTLANDER 1000,2021-01-04,9,1,HI,US,10,1661
OUTLANDER 850,2021-01-04,1,5,HI,US,6,1524
OUTLANDER 450,2021-01-04,4,1,HI,US,5,1560
OUTLANDER 1000,2021-01-11,4,7,HI,US,11,1672
OUTLANDER 850,2021-01-11,11,10,HI,US,21,1545
OUTLANDER 450,2021-01-11,7,1,HI,US,8,1568
OUTLANDER 1000,2021-01-18,0,1,HI,US,1,1673
OUTLANDER 850,2021-01-18,4,15,HI,US,19,1564
OUTLANDER 450,2021-01-18,12,12,HI,US,24,1592
OUTLANDER 1000,2021-01-25,2,13,HI,US,15,1688
OUTLANDER 850,2021-01-25,12,7,HI,US,19,1583
OUTLANDER 450,2021-01-25,8,3,HI,US,11,1603
OUTLANDER 1000,2021-02-01,12,8,HI,US,20,1708
OUTLANDER 850,2021-02-01,14,12,HI,US,26,1609
OUTLANDER 450,2021-02-01,6,6,HI,US,12,1615
OUTLANDER 1000,2021-02-08,4,1,HI,US,5,1713
OUTLANDER 850,2021-02-08,11,3,HI,US,14,1623
OUTLANDER 450,2021-02-08,4,9,HI,US,13,1628
OUTLANDER 1000,2021-02-15,5,14,HI,US,19,1732
OUTLANDER 850,2021-02-15,1,2,HI,US,3,1626
OUTLANDER 450,2021-02-15,4,0,HI,US,4,1632
OUTLANDER 1000,2021-02-22,4,9,HI,US,13,1745
OUTLANDER 850,2021-02-22,1,2,HI,US,3,1629
OUTLANDER 450,2021-02-22,4,3,HI,US,7,1639
OUTLANDER 1000,2021-03-01,0,3,HI,US,3,1748
OUTLANDER 850,2021-03-01,3,5,HI,US,8,1637
OUTLANDER 450,2021-03-01,13,5,HI,US,18,1657
OUTLANDER 1000,2021-03-08,11,4,HI,US,15,1763
OUTLANDER 850,2021-03-08,0,7,HI,US,7,1644
OUTLANDER 450,2021-03-08,1,10,HI,US,11,1668
OUTLANDER 1000,2021-03-15,13,10,HI,US,23,1786
OUTLANDER 850,2021-03-15,5,9,HI,US,14,1658
OUTLANDER 450,2021-03-15,0,9,HI,US,9,1677
OUTLANDER 1000,2021-03-22,9,2,HI,US,11,1797
OUTLANDER 850,2021-03-22,15,10,HI,US,25,1683
OUTLANDER 450,2021-03-22,8,2,HI,US,10,1687
OUTLANDER 1000,2021-03-29,4,4,HI,US,8,1805
OUTLANDER 850,2021-03-29,1,14,HI,US,15,1698
OUTLANDER 450,2021-03-29,13,12,HI,US,25,1712
OUTLANDER 1000,2021-04-05,1,13,HI,US,14,1819
OUTLANDER 850,2021-04-05,8,5,HI,US,13,1711
OUTLANDER 450,2021-04-05,14,1,HI,US,15,1727
OUTLANDER 1000,2021-04-12,1,1,HI,US,2,1821
OUTLANDER 850,2021-04-12,5,1,HI,US,6,1717
OUTLANDER 450,2021-04-12,6,3,HI,US,9,1736
OUTLANDER 1000,2021-04-19,1,8,HI,US,9,1830
OUTLANDER 850,2021-04-19,11,14,HI,US,25,1742
OUTLANDER 450,2021-04-19,11,8,HI,US,19,1755
OUTLANDER 1000,2021-04-26,1,3,HI,US,4,1834
OUTLANDER 850,2021-04-26,11,12,HI,US,23,1765
OUTLANDER 450,2021-04-26,11,7,HI,US,18,1773
OUTLANDER 1000,2021-05-03,1,13,HI,US,14,1848
OUTLANDER 850,2021-05-03,1,12,HI,US,13,1778
OUTLANDER 450,2021-05-03,2,10,HI,US,12,1785
OUTLANDER 1000,2021-05-10,3,8,HI,US,11,1859
OUTLANDER 850,2021-05-10,11,11,HI,US,22,1800
OUTLANDER 450,2021-05-10,7,15,HI,US,22,1807
OUTLANDER 1000,2021-05-17,7,8,HI,US,15,1874
OUTLANDER 850,2021-05-17,2,7,HI,US,9,1809
OUTLANDER 450,2021-05-17,2,12,HI,US,14,1821
OUTLANDER 1000,2021-05-24,3,12,HI,US,15,1889
OUTLANDER 850,2021-05-24,6,13,HI,US,19,1828
OUTLANDER 450,2021-05-24,0,14,HI,US,14,1835
OUTLANDER 1000,2021-05-31,6,9,HI,US,15,1904
OUTLANDER 850,2021-05-31,4,3,HI,US,7,1835
OUTLANDER 450,2021-05-31,3,6,HI,US,9,1844
OUTLANDER 1000,2021-06-07,0,15,HI,US,15,1919
OUTLANDER 850,2021-06-07,8,13,HI,US,21,1856
OUTLANDER 450,2021-06-07,10,9,HI,US,19,1863
OUTLANDER 1000,2021-06-14,10,9,HI,US,19,1938
OUTLANDER 850,2021-06-14,0,5,HI,US,5,1861
OUTLANDER 450,2021-06-14,2,8,HI,US,10,1873
OUTLANDER 1000,2021-06-21,2,6,HI,US,8,1946
OUTLANDER 850,2021-06-21,14,14,HI,US,28,1889
OUTLANDER 450,2021-06-21,1,2,HI,US,3,1876
OUTLANDER 1000,2021-06-28,9,11,HI,US,20,1966
OUTLANDER 850,2021-06-28,11,12,HI,US,23,1912
OUTLANDER 450,2021-06-28,6,14,HI,US,20,1896
OUTLANDER 1000,2021-07-05,14,15,HI,US,29,1995
OUTLANDER 850,2021-07-05,8,0,HI,US,8,1920
OUTLANDER 450,2021-07-05,4,2,HI,US,6,1902
OUTLANDER 1000,2021-07-12,15,6,HI,US,21,2016
OUTLANDER 850,2021-07-12,2,11,HI,US,13,1933
OUTLANDER 450,2021-07-12,2,1,HI,US,3,1905
OUTLANDER 1000,2021-07-19,2,11,HI,US,13,2029
OUTLANDER 850,2021-07-19,15,10,HI,US,25,1958
OUTLANDER 450,2021-07-19,15,10,HI,US,25,1930
OUTLANDER 1000,2021-07-26,10,10,HI,US,20,2049
OUTLANDER 850,2021-07-26,10,2,HI,US,12,1970
OUTLANDER 450,2021-07-26,13,13,HI,US,26,1956
OUTLANDER 1000,2021-08-02,3,11,HI,US,14,2063
OUTLANDER 850,2021-08-02,3,6,HI,US,9,1979
OUTLANDER 450,2021-08-02,14,15,HI,US,29,1985
OUTLANDER 1000,2021-08-09,9,12,HI,US,21,2084
OUTLANDER 850,2021-08-09,13,2,HI,US,15,1994
OUTLANDER 450,2021-08-09,11,2,HI,US,13,1998
OUTLANDER 1000,2021-08-16,12,13,HI,US,25,2109
OUTLANDER 850,2021-08-16,11,0,HI,US,11,2005
OUTLANDER 450,2021-08-16,15,3,HI,US,18,2016
OUTLANDER 1000,2021-08-23,3,10,HI,US,13,2122
OUTLANDER 850,2021-08-23,12,13,HI,US,25,2030
OUTLANDER 450,2021-08-23,4,3,HI,US,7,2023
OUTLANDER 1000,2021-08-30,1,3,HI,US,4,2126
OUTLANDER 850,2021-08-30,8,2,HI,US,10,2040
OUTLANDER 450,2021-08-30,14,9,HI,US,23,2046
OUTLANDER 1000,2021-09-06,0,2,HI,US,2,2128
OUTLANDER 850,2021-09-06,14,12,HI,US,26,2066
OUTLANDER 450,2021-09-06,3,11,HI,US,14,2060
OUTLANDER 1000,2021-09-13,15,1,HI,US,16,2144
OUTLANDER 850,2021-09-13,6,1,HI,US,7,2073
OUTLANDER 450,2021-09-13,9,2,HI,US,11,2071
OUTLANDER 1000,2021-09-20,0,14,HI,US,14,2158
OUTLANDER 850,2021-09-20,7,7,HI,US,14,2087
OUTLANDER 450,2021-09-20,6,15,HI,US,21,2092
OUTLANDER 1000,2021-09-27,7,12,HI,US,19,2177
OUTLANDER 850,2021-09-27,9,10,HI,US,19,2106
OUTLANDER 450,2021-09-27,4,13,HI,US,17,2109
OUTLANDER 1000,2021-10-04,5,9,HI,US,14,2191
OUTLANDER 850,2021-10-04,8,7,HI,US,15,2121
OUTLANDER 450,2021-10-04,5,8,HI,US,13,2122
OUTLANDER 1000,2021-10-11,6,1,HI,US,7,2198
OUTLANDER 850,2021-10-11,4,12,HI,US,16,2137
OUTLANDER 450,2021-10-11,5,12,HI,US,17,2139
OUTLANDER 1000,2021-10-18,2,4,HI,US,6,2204
OUTLANDER 850,2021-10-18,14,1,HI,US,15,2152
OUTLANDER 450,2021-10-18,2,8,HI,US,10,2149
OUTLANDER 1000,2021-10-25,5,8,HI,US,13,2217
OUTLANDER 850,2021-10-25,2,8,HI,US,10,2162
OUTLANDER 450,2021-10-25,12,1,HI,US,13,2162
OUTLANDER 1000,2021-11-01,7,14,HI,US,21,2238
OUTLANDER 850,2021-11-01,6,13,HI,US,19,2181
OUTLANDER 450,2021-11-01,4,5,HI,US,9,2171
OUTLANDER 1000,2021-11-08,10,0,HI,US,10,2248
OUTLANDER 850,2021-11-08,3,1,HI,US,4,2185
OUTLANDER 450,2021-11-08,5,10,HI,US,15,2186
OUTLANDER 1000,2021-11-15,12,7,HI,US,19,2267
OUTLANDER 850,2021-11-15,4,2,HI,US,6,2191
OUTLANDER 450,2021-11-15,9,11,HI,US,20,2206
OUTLANDER 1000,2021-11-22,2,13,HI,US,15,2282
OUTLANDER 850,2021-11-22,7,4,HI,US,11,2202
OUTLANDER 450,2021-11-22,8,9,HI,US,17,2223
OUTLANDER 1000,2021-11-29,5,5,HI,US,10,2292
OUTLANDER 850,2021-11-29,6,6,HI,US,12,2214
OUTLANDER 450,2021-11-29,6,8,HI,US,14,2237
OUTLANDER 1000,2021-12-06,10,15,HI,US,25,2317
OUTLANDER 850,2021-12-06,7,12,HI,US,19,2233
OUTLANDER 450,2021-12-06,4,9,HI,US,13,2250
OUTLANDER 1000,2021-12-13,5,2,HI,US,7,2324
OUTLANDER 850,2021-12-13,8,10,HI,US,18,2251
OUTLANDER 450,2021-12-13,5,7,HI,US,12,2262
OUTLANDER 1000,2021-12-20,7,4,HI,US,11,2335
OUTLANDER 850,2021-12-20,8,14,HI,US,22,2273
OUTLANDER 450,2021-12-20,7,2,HI,US,9,2271
OUTLANDER 1000,2021-12-27,5,11,HI,US,16,2351
OUTLANDER 850,2021-12-27,14,10,HI,US,24,2297
OUTLANDER 450,2021-12-27,15,5,HI,US,20,2291
OUTLANDER 1000,2019-01-07,8,3,ID,US,11,11
OUTLANDER 850,2019-01-07,4,5,ID,US,9,9
OUTLANDER 450,2019-01-07,1,12,ID,US,13,13
OUTLANDER 1000,2019-01-14,10,11,ID,US,21,32
OUTLANDER 850,2019-01-14,8,8,ID,US,16,25
OUTLANDER 450,2019-01-14,13,0,ID,US,13,26
OUTLANDER 1000,2019-01-21,11,13,ID,US,24,56
OUTLANDER 850,2019-01-21,5,13,ID,US,18,43
OUTLANDER 450,2019-01-21,7,8,ID,US,15,41
OUTLANDER 1000,2019-01-28,12,3,ID,US,15,71
OUTLANDER 850,2019-01-28,9,4,ID,US,13,56
OUTLANDER 450,2019-01-28,4,13,ID,US,17,58
OUTLANDER 1000,2019-02-04,3,4,ID,US,7,78
OUTLANDER 850,2019-02-04,9,6,ID,US,15,71
OUTLANDER 450,2019-02-04,14,8,ID,US,22,80
OUTLANDER 1000,2019-02-11,12,11,ID,US,23,101
OUTLANDER 850,2019-02-11,11,3,ID,US,14,85
OUTLANDER 450,2019-02-11,11,11,ID,US,22,102
OUTLANDER 1000,2019-02-18,13,7,ID,US,20,121
OUTLANDER 850,2019-02-18,6,5,ID,US,11,96
OUTLANDER 450,2019-02-18,6,4,ID,US,10,112
OUTLANDER 1000,2019-02-25,14,3,ID,US,17,138
OUTLANDER 850,2019-02-25,9,1,ID,US,10,106
OUTLANDER 450,2019-02-25,1,10,ID,US,11,123
OUTLANDER 1000,2019-03-04,4,3,ID,US,7,145
OUTLANDER 850,2019-03-04,3,2,ID,US,5,111
OUTLANDER 450,2019-03-04,5,10,ID,US,15,138
OUTLANDER 1000,2019-03-11,3,3,ID,US,6,151
OUTLANDER 850,2019-03-11,1,10,ID,US,11,122
OUTLANDER 450,2019-03-11,12,11,ID,US,23,161
OUTLANDER 1000,2019-03-18,2,12,ID,US,14,165
OUTLANDER 850,2019-03-18,9,7,ID,US,16,138
OUTLANDER 450,2019-03-18,1,7,ID,US,8,169
OUTLANDER 1000,2019-03-25,6,6,ID,US,12,177
OUTLANDER 850,2019-03-25,5,14,ID,US,19,157
OUTLANDER 450,2019-03-25,9,5,ID,US,14,183
OUTLANDER 1000,2019-04-01,5,13,ID,US,18,195
OUTLANDER 850,2019-04-01,1,7,ID,US,8,165
OUTLANDER 450,2019-04-01,12,14,ID,US,26,209
OUTLANDER 1000,2019-04-08,5,9,ID,US,14,209
OUTLANDER 850,2019-04-08,8,13,ID,US,21,186
OUTLANDER 450,2019-04-08,4,12,ID,US,16,225
OUTLANDER 1000,2019-04-15,15,10,ID,US,25,234
OUTLANDER 850,2019-04-15,7,10,ID,US,17,203
OUTLANDER 450,2019-04-15,5,7,ID,US,12,237
OUTLANDER 1000,2019-04-22,12,0,ID,US,12,246
OUTLANDER 850,2019-04-22,3,1,ID,US,4,207
OUTLANDER 450,2019-04-22,15,4,ID,US,19,256
OUTLANDER 1000,2019-04-29,8,3,ID,US,11,257
OUTLANDER 850,2019-04-29,15,8,ID,US,23,230
OUTLANDER 450,2019-04-29,5,15,ID,US,20,276
OUTLANDER 1000,2019-05-06,6,12,ID,US,18,275
OUTLANDER 850,2019-05-06,12,3,ID,US,15,245
OUTLANDER 450,2019-05-06,8,4,ID,US,12,288
OUTLANDER 1000,2019-05-13,7,4,ID,US,11,286
OUTLANDER 850,2019-05-13,3,13,ID,US,16,261
OUTLANDER 450,2019-05-13,8,7,ID,US,15,303
OUTLANDER 1000,2019-05-20,12,6,ID,US,18,304
OUTLANDER 850,2019-05-20,11,10,ID,US,21,282
OUTLANDER 450,2019-05-20,3,1,ID,US,4,307
OUTLANDER 1000,2019-05-27,5,8,ID,US,13,317
OUTLANDER 850,2019-05-27,9,14,ID,US,23,305
OUTLANDER 450,2019-05-27,9,6,ID,US,15,322
OUTLANDER 1000,2019-06-03,15,12,ID,US,27,344
OUTLANDER 850,2019-06-03,4,2,ID,US,6,311
OUTLANDER 450,2019-06-03,14,13,ID,US,27,349
OUTLANDER 1000,2019-06-10,1,2,ID,US,3,347
OUTLANDER 850,2019-06-10,8,13,ID,US,21,332
OUTLANDER 450,2019-06-10,7,12,ID,US,19,368
OUTLANDER 1000,2019-06-17,7,3,ID,US,10,357
OUTLANDER 850,2019-06-17,14,13,ID,US,27,359
OUTLANDER 450,2019-06-17,8,4,ID,US,12,380
OUTLANDER 1000,2019-06-24,3,2,ID,US,5,362
OUTLANDER 850,2019-06-24,6,13,ID,US,19,378
OUTLANDER 450,2019-06-24,3,1,ID,US,4,384
OUTLANDER 1000,2019-07-01,4,15,ID,US,19,381
OUTLANDER 850,2019-07-01,2,7,ID,US,9,387
OUTLANDER 450,2019-07-01,10,12,ID,US,22,406
OUTLANDER 1000,2019-07-08,2,6,ID,US,8,389
OUTLANDER 850,2019-07-08,14,8,ID,US,22,409
OUTLANDER 450,2019-07-08,2,12,ID,US,14,420
OUTLANDER 1000,2019-07-15,10,13,ID,US,23,412
OUTLANDER 850,2019-07-15,5,4,ID,US,9,418
OUTLANDER 450,2019-07-15,13,13,ID,US,26,446
OUTLANDER 1000,2019-07-22,12,2,ID,US,14,426
OUTLANDER 850,2019-07-22,3,8,ID,US,11,429
OUTLANDER 450,2019-07-22,8,11,ID,US,19,465
OUTLANDER 1000,2019-07-29,3,5,ID,US,8,434
OUTLANDER 850,2019-07-29,11,13,ID,US,24,453
OUTLANDER 450,2019-07-29,14,3,ID,US,17,482
OUTLANDER 1000,2019-08-05,13,1,ID,US,14,448
OUTLANDER 850,2019-08-05,6,12,ID,US,18,471
OUTLANDER 450,2019-08-05,2,5,ID,US,7,489
OUTLANDER 1000,2019-08-12,11,9,ID,US,20,468
OUTLANDER 850,2019-08-12,9,1,ID,US,10,481
OUTLANDER 450,2019-08-12,2,10,ID,US,12,501
OUTLANDER 1000,2019-08-19,7,14,ID,US,21,489
OUTLANDER 850,2019-08-19,7,7,ID,US,14,495
OUTLANDER 450,2019-08-19,13,4,ID,US,17,518
OUTLANDER 1000,2019-08-26,6,1,ID,US,7,496
OUTLANDER 850,2019-08-26,10,9,ID,US,19,514
OUTLANDER 450,2019-08-26,15,4,ID,US,19,537
OUTLANDER 1000,2019-09-02,10,1,ID,US,11,507
OUTLANDER 850,2019-09-02,9,2,ID,US,11,525
OUTLANDER 450,2019-09-02,8,7,ID,US,15,552
OUTLANDER 1000,2019-09-09,9,4,ID,US,13,520
OUTLANDER 850,2019-09-09,5,11,ID,US,16,541
OUTLANDER 450,2019-09-09,2,3,ID,US,5,557
OUTLANDER 1000,2019-09-16,12,11,ID,US,23,543
OUTLANDER 850,2019-09-16,10,4,ID,US,14,555
OUTLANDER 450,2019-09-16,4,11,ID,US,15,572
OUTLANDER 1000,2019-09-23,3,2,ID,US,5,548
OUTLANDER 850,2019-09-23,12,13,ID,US,25,580
OUTLANDER 450,2019-09-23,13,4,ID,US,17,589
OUTLANDER 1000,2019-09-30,11,8,ID,US,19,567
OUTLANDER 850,2019-09-30,12,15,ID,US,27,607
OUTLANDER 450,2019-09-30,7,14,ID,US,21,610
OUTLANDER 1000,2019-10-07,11,9,ID,US,20,587
OUTLANDER 850,2019-10-07,8,12,ID,US,20,627
OUTLANDER 450,2019-10-07,5,1,ID,US,6,616
OUTLANDER 1000,2019-10-14,2,6,ID,US,8,595
OUTLANDER 850,2019-10-14,8,12,ID,US,20,647
OUTLANDER 450,2019-10-14,2,3,ID,US,5,621
OUTLANDER 1000,2019-10-21,2,4,ID,US,6,601
OUTLANDER 850,2019-10-21,1,10,ID,US,11,658
OUTLANDER 450,2019-10-21,9,8,ID,US,17,638
OUTLANDER 1000,2019-10-28,12,0,ID,US,12,613
OUTLANDER 850,2019-10-28,11,3,ID,US,14,672
OUTLANDER 450,2019-10-28,5,14,ID,US,19,657
OUTLANDER 1000,2019-11-04,8,12,ID,US,20,633
OUTLANDER 850,2019-11-04,9,13,ID,US,22,694
OUTLANDER 450,2019-11-04,6,11,ID,US,17,674
OUTLANDER 1000,2019-11-11,6,8,ID,US,14,647
OUTLANDER 850,2019-11-11,10,9,ID,US,19,713
OUTLANDER 450,2019-11-11,13,10,ID,US,23,697
OUTLANDER 1000,2019-11-18,4,8,ID,US,12,659
OUTLANDER 850,2019-11-18,0,6,ID,US,6,719
OUTLANDER 450,2019-11-18,9,4,ID,US,13,710
OUTLANDER 1000,2019-11-25,8,12,ID,US,20,679
OUTLANDER 850,2019-11-25,8,4,ID,US,12,731
OUTLANDER 450,2019-11-25,14,9,ID,US,23,733
OUTLANDER 1000,2019-12-02,15,3,ID,US,18,697
OUTLANDER 850,2019-12-02,12,12,ID,US,24,755
OUTLANDER 450,2019-12-02,5,2,ID,US,7,740
OUTLANDER 1000,2019-12-09,3,2,ID,US,5,702
OUTLANDER 850,2019-12-09,11,1,ID,US,12,767
OUTLANDER 450,2019-12-09,12,13,ID,US,25,765
OUTLANDER 1000,2019-12-16,1,8,ID,US,9,711
OUTLANDER 850,2019-12-16,14,4,ID,US,18,785
OUTLANDER 450,2019-12-16,6,12,ID,US,18,783
OUTLANDER 1000,2019-12-23,9,7,ID,US,16,727
OUTLANDER 850,2019-12-23,0,4,ID,US,4,789
OUTLANDER 450,2019-12-23,9,3,ID,US,12,795
OUTLANDER 1000,2019-12-30,5,13,ID,US,18,745
OUTLANDER 850,2019-12-30,3,1,ID,US,4,793
OUTLANDER 450,2019-12-30,14,7,ID,US,21,816
OUTLANDER 1000,2020-01-06,2,5,ID,US,7,752
OUTLANDER 850,2020-01-06,3,12,ID,US,15,808
OUTLANDER 450,2020-01-06,13,3,ID,US,16,832
OUTLANDER 1000,2020-01-13,13,10,ID,US,23,775
OUTLANDER 850,2020-01-13,15,0,ID,US,15,823
OUTLANDER 450,2020-01-13,12,13,ID,US,25,857
OUTLANDER 1000,2020-01-20,3,9,ID,US,12,787
OUTLANDER 850,2020-01-20,4,7,ID,US,11,834
OUTLANDER 450,2020-01-20,10,14,ID,US,24,881
OUTLANDER 1000,2020-01-27,3,13,ID,US,16,803
OUTLANDER 850,2020-01-27,8,5,ID,US,13,847
OUTLANDER 450,2020-01-27,5,9,ID,US,14,895
OUTLANDER 1000,2020-02-03,12,3,ID,US,15,818
OUTLANDER 850,2020-02-03,11,0,ID,US,11,858
OUTLANDER 450,2020-02-03,1,5,ID,US,6,901
OUTLANDER 1000,2020-02-10,2,11,ID,US,13,831
OUTLANDER 850,2020-02-10,14,10,ID,US,24,882
OUTLANDER 450,2020-02-10,8,2,ID,US,10,911
OUTLANDER 1000,2020-02-17,4,11,ID,US,15,846
OUTLANDER 850,2020-02-17,14,6,ID,US,20,902
OUTLANDER 450,2020-02-17,8,13,ID,US,21,932
OUTLANDER 1000,2020-02-24,14,13,ID,US,27,873
OUTLANDER 850,2020-02-24,7,11,ID,US,18,920
OUTLANDER 450,2020-02-24,7,9,ID,US,16,948
OUTLANDER 1000,2020-03-02,7,0,ID,US,7,880
OUTLANDER 850,2020-03-02,9,13,ID,US,22,942
OUTLANDER 450,2020-03-02,8,9,ID,US,17,965
OUTLANDER 1000,2020-03-09,11,2,ID,US,13,893
OUTLANDER 850,2020-03-09,6,5,ID,US,11,953
OUTLANDER 450,2020-03-09,7,13,ID,US,20,985
OUTLANDER 1000,2020-03-16,8,10,ID,US,18,911
OUTLANDER 850,2020-03-16,5,12,ID,US,17,970
OUTLANDER 450,2020-03-16,4,9,ID,US,13,998
OUTLANDER 1000,2020-03-23,10,3,ID,US,13,924
OUTLANDER 850,2020-03-23,9,2,ID,US,11,981
OUTLANDER 450,2020-03-23,15,9,ID,US,24,1022
OUTLANDER 1000,2020-03-30,15,14,ID,US,29,953
OUTLANDER 850,2020-03-30,8,4,ID,US,12,993
OUTLANDER 450,2020-03-30,4,5,ID,US,9,1031
OUTLANDER 1000,2020-04-06,4,5,ID,US,9,962
OUTLANDER 850,2020-04-06,10,5,ID,US,15,1008
OUTLANDER 450,2020-04-06,13,15,ID,US,28,1059
OUTLANDER 1000,2020-04-13,14,6,ID,US,20,982
OUTLANDER 850,2020-04-13,14,14,ID,US,28,1036
OUTLANDER 450,2020-04-13,0,8,ID,US,8,1067
OUTLANDER 1000,2020-04-20,3,6,ID,US,9,991
OUTLANDER 850,2020-04-20,14,9,ID,US,23,1059
OUTLANDER 450,2020-04-20,5,2,ID,US,7,1074
OUTLANDER 1000,2020-04-27,8,4,ID,US,12,1003
OUTLANDER 850,2020-04-27,10,12,ID,US,22,1081
OUTLANDER 450,2020-04-27,2,3,ID,US,5,1079
OUTLANDER 1000,2020-05-04,3,9,ID,US,12,1015
OUTLANDER 850,2020-05-04,10,1,ID,US,11,1092
OUTLANDER 450,2020-05-04,14,13,ID,US,27,1106
OUTLANDER 1000,2020-05-11,5,2,ID,US,7,1022
OUTLANDER 850,2020-05-11,14,5,ID,US,19,1111
OUTLANDER 450,2020-05-11,12,7,ID,US,19,1125
OUTLANDER 1000,2020-05-18,2,9,ID,US,11,1033
OUTLANDER 850,2020-05-18,14,0,ID,US,14,1125
OUTLANDER 450,2020-05-18,13,9,ID,US,22,1147
OUTLANDER 1000,2020-05-25,10,12,ID,US,22,1055
OUTLANDER 850,2020-05-25,9,6,ID,US,15,1140
OUTLANDER 450,2020-05-25,12,10,ID,US,22,1169
OUTLANDER 1000,2020-06-01,3,10,ID,US,13,1068
OUTLANDER 850,2020-06-01,10,12,ID,US,22,1162
OUTLANDER 450,2020-06-01,13,8,ID,US,21,1190
OUTLANDER 1000,2020-06-08,2,4,ID,US,6,1074
OUTLANDER 850,2020-06-08,7,12,ID,US,19,1181
OUTLANDER 450,2020-06-08,13,2,ID,US,15,1205
OUTLANDER 1000,2020-06-15,12,12,ID,US,24,1098
OUTLANDER 850,2020-06-15,0,10,ID,US,10,1191
OUTLANDER 450,2020-06-15,14,9,ID,US,23,1228
OUTLANDER 1000,2020-06-22,0,4,ID,US,4,1102
OUTLANDER 850,2020-06-22,10,0,ID,US,10,1201
OUTLANDER 450,2020-06-22,13,7,ID,US,20,1248
OUTLANDER 1000,2020-06-29,8,2,ID,US,10,1112
OUTLANDER 850,2020-06-29,13,10,ID,US,23,1224
OUTLANDER 450,2020-06-29,7,11,ID,US,18,1266
OUTLANDER 1000,2020-07-06,2,5,ID,US,7,1119
OUTLANDER 850,2020-07-06,7,2,ID,US,9,1233
OUTLANDER 450,2020-07-06,9,7,ID,US,16,1282
OUTLANDER 1000,2020-07-13,1,9,ID,US,10,1129
OUTLANDER 850,2020-07-13,6,2,ID,US,8,1241
OUTLANDER 450,2020-07-13,4,4,ID,US,8,1290
OUTLANDER 1000,2020-07-20,10,9,ID,US,19,1148
OUTLANDER 850,2020-07-20,13,12,ID,US,25,1266
OUTLANDER 450,2020-07-20,4,9,ID,US,13,1303
OUTLANDER 1000,2020-07-27,0,13,ID,US,13,1161
OUTLANDER 850,2020-07-27,14,12,ID,US,26,1292
OUTLANDER 450,2020-07-27,9,2,ID,US,11,1314
OUTLANDER 1000,2020-08-03,1,15,ID,US,16,1177
OUTLANDER 850,2020-08-03,13,13,ID,US,26,1318
OUTLANDER 450,2020-08-03,5,12,ID,US,17,1331
OUTLANDER 1000,2020-08-10,13,4,ID,US,17,1194
OUTLANDER 850,2020-08-10,7,5,ID,US,12,1330
OUTLANDER 450,2020-08-10,7,13,ID,US,20,1351
OUTLANDER 1000,2020-08-17,1,9,ID,US,10,1204
OUTLANDER 850,2020-08-17,14,8,ID,US,22,1352
OUTLANDER 450,2020-08-17,1,4,ID,US,5,1356
OUTLANDER 1000,2020-08-24,7,9,ID,US,16,1220
OUTLANDER 850,2020-08-24,10,7,ID,US,17,1369
OUTLANDER 450,2020-08-24,0,6,ID,US,6,1362
OUTLANDER 1000,2020-08-31,9,4,ID,US,13,1233
OUTLANDER 850,2020-08-31,13,10,ID,US,23,1392
OUTLANDER 450,2020-08-31,6,13,ID,US,19,1381
OUTLANDER 1000,2020-09-07,14,1,ID,US,15,1248
OUTLANDER 850,2020-09-07,13,5,ID,US,18,1410
OUTLANDER 450,2020-09-07,11,13,ID,US,24,1405
OUTLANDER 1000,2020-09-14,9,12,ID,US,21,1269
OUTLANDER 850,2020-09-14,9,7,ID,US,16,1426
OUTLANDER 450,2020-09-14,4,9,ID,US,13,1418
OUTLANDER 1000,2020-09-21,5,10,ID,US,15,1284
OUTLANDER 850,2020-09-21,5,4,ID,US,9,1435
OUTLANDER 450,2020-09-21,7,13,ID,US,20,1438
OUTLANDER 1000,2020-09-28,9,14,ID,US,23,1307
OUTLANDER 850,2020-09-28,8,6,ID,US,14,1449
OUTLANDER 450,2020-09-28,0,8,ID,US,8,1446
OUTLANDER 1000,2020-10-05,13,4,ID,US,17,1324
OUTLANDER 850,2020-10-05,9,1,ID,US,10,1459
OUTLANDER 450,2020-10-05,14,5,ID,US,19,1465
OUTLANDER 1000,2020-10-12,1,11,ID,US,12,1336
OUTLANDER 850,2020-10-12,3,4,ID,US,7,1466
OUTLANDER 450,2020-10-12,10,12,ID,US,22,1487
OUTLANDER 1000,2020-10-19,1,9,ID,US,10,1346
OUTLANDER 850,2020-10-19,14,14,ID,US,28,1494
OUTLANDER 450,2020-10-19,2,15,ID,US,17,1504
OUTLANDER 1000,2020-10-26,9,10,ID,US,19,1365
OUTLANDER 850,2020-10-26,11,14,ID,US,25,1519
OUTLANDER 450,2020-10-26,1,13,ID,US,14,1518
OUTLANDER 1000,2020-11-02,3,13,ID,US,16,1381
OUTLANDER 850,2020-11-02,3,3,ID,US,6,1525
OUTLANDER 450,2020-11-02,0,8,ID,US,8,1526
OUTLANDER 1000,2020-11-09,4,1,ID,US,5,1386
OUTLANDER 850,2020-11-09,4,8,ID,US,12,1537
OUTLANDER 450,2020-11-09,6,7,ID,US,13,1539
OUTLANDER 1000,2020-11-16,5,13,ID,US,18,1404
OUTLANDER 850,2020-11-16,15,0,ID,US,15,1552
OUTLANDER 450,2020-11-16,10,3,ID,US,13,1552
OUTLANDER 1000,2020-11-23,9,5,ID,US,14,1418
OUTLANDER 850,2020-11-23,3,7,ID,US,10,1562
OUTLANDER 450,2020-11-23,13,12,ID,US,25,1577
OUTLANDER 1000,2020-11-30,15,8,ID,US,23,1441
OUTLANDER 850,2020-11-30,12,1,ID,US,13,1575
OUTLANDER 450,2020-11-30,13,13,ID,US,26,1603
OUTLANDER 1000,2020-12-07,14,11,ID,US,25,1466
OUTLANDER 850,2020-12-07,1,12,ID,US,13,1588
OUTLANDER 450,2020-12-07,3,15,ID,US,18,1621
OUTLANDER 1000,2020-12-14,1,3,ID,US,4,1470
OUTLANDER 850,2020-12-14,5,5,ID,US,10,1598
OUTLANDER 450,2020-12-14,14,6,ID,US,20,1641
OUTLANDER 1000,2020-12-21,9,10,ID,US,19,1489
OUTLANDER 850,2020-12-21,13,9,ID,US,22,1620
OUTLANDER 450,2020-12-21,2,8,ID,US,10,1651
OUTLANDER 1000,2020-12-28,7,6,ID,US,13,1502
OUTLANDER 850,2020-12-28,5,7,ID,US,12,1632
OUTLANDER 450,2020-12-28,6,8,ID,US,14,1665
OUTLANDER 1000,2021-01-04,3,6,ID,US,9,1511
OUTLANDER 850,2021-01-04,0,6,ID,US,6,1638
OUTLANDER 450,2021-01-04,11,10,ID,US,21,1686
OUTLANDER 1000,2021-01-11,4,9,ID,US,13,1524
OUTLANDER 850,2021-01-11,2,6,ID,US,8,1646
OUTLANDER 450,2021-01-11,3,6,ID,US,9,1695
OUTLANDER 1000,2021-01-18,2,7,ID,US,9,1533
OUTLANDER 850,2021-01-18,3,2,ID,US,5,1651
OUTLANDER 450,2021-01-18,6,7,ID,US,13,1708
OUTLANDER 1000,2021-01-25,11,8,ID,US,19,1552
OUTLANDER 850,2021-01-25,8,2,ID,US,10,1661
OUTLANDER 450,2021-01-25,6,15,ID,US,21,1729
OUTLANDER 1000,2021-02-01,2,12,ID,US,14,1566
OUTLANDER 850,2021-02-01,8,8,ID,US,16,1677
OUTLANDER 450,2021-02-01,9,4,ID,US,13,1742
OUTLANDER 1000,2021-02-08,13,9,ID,US,22,1588
OUTLANDER 850,2021-02-08,5,11,ID,US,16,1693
OUTLANDER 450,2021-02-08,10,3,ID,US,13,1755
OUTLANDER 1000,2021-02-15,11,0,ID,US,11,1599
OUTLANDER 850,2021-02-15,3,8,ID,US,11,1704
OUTLANDER 450,2021-02-15,10,10,ID,US,20,1775
OUTLANDER 1000,2021-02-22,3,6,ID,US,9,1608
OUTLANDER 850,2021-02-22,8,14,ID,US,22,1726
OUTLANDER 450,2021-02-22,9,4,ID,US,13,1788
OUTLANDER 1000,2021-03-01,12,1,ID,US,13,1621
OUTLANDER 850,2021-03-01,11,9,ID,US,20,1746
OUTLANDER 450,2021-03-01,7,3,ID,US,10,1798
OUTLANDER 1000,2021-03-08,12,9,ID,US,21,1642
OUTLANDER 850,2021-03-08,12,2,ID,US,14,1760
OUTLANDER 450,2021-03-08,14,12,ID,US,26,1824
OUTLANDER 1000,2021-03-15,4,14,ID,US,18,1660
OUTLANDER 850,2021-03-15,4,9,ID,US,13,1773
OUTLANDER 450,2021-03-15,0,3,ID,US,3,1827
OUTLANDER 1000,2021-03-22,6,0,ID,US,6,1666
OUTLANDER 850,2021-03-22,5,14,ID,US,19,1792
OUTLANDER 450,2021-03-22,4,11,ID,US,15,1842
OUTLANDER 1000,2021-03-29,10,13,ID,US,23,1689
OUTLANDER 850,2021-03-29,11,6,ID,US,17,1809
OUTLANDER 450,2021-03-29,3,10,ID,US,13,1855
OUTLANDER 1000,2021-04-05,1,12,ID,US,13,1702
OUTLANDER 850,2021-04-05,1,12,ID,US,13,1822
OUTLANDER 450,2021-04-05,12,5,ID,US,17,1872
OUTLANDER 1000,2021-04-12,7,13,ID,US,20,1722
OUTLANDER 850,2021-04-12,0,6,ID,US,6,1828
OUTLANDER 450,2021-04-12,6,4,ID,US,10,1882
OUTLANDER 1000,2021-04-19,1,5,ID,US,6,1728
OUTLANDER 850,2021-04-19,10,10,ID,US,20,1848
OUTLANDER 450,2021-04-19,15,12,ID,US,27,1909
OUTLANDER 1000,2021-04-26,3,6,ID,US,9,1737
OUTLANDER 850,2021-04-26,8,11,ID,US,19,1867
OUTLANDER 450,2021-04-26,3,2,ID,US,5,1914
OUTLANDER 1000,2021-05-03,6,4,ID,US,10,1747
OUTLANDER 850,2021-05-03,15,4,ID,US,19,1886
OUTLANDER 450,2021-05-03,12,7,ID,US,19,1933
OUTLANDER 1000,2021-05-10,10,15,ID,US,25,1772
OUTLANDER 850,2021-05-10,10,14,ID,US,24,1910
OUTLANDER 450,2021-05-10,5,9,ID,US,14,1947
OUTLANDER 1000,2021-05-17,9,7,ID,US,16,1788
OUTLANDER 850,2021-05-17,6,9,ID,US,15,1925
OUTLANDER 450,2021-05-17,13,4,ID,US,17,1964
OUTLANDER 1000,2021-05-24,12,11,ID,US,23,1811
OUTLANDER 850,2021-05-24,1,10,ID,US,11,1936
OUTLANDER 450,2021-05-24,10,4,ID,US,14,1978
OUTLANDER 1000,2021-05-31,5,12,ID,US,17,1828
OUTLANDER 850,2021-05-31,4,1,ID,US,5,1941
OUTLANDER 450,2021-05-31,15,7,ID,US,22,2000
OUTLANDER 1000,2021-06-07,6,6,ID,US,12,1840
OUTLANDER 850,2021-06-07,2,9,ID,US,11,1952
OUTLANDER 450,2021-06-07,9,4,ID,US,13,2013
OUTLANDER 1000,2021-06-14,14,13,ID,US,27,1867
OUTLANDER 850,2021-06-14,12,14,ID,US,26,1978
OUTLANDER 450,2021-06-14,4,5,ID,US,9,2022
OUTLANDER 1000,2021-06-21,12,1,ID,US,13,1880
OUTLANDER 850,2021-06-21,14,15,ID,US,29,2007
OUTLANDER 450,2021-06-21,14,9,ID,US,23,2045
OUTLANDER 1000,2021-06-28,10,14,ID,US,24,1904
OUTLANDER 850,2021-06-28,10,5,ID,US,15,2022
OUTLANDER 450,2021-06-28,7,6,ID,US,13,2058
OUTLANDER 1000,2021-07-05,2,3,ID,US,5,1909
OUTLANDER 850,2021-07-05,6,10,ID,US,16,2038
OUTLANDER 450,2021-07-05,4,8,ID,US,12,2070
OUTLANDER 1000,2021-07-12,5,3,ID,US,8,1917
OUTLANDER 850,2021-07-12,14,12,ID,US,26,2064
OUTLANDER 450,2021-07-12,2,10,ID,US,12,2082
OUTLANDER 1000,2021-07-19,0,9,ID,US,9,1926
OUTLANDER 850,2021-07-19,7,4,ID,US,11,2075
OUTLANDER 450,2021-07-19,0,2,ID,US,2,2084
OUTLANDER 1000,2021-07-26,3,1,ID,US,4,1930
OUTLANDER 850,2021-07-26,3,15,ID,US,18,2093
OUTLANDER 450,2021-07-26,10,12,ID,US,22,2106
OUTLANDER 1000,2021-08-02,8,3,ID,US,11,1941
OUTLANDER 850,2021-08-02,13,10,ID,US,23,2116
OUTLANDER 450,2021-08-02,13,15,ID,US,28,2134
OUTLANDER 1000,2021-08-09,0,1,ID,US,1,1942
OUTLANDER 850,2021-08-09,11,4,ID,US,15,2131
OUTLANDER 450,2021-08-09,10,8,ID,US,18,2152
OUTLANDER 1000,2021-08-16,8,12,ID,US,20,1962
OUTLANDER 850,2021-08-16,8,6,ID,US,14,2145
OUTLANDER 450,2021-08-16,4,12,ID,US,16,2168
OUTLANDER 1000,2021-08-23,14,14,ID,US,28,1990
OUTLANDER 850,2021-08-23,7,6,ID,US,13,2158
OUTLANDER 450,2021-08-23,6,7,ID,US,13,2181
OUTLANDER 1000,2021-08-30,1,2,ID,US,3,1993
OUTLANDER 850,2021-08-30,7,4,ID,US,11,2169
OUTLANDER 450,2021-08-30,10,15,ID,US,25,2206
OUTLANDER 1000,2021-09-06,10,7,ID,US,17,2010
OUTLANDER 850,2021-09-06,15,2,ID,US,17,2186
OUTLANDER 450,2021-09-06,8,9,ID,US,17,2223
OUTLANDER 1000,2021-09-13,11,4,ID,US,15,2025
OUTLANDER 850,2021-09-13,2,1,ID,US,3,2189
OUTLANDER 450,2021-09-13,7,11,ID,US,18,2241
OUTLANDER 1000,2021-09-20,13,12,ID,US,25,2050
OUTLANDER 850,2021-09-20,11,3,ID,US,14,2203
OUTLANDER 450,2021-09-20,2,14,ID,US,16,2257
OUTLANDER 1000,2021-09-27,6,3,ID,US,9,2059
OUTLANDER 850,2021-09-27,12,5,ID,US,17,2220
OUTLANDER 450,2021-09-27,12,3,ID,US,15,2272
OUTLANDER 1000,2021-10-04,9,12,ID,US,21,2080
OUTLANDER 850,2021-10-04,8,7,ID,US,15,2235
OUTLANDER 450,2021-10-04,6,13,ID,US,19,2291
OUTLANDER 1000,2021-10-11,9,2,ID,US,11,2091
OUTLANDER 850,2021-10-11,5,7,ID,US,12,2247
OUTLANDER 450,2021-10-11,6,7,ID,US,13,2304
OUTLANDER 1000,2021-10-18,4,12,ID,US,16,2107
OUTLANDER 850,2021-10-18,6,9,ID,US,15,2262
OUTLANDER 450,2021-10-18,7,12,ID,US,19,2323
OUTLANDER 1000,2021-10-25,5,7,ID,US,12,2119
OUTLANDER 850,2021-10-25,4,9,ID,US,13,2275
OUTLANDER 450,2021-10-25,0,2,ID,US,2,2325
OUTLANDER 1000,2021-11-01,8,3,ID,US,11,2130
OUTLANDER 850,2021-11-01,0,14,ID,US,14,2289
OUTLANDER 450,2021-11-01,6,9,ID,US,15,2340
OUTLANDER 1000,2021-11-08,2,9,ID,US,11,2141
OUTLANDER 850,2021-11-08,4,3,ID,US,7,2296
OUTLANDER 450,2021-11-08,7,1,ID,US,8,2348
OUTLANDER 1000,2021-11-15,10,13,ID,US,23,2164
OUTLANDER 850,2021-11-15,4,10,ID,US,14,2310
OUTLANDER 450,2021-11-15,12,8,ID,US,20,2368
OUTLANDER 1000,2021-11-22,5,8,ID,US,13,2177
OUTLANDER 850,2021-11-22,6,7,ID,US,13,2323
OUTLANDER 450,2021-11-22,13,1,ID,US,14,2382
OUTLANDER 1000,2021-11-29,6,5,ID,US,11,2188
OUTLANDER 850,2021-11-29,8,7,ID,US,15,2338
OUTLANDER 450,2021-11-29,13,8,ID,US,21,2403
OUTLANDER 1000,2021-12-06,14,12,ID,US,26,2214
OUTLANDER 850,2021-12-06,2,10,ID,US,12,2350
OUTLANDER 450,2021-12-06,7,14,ID,US,21,2424
OUTLANDER 1000,2021-12-13,13,6,ID,US,19,2233
OUTLANDER 850,2021-12-13,3,4,ID,US,7,2357
OUTLANDER 450,2021-12-13,5,10,ID,US,15,2439
OUTLANDER 1000,2021-12-20,13,12,ID,US,25,2258
OUTLANDER 850,2021-12-20,4,6,ID,US,10,2367
OUTLANDER 450,2021-12-20,7,1,ID,US,8,2447
OUTLANDER 1000,2021-12-27,13,11,ID,US,24,2282
OUTLANDER 850,2021-12-27,14,9,ID,US,23,2390
OUTLANDER 450,2021-12-27,14,5,ID,US,19,2466
OUTLANDER 1000,2019-01-07,12,9,IL,US,21,21
OUTLANDER 850,2019-01-07,9,1,IL,US,10,10
OUTLANDER 450,2019-01-07,4,3,IL,US,7,7
OUTLANDER 1000,2019-01-14,10,11,IL,US,21,42
OUTLANDER 850,2019-01-14,15,8,IL,US,23,33
OUTLANDER 450,2019-01-14,11,15,IL,US,26,33
OUTLANDER 1000,2019-01-21,12,14,IL,US,26,68
OUTLANDER 850,2019-01-21,13,14,IL,US,27,60
OUTLANDER 450,2019-01-21,14,11,IL,US,25,58
OUTLANDER 1000,2019-01-28,4,11,IL,US,15,83
OUTLANDER 850,2019-01-28,14,7,IL,US,21,81
OUTLANDER 450,2019-01-28,7,13,IL,US,20,78
OUTLANDER 1000,2019-02-04,11,0,IL,US,11,94
OUTLANDER 850,2019-02-04,2,1,IL,US,3,84
OUTLANDER 450,2019-02-04,12,9,IL,US,21,99
OUTLANDER 1000,2019-02-11,6,7,IL,US,13,107
OUTLANDER 850,2019-02-11,14,9,IL,US,23,107
OUTLANDER 450,2019-02-11,1,14,IL,US,15,114
OUTLANDER 1000,2019-02-18,13,13,IL,US,26,133
OUTLANDER 850,2019-02-18,12,8,IL,US,20,127
OUTLANDER 450,2019-02-18,13,10,IL,US,23,137
OUTLANDER 1000,2019-02-25,9,15,IL,US,24,157
OUTLANDER 850,2019-02-25,11,3,IL,US,14,141
OUTLANDER 450,2019-02-25,11,1,IL,US,12,149
OUTLANDER 1000,2019-03-04,4,5,IL,US,9,166
OUTLANDER 850,2019-03-04,5,0,IL,US,5,146
OUTLANDER 450,2019-03-04,2,8,IL,US,10,159
OUTLANDER 1000,2019-03-11,0,1,IL,US,1,167
OUTLANDER 850,2019-03-11,7,5,IL,US,12,158
OUTLANDER 450,2019-03-11,0,1,IL,US,1,160
OUTLANDER 1000,2019-03-18,11,4,IL,US,15,182
OUTLANDER 850,2019-03-18,10,13,IL,US,23,181
OUTLANDER 450,2019-03-18,14,9,IL,US,23,183
OUTLANDER 1000,2019-03-25,9,6,IL,US,15,197
OUTLANDER 850,2019-03-25,3,0,IL,US,3,184
OUTLANDER 450,2019-03-25,12,9,IL,US,21,204
OUTLANDER 1000,2019-04-01,7,6,IL,US,13,210
OUTLANDER 850,2019-04-01,1,10,IL,US,11,195
OUTLANDER 450,2019-04-01,14,2,IL,US,16,220
OUTLANDER 1000,2019-04-08,5,4,IL,US,9,219
OUTLANDER 850,2019-04-08,2,8,IL,US,10,205
OUTLANDER 450,2019-04-08,11,5,IL,US,16,236
OUTLANDER 1000,2019-04-15,12,13,IL,US,25,244
OUTLANDER 850,2019-04-15,7,5,IL,US,12,217
OUTLANDER 450,2019-04-15,15,14,IL,US,29,265
OUTLANDER 1000,2019-04-22,14,7,IL,US,21,265
OUTLANDER 850,2019-04-22,9,7,IL,US,16,233
OUTLANDER 450,2019-04-22,9,1,IL,US,10,275
OUTLANDER 1000,2019-04-29,0,2,IL,US,2,267
OUTLANDER 850,2019-04-29,8,6,IL,US,14,247
OUTLANDER 450,2019-04-29,6,4,IL,US,10,285
OUTLANDER 1000,2019-05-06,10,5,IL,US,15,282
OUTLANDER 850,2019-05-06,8,2,IL,US,10,257
OUTLANDER 450,2019-05-06,9,9,IL,US,18,303
OUTLANDER 1000,2019-05-13,1,14,IL,US,15,297
OUTLANDER 850,2019-05-13,5,6,IL,US,11,268
OUTLANDER 450,2019-05-13,10,8,IL,US,18,321
OUTLANDER 1000,2019-05-20,4,7,IL,US,11,308
OUTLANDER 850,2019-05-20,9,8,IL,US,17,285
OUTLANDER 450,2019-05-20,5,6,IL,US,11,332
OUTLANDER 1000,2019-05-27,1,5,IL,US,6,314
OUTLANDER 850,2019-05-27,0,12,IL,US,12,297
OUTLANDER 450,2019-05-27,8,7,IL,US,15,347
OUTLANDER 1000,2019-06-03,14,11,IL,US,25,339
OUTLANDER 850,2019-06-03,3,0,IL,US,3,300
OUTLANDER 450,2019-06-03,5,0,IL,US,5,352
OUTLANDER 1000,2019-06-10,8,1,IL,US,9,348
OUTLANDER 850,2019-06-10,2,6,IL,US,8,308
OUTLANDER 450,2019-06-10,11,3,IL,US,14,366
OUTLANDER 1000,2019-06-17,13,12,IL,US,25,373
OUTLANDER 850,2019-06-17,8,2,IL,US,10,318
OUTLANDER 450,2019-06-17,5,0,IL,US,5,371
OUTLANDER 1000,2019-06-24,3,4,IL,US,7,380
OUTLANDER 850,2019-06-24,9,11,IL,US,20,338
OUTLANDER 450,2019-06-24,15,4,IL,US,19,390
OUTLANDER 1000,2019-07-01,12,9,IL,US,21,401
OUTLANDER 850,2019-07-01,15,4,IL,US,19,357
OUTLANDER 450,2019-07-01,0,12,IL,US,12,402
OUTLANDER 1000,2019-07-08,5,5,IL,US,10,411
OUTLANDER 850,2019-07-08,11,4,IL,US,15,372
OUTLANDER 450,2019-07-08,5,12,IL,US,17,419
OUTLANDER 1000,2019-07-15,1,9,IL,US,10,421
OUTLANDER 850,2019-07-15,14,5,IL,US,19,391
OUTLANDER 450,2019-07-15,2,8,IL,US,10,429
OUTLANDER 1000,2019-07-22,14,7,IL,US,21,442
OUTLANDER 850,2019-07-22,6,8,IL,US,14,405
OUTLANDER 450,2019-07-22,2,5,IL,US,7,436
OUTLANDER 1000,2019-07-29,13,1,IL,US,14,456
OUTLANDER 850,2019-07-29,11,6,IL,US,17,422
OUTLANDER 450,2019-07-29,0,10,IL,US,10,446
OUTLANDER 1000,2019-08-05,4,6,IL,US,10,466
OUTLANDER 850,2019-08-05,5,7,IL,US,12,434
OUTLANDER 450,2019-08-05,11,12,IL,US,23,469
OUTLANDER 1000,2019-08-12,9,10,IL,US,19,485
OUTLANDER 850,2019-08-12,3,14,IL,US,17,451
OUTLANDER 450,2019-08-12,6,1,IL,US,7,476
OUTLANDER 1000,2019-08-19,15,0,IL,US,15,500
OUTLANDER 850,2019-08-19,13,6,IL,US,19,470
OUTLANDER 450,2019-08-19,5,1,IL,US,6,482
OUTLANDER 1000,2019-08-26,8,9,IL,US,17,517
OUTLANDER 850,2019-08-26,8,0,IL,US,8,478
OUTLANDER 450,2019-08-26,4,3,IL,US,7,489
OUTLANDER 1000,2019-09-02,11,5,IL,US,16,533
OUTLANDER 850,2019-09-02,3,3,IL,US,6,484
OUTLANDER 450,2019-09-02,4,7,IL,US,11,500
OUTLANDER 1000,2019-09-09,14,2,IL,US,16,549
OUTLANDER 850,2019-09-09,0,14,IL,US,14,498
OUTLANDER 450,2019-09-09,11,14,IL,US,25,525
OUTLANDER 1000,2019-09-16,13,6,IL,US,19,568
OUTLANDER 850,2019-09-16,9,9,IL,US,18,516
OUTLANDER 450,2019-09-16,3,6,IL,US,9,534
OUTLANDER 1000,2019-09-23,1,12,IL,US,13,581
OUTLANDER 850,2019-09-23,7,10,IL,US,17,533
OUTLANDER 450,2019-09-23,12,8,IL,US,20,554
OUTLANDER 1000,2019-09-30,12,14,IL,US,26,607
OUTLANDER 850,2019-09-30,4,3,IL,US,7,540
OUTLANDER 450,2019-09-30,11,8,IL,US,19,573
OUTLANDER 1000,2019-10-07,11,12,IL,US,23,630
OUTLANDER 850,2019-10-07,1,7,IL,US,8,548
OUTLANDER 450,2019-10-07,6,5,IL,US,11,584
OUTLANDER 1000,2019-10-14,1,9,IL,US,10,640
OUTLANDER 850,2019-10-14,8,14,IL,US,22,570
OUTLANDER 450,2019-10-14,15,13,IL,US,28,612
OUTLANDER 1000,2019-10-21,0,6,IL,US,6,646
OUTLANDER 850,2019-10-21,14,1,IL,US,15,585
OUTLANDER 450,2019-10-21,4,9,IL,US,13,625
OUTLANDER 1000,2019-10-28,1,9,IL,US,10,656
OUTLANDER 850,2019-10-28,13,13,IL,US,26,611
OUTLANDER 450,2019-10-28,3,11,IL,US,14,639
OUTLANDER 1000,2019-11-04,3,11,IL,US,14,670
OUTLANDER 850,2019-11-04,14,15,IL,US,29,640
OUTLANDER 450,2019-11-04,7,9,IL,US,16,655
OUTLANDER 1000,2019-11-11,4,2,IL,US,6,676
OUTLANDER 850,2019-11-11,4,14,IL,US,18,658
OUTLANDER 450,2019-11-11,2,3,IL,US,5,660
OUTLANDER 1000,2019-11-18,8,6,IL,US,14,690
OUTLANDER 850,2019-11-18,14,14,IL,US,28,686
OUTLANDER 450,2019-11-18,5,5,IL,US,10,670
OUTLANDER 1000,2019-11-25,6,8,IL,US,14,704
OUTLANDER 850,2019-11-25,6,1,IL,US,7,693
OUTLANDER 450,2019-11-25,9,3,IL,US,12,682
OUTLANDER 1000,2019-12-02,3,9,IL,US,12,716
OUTLANDER 850,2019-12-02,8,3,IL,US,11,704
OUTLANDER 450,2019-12-02,6,7,IL,US,13,695
OUTLANDER 1000,2019-12-09,2,7,IL,US,9,725
OUTLANDER 850,2019-12-09,7,1,IL,US,8,712
OUTLANDER 450,2019-12-09,6,15,IL,US,21,716
OUTLANDER 1000,2019-12-16,1,12,IL,US,13,738
OUTLANDER 850,2019-12-16,13,12,IL,US,25,737
OUTLANDER 450,2019-12-16,7,5,IL,US,12,728
OUTLANDER 1000,2019-12-23,3,11,IL,US,14,752
OUTLANDER 850,2019-12-23,2,2,IL,US,4,741
OUTLANDER 450,2019-12-23,5,15,IL,US,20,748
OUTLANDER 1000,2019-12-30,7,14,IL,US,21,773
OUTLANDER 850,2019-12-30,13,8,IL,US,21,762
OUTLANDER 450,2019-12-30,5,12,IL,US,17,765
OUTLANDER 1000,2020-01-06,12,9,IL,US,21,794
OUTLANDER 850,2020-01-06,2,6,IL,US,8,770
OUTLANDER 450,2020-01-06,7,8,IL,US,15,780
OUTLANDER 1000,2020-01-13,10,3,IL,US,13,807
OUTLANDER 850,2020-01-13,6,12,IL,US,18,788
OUTLANDER 450,2020-01-13,6,9,IL,US,15,795
OUTLANDER 1000,2020-01-20,12,8,IL,US,20,827
OUTLANDER 850,2020-01-20,14,5,IL,US,19,807
OUTLANDER 450,2020-01-20,4,1,IL,US,5,800
OUTLANDER 1000,2020-01-27,2,10,IL,US,12,839
OUTLANDER 850,2020-01-27,5,11,IL,US,16,823
OUTLANDER 450,2020-01-27,2,4,IL,US,6,806
OUTLANDER 1000,2020-02-03,13,4,IL,US,17,856
OUTLANDER 850,2020-02-03,3,8,IL,US,11,834
OUTLANDER 450,2020-02-03,12,13,IL,US,25,831
OUTLANDER 1000,2020-02-10,9,9,IL,US,18,874
OUTLANDER 850,2020-02-10,14,5,IL,US,19,853
OUTLANDER 450,2020-02-10,4,3,IL,US,7,838
OUTLANDER 1000,2020-02-17,12,3,IL,US,15,889
OUTLANDER 850,2020-02-17,14,7,IL,US,21,874
OUTLANDER 450,2020-02-17,15,11,IL,US,26,864
OUTLANDER 1000,2020-02-24,12,13,IL,US,25,914
OUTLANDER 850,2020-02-24,6,12,IL,US,18,892
OUTLANDER 450,2020-02-24,12,1,IL,US,13,877
OUTLANDER 1000,2020-03-02,3,2,IL,US,5,919
OUTLANDER 850,2020-03-02,1,7,IL,US,8,900
OUTLANDER 450,2020-03-02,4,7,IL,US,11,888
OUTLANDER 1000,2020-03-09,3,7,IL,US,10,929
OUTLANDER 850,2020-03-09,14,9,IL,US,23,923
OUTLANDER 450,2020-03-09,2,12,IL,US,14,902
OUTLANDER 1000,2020-03-16,5,6,IL,US,11,940
OUTLANDER 850,2020-03-16,8,7,IL,US,15,938
OUTLANDER 450,2020-03-16,1,5,IL,US,6,908
OUTLANDER 1000,2020-03-23,1,2,IL,US,3,943
OUTLANDER 850,2020-03-23,14,15,IL,US,29,967
OUTLANDER 450,2020-03-23,8,8,IL,US,16,924
OUTLANDER 1000,2020-03-30,11,15,IL,US,26,969
OUTLANDER 850,2020-03-30,13,12,IL,US,25,992
OUTLANDER 450,2020-03-30,14,9,IL,US,23,947
OUTLANDER 1000,2020-04-06,7,5,IL,US,12,981
OUTLANDER 850,2020-04-06,4,7,IL,US,11,1003
OUTLANDER 450,2020-04-06,2,9,IL,US,11,958
OUTLANDER 1000,2020-04-13,12,7,IL,US,19,1000
OUTLANDER 850,2020-04-13,4,8,IL,US,12,1015
OUTLANDER 450,2020-04-13,14,13,IL,US,27,985
OUTLANDER 1000,2020-04-20,10,15,IL,US,25,1025
OUTLANDER 850,2020-04-20,3,8,IL,US,11,1026
OUTLANDER 450,2020-04-20,3,6,IL,US,9,994
OUTLANDER 1000,2020-04-27,2,4,IL,US,6,1031
OUTLANDER 850,2020-04-27,15,11,IL,US,26,1052
OUTLANDER 450,2020-04-27,9,7,IL,US,16,1010
OUTLANDER 1000,2020-05-04,3,11,IL,US,14,1045
OUTLANDER 850,2020-05-04,12,5,IL,US,17,1069
OUTLANDER 450,2020-05-04,11,3,IL,US,14,1024
OUTLANDER 1000,2020-05-11,12,8,IL,US,20,1065
OUTLANDER 850,2020-05-11,11,2,IL,US,13,1082
OUTLANDER 450,2020-05-11,1,14,IL,US,15,1039
OUTLANDER 1000,2020-05-18,12,2,IL,US,14,1079
OUTLANDER 850,2020-05-18,13,10,IL,US,23,1105
OUTLANDER 450,2020-05-18,10,13,IL,US,23,1062
OUTLANDER 1000,2020-05-25,3,10,IL,US,13,1092
OUTLANDER 850,2020-05-25,5,5,IL,US,10,1115
OUTLANDER 450,2020-05-25,0,12,IL,US,12,1074
OUTLANDER 1000,2020-06-01,12,1,IL,US,13,1105
OUTLANDER 850,2020-06-01,5,15,IL,US,20,1135
OUTLANDER 450,2020-06-01,5,3,IL,US,8,1082
OUTLANDER 1000,2020-06-08,2,13,IL,US,15,1120
OUTLANDER 850,2020-06-08,3,9,IL,US,12,1147
OUTLANDER 450,2020-06-08,10,14,IL,US,24,1106
OUTLANDER 1000,2020-06-15,8,4,IL,US,12,1132
OUTLANDER 850,2020-06-15,4,10,IL,US,14,1161
OUTLANDER 450,2020-06-15,1,2,IL,US,3,1109
OUTLANDER 1000,2020-06-22,10,8,IL,US,18,1150
OUTLANDER 850,2020-06-22,3,2,IL,US,5,1166
OUTLANDER 450,2020-06-22,5,4,IL,US,9,1118
OUTLANDER 1000,2020-06-29,5,3,IL,US,8,1158
OUTLANDER 850,2020-06-29,8,3,IL,US,11,1177
OUTLANDER 450,2020-06-29,15,4,IL,US,19,1137
OUTLANDER 1000,2020-07-06,13,1,IL,US,14,1172
OUTLANDER 850,2020-07-06,14,9,IL,US,23,1200
OUTLANDER 450,2020-07-06,5,4,IL,US,9,1146
OUTLANDER 1000,2020-07-13,10,1,IL,US,11,1183
OUTLANDER 850,2020-07-13,1,11,IL,US,12,1212
OUTLANDER 450,2020-07-13,8,3,IL,US,11,1157
OUTLANDER 1000,2020-07-20,4,11,IL,US,15,1198
OUTLANDER 850,2020-07-20,12,12,IL,US,24,1236
OUTLANDER 450,2020-07-20,7,3,IL,US,10,1167
OUTLANDER 1000,2020-07-27,5,13,IL,US,18,1216
OUTLANDER 850,2020-07-27,9,5,IL,US,14,1250
OUTLANDER 450,2020-07-27,6,2,IL,US,8,1175
OUTLANDER 1000,2020-08-03,6,12,IL,US,18,1234
OUTLANDER 850,2020-08-03,5,2,IL,US,7,1257
OUTLANDER 450,2020-08-03,9,5,IL,US,14,1189
OUTLANDER 1000,2020-08-10,14,6,IL,US,20,1254
OUTLANDER 850,2020-08-10,4,1,IL,US,5,1262
OUTLANDER 450,2020-08-10,12,5,IL,US,17,1206
OUTLANDER 1000,2020-08-17,6,10,IL,US,16,1270
OUTLANDER 850,2020-08-17,14,11,IL,US,25,1287
OUTLANDER 450,2020-08-17,11,11,IL,US,22,1228
OUTLANDER 1000,2020-08-24,11,14,IL,US,25,1295
OUTLANDER 850,2020-08-24,6,9,IL,US,15,1302
OUTLANDER 450,2020-08-24,13,5,IL,US,18,1246
OUTLANDER 1000,2020-08-31,10,13,IL,US,23,1318
OUTLANDER 850,2020-08-31,11,5,IL,US,16,1318
OUTLANDER 450,2020-08-31,3,13,IL,US,16,1262
OUTLANDER 1000,2020-09-07,7,14,IL,US,21,1339
OUTLANDER 850,2020-09-07,3,5,IL,US,8,1326
OUTLANDER 450,2020-09-07,1,14,IL,US,15,1277
OUTLANDER 1000,2020-09-14,11,2,IL,US,13,1352
OUTLANDER 850,2020-09-14,14,14,IL,US,28,1354
OUTLANDER 450,2020-09-14,7,9,IL,US,16,1293
OUTLANDER 1000,2020-09-21,10,3,IL,US,13,1365
OUTLANDER 850,2020-09-21,7,15,IL,US,22,1376
OUTLANDER 450,2020-09-21,4,14,IL,US,18,1311
OUTLANDER 1000,2020-09-28,5,5,IL,US,10,1375
OUTLANDER 850,2020-09-28,1,11,IL,US,12,1388
OUTLANDER 450,2020-09-28,12,7,IL,US,19,1330
OUTLANDER 1000,2020-10-05,8,8,IL,US,16,1391
OUTLANDER 850,2020-10-05,1,14,IL,US,15,1403
OUTLANDER 450,2020-10-05,9,8,IL,US,17,1347
OUTLANDER 1000,2020-10-12,14,2,IL,US,16,1407
OUTLANDER 850,2020-10-12,15,8,IL,US,23,1426
OUTLANDER 450,2020-10-12,3,13,IL,US,16,1363
OUTLANDER 1000,2020-10-19,4,13,IL,US,17,1424
OUTLANDER 850,2020-10-19,8,13,IL,US,21,1447
OUTLANDER 450,2020-10-19,12,14,IL,US,26,1389
OUTLANDER 1000,2020-10-26,3,8,IL,US,11,1435
OUTLANDER 850,2020-10-26,10,12,IL,US,22,1469
OUTLANDER 450,2020-10-26,13,12,IL,US,25,1414
OUTLANDER 1000,2020-11-02,8,5,IL,US,13,1448
OUTLANDER 850,2020-11-02,15,4,IL,US,19,1488
OUTLANDER 450,2020-11-02,10,13,IL,US,23,1437
OUTLANDER 1000,2020-11-09,8,4,IL,US,12,1460
OUTLANDER 850,2020-11-09,9,0,IL,US,9,1497
OUTLANDER 450,2020-11-09,6,2,IL,US,8,1445
OUTLANDER 1000,2020-11-16,1,11,IL,US,12,1472
OUTLANDER 850,2020-11-16,2,2,IL,US,4,1501
OUTLANDER 450,2020-11-16,15,10,IL,US,25,1470
OUTLANDER 1000,2020-11-23,7,13,IL,US,20,1492
OUTLANDER 850,2020-11-23,1,6,IL,US,7,1508
OUTLANDER 450,2020-11-23,1,13,IL,US,14,1484
OUTLANDER 1000,2020-11-30,11,5,IL,US,16,1508
OUTLANDER 850,2020-11-30,2,6,IL,US,8,1516
OUTLANDER 450,2020-11-30,4,1,IL,US,5,1489
OUTLANDER 1000,2020-12-07,11,14,IL,US,25,1533
OUTLANDER 850,2020-12-07,13,2,IL,US,15,1531
OUTLANDER 450,2020-12-07,14,5,IL,US,19,1508
OUTLANDER 1000,2020-12-14,2,13,IL,US,15,1548
OUTLANDER 850,2020-12-14,4,13,IL,US,17,1548
OUTLANDER 450,2020-12-14,4,11,IL,US,15,1523
OUTLANDER 1000,2020-12-21,1,6,IL,US,7,1555
OUTLANDER 850,2020-12-21,6,5,IL,US,11,1559
OUTLANDER 450,2020-12-21,7,14,IL,US,21,1544
OUTLANDER 1000,2020-12-28,13,4,IL,US,17,1572
OUTLANDER 850,2020-12-28,3,9,IL,US,12,1571
OUTLANDER 450,2020-12-28,7,2,IL,US,9,1553
OUTLANDER 1000,2021-01-04,2,4,IL,US,6,1578
OUTLANDER 850,2021-01-04,13,8,IL,US,21,1592
OUTLANDER 450,2021-01-04,13,3,IL,US,16,1569
OUTLANDER 1000,2021-01-11,1,2,IL,US,3,1581
OUTLANDER 850,2021-01-11,13,12,IL,US,25,1617
OUTLANDER 450,2021-01-11,14,10,IL,US,24,1593
OUTLANDER 1000,2021-01-18,0,10,IL,US,10,1591
OUTLANDER 850,2021-01-18,2,0,IL,US,2,1619
OUTLANDER 450,2021-01-18,15,3,IL,US,18,1611
OUTLANDER 1000,2021-01-25,9,8,IL,US,17,1608
OUTLANDER 850,2021-01-25,3,11,IL,US,14,1633
OUTLANDER 450,2021-01-25,4,6,IL,US,10,1621
OUTLANDER 1000,2021-02-01,8,3,IL,US,11,1619
OUTLANDER 850,2021-02-01,14,8,IL,US,22,1655
OUTLANDER 450,2021-02-01,8,14,IL,US,22,1643
OUTLANDER 1000,2021-02-08,8,1,IL,US,9,1628
OUTLANDER 850,2021-02-08,5,5,IL,US,10,1665
OUTLANDER 450,2021-02-08,15,7,IL,US,22,1665
OUTLANDER 1000,2021-02-15,9,4,IL,US,13,1641
OUTLANDER 850,2021-02-15,11,13,IL,US,24,1689
OUTLANDER 450,2021-02-15,2,2,IL,US,4,1669
OUTLANDER 1000,2021-02-22,4,9,IL,US,13,1654
OUTLANDER 850,2021-02-22,5,6,IL,US,11,1700
OUTLANDER 450,2021-02-22,2,4,IL,US,6,1675
OUTLANDER 1000,2021-03-01,0,4,IL,US,4,1658
OUTLANDER 850,2021-03-01,4,7,IL,US,11,1711
OUTLANDER 450,2021-03-01,12,7,IL,US,19,1694
OUTLANDER 1000,2021-03-08,11,6,IL,US,17,1675
OUTLANDER 850,2021-03-08,9,6,IL,US,15,1726
OUTLANDER 450,2021-03-08,8,12,IL,US,20,1714
OUTLANDER 1000,2021-03-15,7,5,IL,US,12,1687
OUTLANDER 850,2021-03-15,1,5,IL,US,6,1732
OUTLANDER 450,2021-03-15,3,4,IL,US,7,1721
OUTLANDER 1000,2021-03-22,13,7,IL,US,20,1707
OUTLANDER 850,2021-03-22,12,12,IL,US,24,1756
OUTLANDER 450,2021-03-22,2,1,IL,US,3,1724
OUTLANDER 1000,2021-03-29,0,4,IL,US,4,1711
OUTLANDER 850,2021-03-29,2,3,IL,US,5,1761
OUTLANDER 450,2021-03-29,10,8,IL,US,18,1742
OUTLANDER 1000,2021-04-05,5,9,IL,US,14,1725
OUTLANDER 850,2021-04-05,5,6,IL,US,11,1772
OUTLANDER 450,2021-04-05,8,10,IL,US,18,1760
OUTLANDER 1000,2021-04-12,12,10,IL,US,22,1747
OUTLANDER 850,2021-04-12,8,15,IL,US,23,1795
OUTLANDER 450,2021-04-12,13,2,IL,US,15,1775
OUTLANDER 1000,2021-04-19,14,2,IL,US,16,1763
OUTLANDER 850,2021-04-19,5,3,IL,US,8,1803
OUTLANDER 450,2021-04-19,10,5,IL,US,15,1790
OUTLANDER 1000,2021-04-26,5,5,IL,US,10,1773
OUTLANDER 850,2021-04-26,15,10,IL,US,25,1828
OUTLANDER 450,2021-04-26,13,4,IL,US,17,1807
OUTLANDER 1000,2021-05-03,2,7,IL,US,9,1782
OUTLANDER 850,2021-05-03,4,11,IL,US,15,1843
OUTLANDER 450,2021-05-03,12,6,IL,US,18,1825
OUTLANDER 1000,2021-05-10,9,6,IL,US,15,1797
OUTLANDER 850,2021-05-10,3,5,IL,US,8,1851
OUTLANDER 450,2021-05-10,5,7,IL,US,12,1837
OUTLANDER 1000,2021-05-17,3,4,IL,US,7,1804
OUTLANDER 850,2021-05-17,13,9,IL,US,22,1873
OUTLANDER 450,2021-05-17,14,15,IL,US,29,1866
OUTLANDER 1000,2021-05-24,6,14,IL,US,20,1824
OUTLANDER 850,2021-05-24,14,5,IL,US,19,1892
OUTLANDER 450,2021-05-24,10,3,IL,US,13,1879
OUTLANDER 1000,2021-05-31,2,7,IL,US,9,1833
OUTLANDER 850,2021-05-31,6,8,IL,US,14,1906
OUTLANDER 450,2021-05-31,13,6,IL,US,19,1898
OUTLANDER 1000,2021-06-07,14,0,IL,US,14,1847
OUTLANDER 850,2021-06-07,6,2,IL,US,8,1914
OUTLANDER 450,2021-06-07,1,10,IL,US,11,1909
OUTLANDER 1000,2021-06-14,6,12,IL,US,18,1865
OUTLANDER 850,2021-06-14,1,14,IL,US,15,1929
OUTLANDER 450,2021-06-14,14,7,IL,US,21,1930
OUTLANDER 1000,2021-06-21,11,10,IL,US,21,1886
OUTLANDER 850,2021-06-21,6,13,IL,US,19,1948
OUTLANDER 450,2021-06-21,7,10,IL,US,17,1947
OUTLANDER 1000,2021-06-28,1,6,IL,US,7,1893
OUTLANDER 850,2021-06-28,13,5,IL,US,18,1966
OUTLANDER 450,2021-06-28,1,6,IL,US,7,1954
OUTLANDER 1000,2021-07-05,2,10,IL,US,12,1905
OUTLANDER 850,2021-07-05,7,3,IL,US,10,1976
OUTLANDER 450,2021-07-05,10,1,IL,US,11,1965
OUTLANDER 1000,2021-07-12,13,9,IL,US,22,1927
OUTLANDER 850,2021-07-12,13,3,IL,US,16,1992
OUTLANDER 450,2021-07-12,7,7,IL,US,14,1979
OUTLANDER 1000,2021-07-19,4,9,IL,US,13,1940
OUTLANDER 850,2021-07-19,15,5,IL,US,20,2012
OUTLANDER 450,2021-07-19,12,5,IL,US,17,1996
OUTLANDER 1000,2021-07-26,8,11,IL,US,19,1959
OUTLANDER 850,2021-07-26,11,2,IL,US,13,2025
OUTLANDER 450,2021-07-26,12,13,IL,US,25,2021
OUTLANDER 1000,2021-08-02,2,12,IL,US,14,1973
OUTLANDER 850,2021-08-02,7,12,IL,US,19,2044
OUTLANDER 450,2021-08-02,9,9,IL,US,18,2039
OUTLANDER 1000,2021-08-09,4,10,IL,US,14,1987
OUTLANDER 850,2021-08-09,8,2,IL,US,10,2054
OUTLANDER 450,2021-08-09,2,3,IL,US,5,2044
OUTLANDER 1000,2021-08-16,9,2,IL,US,11,1998
OUTLANDER 850,2021-08-16,6,7,IL,US,13,2067
OUTLANDER 450,2021-08-16,11,4,IL,US,15,2059
OUTLANDER 1000,2021-08-23,2,9,IL,US,11,2009
OUTLANDER 850,2021-08-23,2,6,IL,US,8,2075
OUTLANDER 450,2021-08-23,0,5,IL,US,5,2064
OUTLANDER 1000,2021-08-30,1,14,IL,US,15,2024
OUTLANDER 850,2021-08-30,10,5,IL,US,15,2090
OUTLANDER 450,2021-08-30,8,3,IL,US,11,2075
OUTLANDER 1000,2021-09-06,4,7,IL,US,11,2035
OUTLANDER 850,2021-09-06,13,4,IL,US,17,2107
OUTLANDER 450,2021-09-06,7,5,IL,US,12,2087
OUTLANDER 1000,2021-09-13,6,15,IL,US,21,2056
OUTLANDER 850,2021-09-13,4,8,IL,US,12,2119
OUTLANDER 450,2021-09-13,10,9,IL,US,19,2106
OUTLANDER 1000,2021-09-20,1,3,IL,US,4,2060
OUTLANDER 850,2021-09-20,10,0,IL,US,10,2129
OUTLANDER 450,2021-09-20,11,8,IL,US,19,2125
OUTLANDER 1000,2021-09-27,9,12,IL,US,21,2081
OUTLANDER 850,2021-09-27,2,13,IL,US,15,2144
OUTLANDER 450,2021-09-27,10,12,IL,US,22,2147
OUTLANDER 1000,2021-10-04,3,6,IL,US,9,2090
OUTLANDER 850,2021-10-04,15,14,IL,US,29,2173
OUTLANDER 450,2021-10-04,1,5,IL,US,6,2153
OUTLANDER 1000,2021-10-11,3,13,IL,US,16,2106
OUTLANDER 850,2021-10-11,10,15,IL,US,25,2198
OUTLANDER 450,2021-10-11,9,15,IL,US,24,2177
OUTLANDER 1000,2021-10-18,10,8,IL,US,18,2124
OUTLANDER 850,2021-10-18,6,9,IL,US,15,2213
OUTLANDER 450,2021-10-18,9,7,IL,US,16,2193
OUTLANDER 1000,2021-10-25,2,4,IL,US,6,2130
OUTLANDER 850,2021-10-25,7,0,IL,US,7,2220
OUTLANDER 450,2021-10-25,1,11,IL,US,12,2205
OUTLANDER 1000,2021-11-01,10,14,IL,US,24,2154
OUTLANDER 850,2021-11-01,13,8,IL,US,21,2241
OUTLANDER 450,2021-11-01,14,1,IL,US,15,2220
OUTLANDER 1000,2021-11-08,0,13,IL,US,13,2167
OUTLANDER 850,2021-11-08,10,8,IL,US,18,2259
OUTLANDER 450,2021-11-08,4,0,IL,US,4,2224
OUTLANDER 1000,2021-11-15,8,9,IL,US,17,2184
OUTLANDER 850,2021-11-15,7,15,IL,US,22,2281
OUTLANDER 450,2021-11-15,13,12,IL,US,25,2249
OUTLANDER 1000,2021-11-22,13,10,IL,US,23,2207
OUTLANDER 850,2021-11-22,3,4,IL,US,7,2288
OUTLANDER 450,2021-11-22,12,2,IL,US,14,2263
OUTLANDER 1000,2021-11-29,13,5,IL,US,18,2225
OUTLANDER 850,2021-11-29,7,11,IL,US,18,2306
OUTLANDER 450,2021-11-29,14,12,IL,US,26,2289
OUTLANDER 1000,2021-12-06,10,2,IL,US,12,2237
OUTLANDER 850,2021-12-06,10,5,IL,US,15,2321
OUTLANDER 450,2021-12-06,12,6,IL,US,18,2307
OUTLANDER 1000,2021-12-13,6,3,IL,US,9,2246
OUTLANDER 850,2021-12-13,13,14,IL,US,27,2348
OUTLANDER 450,2021-12-13,0,15,IL,US,15,2322
OUTLANDER 1000,2021-12-20,8,8,IL,US,16,2262
OUTLANDER 850,2021-12-20,1,10,IL,US,11,2359
OUTLANDER 450,2021-12-20,10,11,IL,US,21,2343
OUTLANDER 1000,2021-12-27,11,3,IL,US,14,2276
OUTLANDER 850,2021-12-27,13,8,IL,US,21,2380
OUTLANDER 450,2021-12-27,0,12,IL,US,12,2355
OUTLANDER 1000,2019-01-07,9,3,IN,US,12,12
OUTLANDER 850,2019-01-07,2,12,IN,US,14,14
OUTLANDER 450,2019-01-07,6,13,IN,US,19,19
OUTLANDER 1000,2019-01-14,5,11,IN,US,16,28
OUTLANDER 850,2019-01-14,6,15,IN,US,21,35
OUTLANDER 450,2019-01-14,14,13,IN,US,27,46
OUTLANDER 1000,2019-01-21,5,11,IN,US,16,44
OUTLANDER 850,2019-01-21,12,5,IN,US,17,52
OUTLANDER 450,2019-01-21,11,10,IN,US,21,67
OUTLANDER 1000,2019-01-28,6,4,IN,US,10,54
OUTLANDER 850,2019-01-28,10,2,IN,US,12,64
OUTLANDER 450,2019-01-28,13,8,IN,US,21,88
OUTLANDER 1000,2019-02-04,14,1,IN,US,15,69
OUTLANDER 850,2019-02-04,7,14,IN,US,21,85
OUTLANDER 450,2019-02-04,5,8,IN,US,13,101
OUTLANDER 1000,2019-02-11,10,13,IN,US,23,92
OUTLANDER 850,2019-02-11,7,1,IN,US,8,93
OUTLANDER 450,2019-02-11,7,13,IN,US,20,121
OUTLANDER 1000,2019-02-18,5,11,IN,US,16,108
OUTLANDER 850,2019-02-18,6,9,IN,US,15,108
OUTLANDER 450,2019-02-18,3,4,IN,US,7,128
OUTLANDER 1000,2019-02-25,10,10,IN,US,20,128
OUTLANDER 850,2019-02-25,10,6,IN,US,16,124
OUTLANDER 450,2019-02-25,9,5,IN,US,14,142
OUTLANDER 1000,2019-03-04,12,3,IN,US,15,143
OUTLANDER 850,2019-03-04,14,11,IN,US,25,149
OUTLANDER 450,2019-03-04,6,10,IN,US,16,158
OUTLANDER 1000,2019-03-11,1,8,IN,US,9,152
OUTLANDER 850,2019-03-11,14,11,IN,US,25,174
OUTLANDER 450,2019-03-11,4,8,IN,US,12,170
OUTLANDER 1000,2019-03-18,3,14,IN,US,17,169
OUTLANDER 850,2019-03-18,4,10,IN,US,14,188
OUTLANDER 450,2019-03-18,6,15,IN,US,21,191
OUTLANDER 1000,2019-03-25,4,11,IN,US,15,184
OUTLANDER 850,2019-03-25,9,4,IN,US,13,201
OUTLANDER 450,2019-03-25,5,7,IN,US,12,203
OUTLANDER 1000,2019-04-01,5,0,IN,US,5,189
OUTLANDER 850,2019-04-01,7,6,IN,US,13,214
OUTLANDER 450,2019-04-01,6,15,IN,US,21,224
OUTLANDER 1000,2019-04-08,14,11,IN,US,25,214
OUTLANDER 850,2019-04-08,8,15,IN,US,23,237
OUTLANDER 450,2019-04-08,6,5,IN,US,11,235
OUTLANDER 1000,2019-04-15,6,14,IN,US,20,234
OUTLANDER 850,2019-04-15,8,12,IN,US,20,257
OUTLANDER 450,2019-04-15,6,3,IN,US,9,244
OUTLANDER 1000,2019-04-22,14,5,IN,US,19,253
OUTLANDER 850,2019-04-22,2,11,IN,US,13,270
OUTLANDER 450,2019-04-22,12,6,IN,US,18,262
OUTLANDER 1000,2019-04-29,9,7,IN,US,16,269
OUTLANDER 850,2019-04-29,5,1,IN,US,6,276
OUTLANDER 450,2019-04-29,9,3,IN,US,12,274
OUTLANDER 1000,2019-05-06,8,5,IN,US,13,282
OUTLANDER 850,2019-05-06,15,8,IN,US,23,299
OUTLANDER 450,2019-05-06,7,8,IN,US,15,289
OUTLANDER 1000,2019-05-13,3,4,IN,US,7,289
OUTLANDER 850,2019-05-13,12,13,IN,US,25,324
OUTLANDER 450,2019-05-13,6,2,IN,US,8,297
OUTLANDER 1000,2019-05-20,11,14,IN,US,25,314
OUTLANDER 850,2019-05-20,14,4,IN,US,18,342
OUTLANDER 450,2019-05-20,1,13,IN,US,14,311
OUTLANDER 1000,2019-05-27,0,1,IN,US,1,315
OUTLANDER 850,2019-05-27,12,12,IN,US,24,366
OUTLANDER 450,2019-05-27,1,8,IN,US,9,320
OUTLANDER 1000,2019-06-03,9,10,IN,US,19,334
OUTLANDER 850,2019-06-03,5,11,IN,US,16,382
OUTLANDER 450,2019-06-03,3,13,IN,US,16,336
OUTLANDER 1000,2019-06-10,7,4,IN,US,11,345
OUTLANDER 850,2019-06-10,3,14,IN,US,17,399
OUTLANDER 450,2019-06-10,7,15,IN,US,22,358
OUTLANDER 1000,2019-06-17,10,5,IN,US,15,360
OUTLANDER 850,2019-06-17,11,6,IN,US,17,416
OUTLANDER 450,2019-06-17,5,7,IN,US,12,370
OUTLANDER 1000,2019-06-24,7,15,IN,US,22,382
OUTLANDER 850,2019-06-24,4,8,IN,US,12,428
OUTLANDER 450,2019-06-24,5,9,IN,US,14,384
OUTLANDER 1000,2019-07-01,9,0,IN,US,9,391
OUTLANDER 850,2019-07-01,4,9,IN,US,13,441
OUTLANDER 450,2019-07-01,1,3,IN,US,4,388
OUTLANDER 1000,2019-07-08,10,4,IN,US,14,405
OUTLANDER 850,2019-07-08,3,10,IN,US,13,454
OUTLANDER 450,2019-07-08,2,6,IN,US,8,396
OUTLANDER 1000,2019-07-15,9,6,IN,US,15,420
OUTLANDER 850,2019-07-15,15,2,IN,US,17,471
OUTLANDER 450,2019-07-15,13,14,IN,US,27,423
OUTLANDER 1000,2019-07-22,1,2,IN,US,3,423
OUTLANDER 850,2019-07-22,13,6,IN,US,19,490
OUTLANDER 450,2019-07-22,13,1,IN,US,14,437
OUTLANDER 1000,2019-07-29,2,4,IN,US,6,429
OUTLANDER 850,2019-07-29,10,10,IN,US,20,510
OUTLANDER 450,2019-07-29,12,14,IN,US,26,463
OUTLANDER 1000,2019-08-05,0,12,IN,US,12,441
OUTLANDER 850,2019-08-05,12,14,IN,US,26,536
OUTLANDER 450,2019-08-05,8,7,IN,US,15,478
OUTLANDER 1000,2019-08-12,4,8,IN,US,12,453
OUTLANDER 850,2019-08-12,11,15,IN,US,26,562
OUTLANDER 450,2019-08-12,11,3,IN,US,14,492
OUTLANDER 1000,2019-08-19,7,13,IN,US,20,473
OUTLANDER 850,2019-08-19,3,4,IN,US,7,569
OUTLANDER 450,2019-08-19,4,9,IN,US,13,505
OUTLANDER 1000,2019-08-26,8,6,IN,US,14,487
OUTLANDER 850,2019-08-26,1,5,IN,US,6,575
OUTLANDER 450,2019-08-26,6,1,IN,US,7,512
OUTLANDER 1000,2019-09-02,12,7,IN,US,19,506
OUTLANDER 850,2019-09-02,9,15,IN,US,24,599
OUTLANDER 450,2019-09-02,7,7,IN,US,14,526
OUTLANDER 1000,2019-09-09,3,2,IN,US,5,511
OUTLANDER 850,2019-09-09,11,5,IN,US,16,615
OUTLANDER 450,2019-09-09,11,9,IN,US,20,546
OUTLANDER 1000,2019-09-16,7,7,IN,US,14,525
OUTLANDER 850,2019-09-16,13,9,IN,US,22,637
OUTLANDER 450,2019-09-16,0,6,IN,US,6,552
OUTLANDER 1000,2019-09-23,6,1,IN,US,7,532
OUTLANDER 850,2019-09-23,2,6,IN,US,8,645
OUTLANDER 450,2019-09-23,2,5,IN,US,7,559
OUTLANDER 1000,2019-09-30,2,11,IN,US,13,545
OUTLANDER 850,2019-09-30,8,7,IN,US,15,660
OUTLANDER 450,2019-09-30,5,7,IN,US,12,571
OUTLANDER 1000,2019-10-07,10,1,IN,US,11,556
OUTLANDER 850,2019-10-07,11,4,IN,US,15,675
OUTLANDER 450,2019-10-07,10,12,IN,US,22,593
OUTLANDER 1000,2019-10-14,12,3,IN,US,15,571
OUTLANDER 850,2019-10-14,14,12,IN,US,26,701
OUTLANDER 450,2019-10-14,5,12,IN,US,17,610
OUTLANDER 1000,2019-10-21,3,7,IN,US,10,581
OUTLANDER 850,2019-10-21,11,4,IN,US,15,716
OUTLANDER 450,2019-10-21,14,9,IN,US,23,633
OUTLANDER 1000,2019-10-28,13,7,IN,US,20,601
OUTLANDER 850,2019-10-28,10,7,IN,US,17,733
OUTLANDER 450,2019-10-28,12,1,IN,US,13,646
OUTLANDER 1000,2019-11-04,14,5,IN,US,19,620
OUTLANDER 850,2019-11-04,14,7,IN,US,21,754
OUTLANDER 450,2019-11-04,14,13,IN,US,27,673
OUTLANDER 1000,2019-11-11,14,2,IN,US,16,636
OUTLANDER 850,2019-11-11,6,1,IN,US,7,761
OUTLANDER 450,2019-11-11,9,12,IN,US,21,694
OUTLANDER 1000,2019-11-18,4,8,IN,US,12,648
OUTLANDER 850,2019-11-18,10,9,IN,US,19,780
OUTLANDER 450,2019-11-18,0,4,IN,US,4,698
OUTLANDER 1000,2019-11-25,12,2,IN,US,14,662
OUTLANDER 850,2019-11-25,10,14,IN,US,24,804
OUTLANDER 450,2019-11-25,6,13,IN,US,19,717
OUTLANDER 1000,2019-12-02,11,14,IN,US,25,687
OUTLANDER 850,2019-12-02,7,14,IN,US,21,825
OUTLANDER 450,2019-12-02,6,6,IN,US,12,729
OUTLANDER 1000,2019-12-09,3,7,IN,US,10,697
OUTLANDER 850,2019-12-09,7,9,IN,US,16,841
OUTLANDER 450,2019-12-09,12,12,IN,US,24,753
OUTLANDER 1000,2019-12-16,13,12,IN,US,25,722
OUTLANDER 850,2019-12-16,8,2,IN,US,10,851
OUTLANDER 450,2019-12-16,4,5,IN,US,9,762
OUTLANDER 1000,2019-12-23,7,1,IN,US,8,730
OUTLANDER 850,2019-12-23,12,2,IN,US,14,865
OUTLANDER 450,2019-12-23,8,12,IN,US,20,782
OUTLANDER 1000,2019-12-30,4,7,IN,US,11,741
OUTLANDER 850,2019-12-30,6,0,IN,US,6,871
OUTLANDER 450,2019-12-30,0,3,IN,US,3,785
OUTLANDER 1000,2020-01-06,7,1,IN,US,8,749
OUTLANDER 850,2020-01-06,3,8,IN,US,11,882
OUTLANDER 450,2020-01-06,9,10,IN,US,19,804
OUTLANDER 1000,2020-01-13,14,11,IN,US,25,774
OUTLANDER 850,2020-01-13,10,14,IN,US,24,906
OUTLANDER 450,2020-01-13,9,10,IN,US,19,823
OUTLANDER 1000,2020-01-20,1,11,IN,US,12,786
OUTLANDER 850,2020-01-20,0,6,IN,US,6,912
OUTLANDER 450,2020-01-20,9,10,IN,US,19,842
OUTLANDER 1000,2020-01-27,2,2,IN,US,4,790
OUTLANDER 850,2020-01-27,9,14,IN,US,23,935
OUTLANDER 450,2020-01-27,0,6,IN,US,6,848
OUTLANDER 1000,2020-02-03,9,12,IN,US,21,811
OUTLANDER 850,2020-02-03,10,1,IN,US,11,946
OUTLANDER 450,2020-02-03,4,4,IN,US,8,856
OUTLANDER 1000,2020-02-10,14,3,IN,US,17,828
OUTLANDER 850,2020-02-10,1,6,IN,US,7,953
OUTLANDER 450,2020-02-10,12,3,IN,US,15,871
OUTLANDER 1000,2020-02-17,15,13,IN,US,28,856
OUTLANDER 850,2020-02-17,7,15,IN,US,22,975
OUTLANDER 450,2020-02-17,3,6,IN,US,9,880
OUTLANDER 1000,2020-02-24,3,10,IN,US,13,869
OUTLANDER 850,2020-02-24,10,14,IN,US,24,999
OUTLANDER 450,2020-02-24,13,0,IN,US,13,893
OUTLANDER 1000,2020-03-02,11,0,IN,US,11,880
OUTLANDER 850,2020-03-02,12,12,IN,US,24,1023
OUTLANDER 450,2020-03-02,4,4,IN,US,8,901
OUTLANDER 1000,2020-03-09,0,12,IN,US,12,892
OUTLANDER 850,2020-03-09,11,11,IN,US,22,1045
OUTLANDER 450,2020-03-09,0,13,IN,US,13,914
OUTLANDER 1000,2020-03-16,10,5,IN,US,15,907
OUTLANDER 850,2020-03-16,13,10,IN,US,23,1068
OUTLANDER 450,2020-03-16,11,2,IN,US,13,927
OUTLANDER 1000,2020-03-23,11,6,IN,US,17,924
OUTLANDER 850,2020-03-23,14,6,IN,US,20,1088
OUTLANDER 450,2020-03-23,15,6,IN,US,21,948
OUTLANDER 1000,2020-03-30,4,4,IN,US,8,932
OUTLANDER 850,2020-03-30,4,13,IN,US,17,1105
OUTLANDER 450,2020-03-30,1,8,IN,US,9,957
OUTLANDER 1000,2020-04-06,3,5,IN,US,8,940
OUTLANDER 850,2020-04-06,14,3,IN,US,17,1122
OUTLANDER 450,2020-04-06,4,9,IN,US,13,970
OUTLANDER 1000,2020-04-13,14,7,IN,US,21,961
OUTLANDER 850,2020-04-13,10,10,IN,US,20,1142
OUTLANDER 450,2020-04-13,4,4,IN,US,8,978
OUTLANDER 1000,2020-04-20,6,4,IN,US,10,971
OUTLANDER 850,2020-04-20,13,4,IN,US,17,1159
OUTLANDER 450,2020-04-20,6,12,IN,US,18,996
OUTLANDER 1000,2020-04-27,3,4,IN,US,7,978
OUTLANDER 850,2020-04-27,7,4,IN,US,11,1170
OUTLANDER 450,2020-04-27,2,6,IN,US,8,1004
OUTLANDER 1000,2020-05-04,9,9,IN,US,18,996
OUTLANDER 850,2020-05-04,7,6,IN,US,13,1183
OUTLANDER 450,2020-05-04,11,3,IN,US,14,1018
OUTLANDER 1000,2020-05-11,3,13,IN,US,16,1012
OUTLANDER 850,2020-05-11,2,3,IN,US,5,1188
OUTLANDER 450,2020-05-11,3,2,IN,US,5,1023
OUTLANDER 1000,2020-05-18,13,1,IN,US,14,1026
OUTLANDER 850,2020-05-18,6,6,IN,US,12,1200
OUTLANDER 450,2020-05-18,3,11,IN,US,14,1037
OUTLANDER 1000,2020-05-25,4,5,IN,US,9,1035
OUTLANDER 850,2020-05-25,12,2,IN,US,14,1214
OUTLANDER 450,2020-05-25,7,10,IN,US,17,1054
OUTLANDER 1000,2020-06-01,10,6,IN,US,16,1051
OUTLANDER 850,2020-06-01,6,7,IN,US,13,1227
OUTLANDER 450,2020-06-01,8,13,IN,US,21,1075
OUTLANDER 1000,2020-06-08,3,2,IN,US,5,1056
OUTLANDER 850,2020-06-08,2,10,IN,US,12,1239
OUTLANDER 450,2020-06-08,8,3,IN,US,11,1086
OUTLANDER 1000,2020-06-15,11,1,IN,US,12,1068
OUTLANDER 850,2020-06-15,9,4,IN,US,13,1252
OUTLANDER 450,2020-06-15,11,0,IN,US,11,1097
OUTLANDER 1000,2020-06-22,2,1,IN,US,3,1071
OUTLANDER 850,2020-06-22,3,14,IN,US,17,1269
OUTLANDER 450,2020-06-22,12,9,IN,US,21,1118
OUTLANDER 1000,2020-06-29,6,8,IN,US,14,1085
OUTLANDER 850,2020-06-29,8,12,IN,US,20,1289
OUTLANDER 450,2020-06-29,10,9,IN,US,19,1137
OUTLANDER 1000,2020-07-06,14,15,IN,US,29,1114
OUTLANDER 850,2020-07-06,11,1,IN,US,12,1301
OUTLANDER 450,2020-07-06,12,9,IN,US,21,1158
OUTLANDER 1000,2020-07-13,7,5,IN,US,12,1126
OUTLANDER 850,2020-07-13,15,7,IN,US,22,1323
OUTLANDER 450,2020-07-13,3,0,IN,US,3,1161
OUTLANDER 1000,2020-07-20,6,5,IN,US,11,1137
OUTLANDER 850,2020-07-20,10,1,IN,US,11,1334
OUTLANDER 450,2020-07-20,10,14,IN,US,24,1185
OUTLANDER 1000,2020-07-27,4,7,IN,US,11,1148
OUTLANDER 850,2020-07-27,15,13,IN,US,28,1362
OUTLANDER 450,2020-07-27,5,13,IN,US,18,1203
OUTLANDER 1000,2020-08-03,5,10,IN,US,15,1163
OUTLANDER 850,2020-08-03,10,6,IN,US,16,1378
OUTLANDER 450,2020-08-03,4,12,IN,US,16,1219
OUTLANDER 1000,2020-08-10,1,9,IN,US,10,1173
OUTLANDER 850,2020-08-10,14,2,IN,US,16,1394
OUTLANDER 450,2020-08-10,10,11,IN,US,21,1240
OUTLANDER 1000,2020-08-17,11,10,IN,US,21,1194
OUTLANDER 850,2020-08-17,14,5,IN,US,19,1413
OUTLANDER 450,2020-08-17,11,13,IN,US,24,1264
OUTLANDER 1000,2020-08-24,9,3,IN,US,12,1206
OUTLANDER 850,2020-08-24,3,8,IN,US,11,1424
OUTLANDER 450,2020-08-24,1,9,IN,US,10,1274
OUTLANDER 1000,2020-08-31,14,4,IN,US,18,1224
OUTLANDER 850,2020-08-31,14,4,IN,US,18,1442
OUTLANDER 450,2020-08-31,8,12,IN,US,20,1294
OUTLANDER 1000,2020-09-07,7,9,IN,US,16,1240
OUTLANDER 850,2020-09-07,9,1,IN,US,10,1452
OUTLANDER 450,2020-09-07,1,3,IN,US,4,1298
OUTLANDER 1000,2020-09-14,12,2,IN,US,14,1254
OUTLANDER 850,2020-09-14,2,15,IN,US,17,1469
OUTLANDER 450,2020-09-14,11,12,IN,US,23,1321
OUTLANDER 1000,2020-09-21,2,4,IN,US,6,1260
OUTLANDER 850,2020-09-21,8,13,IN,US,21,1490
OUTLANDER 450,2020-09-21,8,7,IN,US,15,1336
OUTLANDER 1000,2020-09-28,8,7,IN,US,15,1275
OUTLANDER 850,2020-09-28,1,6,IN,US,7,1497
OUTLANDER 450,2020-09-28,3,8,IN,US,11,1347
OUTLANDER 1000,2020-10-05,14,11,IN,US,25,1300
OUTLANDER 850,2020-10-05,8,11,IN,US,19,1516
OUTLANDER 450,2020-10-05,4,3,IN,US,7,1354
OUTLANDER 1000,2020-10-12,12,10,IN,US,22,1322
OUTLANDER 850,2020-10-12,12,11,IN,US,23,1539
OUTLANDER 450,2020-10-12,6,8,IN,US,14,1368
OUTLANDER 1000,2020-10-19,14,6,IN,US,20,1342
OUTLANDER 850,2020-10-19,4,6,IN,US,10,1549
OUTLANDER 450,2020-10-19,12,15,IN,US,27,1395
OUTLANDER 1000,2020-10-26,1,13,IN,US,14,1356
OUTLANDER 850,2020-10-26,5,13,IN,US,18,1567
OUTLANDER 450,2020-10-26,13,1,IN,US,14,1409
OUTLANDER 1000,2020-11-02,2,2,IN,US,4,1360
OUTLANDER 850,2020-11-02,8,2,IN,US,10,1577
OUTLANDER 450,2020-11-02,5,4,IN,US,9,1418
OUTLANDER 1000,2020-11-09,13,8,IN,US,21,1381
OUTLANDER 850,2020-11-09,9,4,IN,US,13,1590
OUTLANDER 450,2020-11-09,12,8,IN,US,20,1438
OUTLANDER 1000,2020-11-16,9,5,IN,US,14,1395
OUTLANDER 850,2020-11-16,6,5,IN,US,11,1601
OUTLANDER 450,2020-11-16,4,9,IN,US,13,1451
OUTLANDER 1000,2020-11-23,14,8,IN,US,22,1417
OUTLANDER 850,2020-11-23,12,7,IN,US,19,1620
OUTLANDER 450,2020-11-23,13,3,IN,US,16,1467
OUTLANDER 1000,2020-11-30,3,4,IN,US,7,1424
OUTLANDER 850,2020-11-30,13,7,IN,US,20,1640
OUTLANDER 450,2020-11-30,0,11,IN,US,11,1478
OUTLANDER 1000,2020-12-07,9,13,IN,US,22,1446
OUTLANDER 850,2020-12-07,13,10,IN,US,23,1663
OUTLANDER 450,2020-12-07,4,13,IN,US,17,1495
OUTLANDER 1000,2020-12-14,4,14,IN,US,18,1464
OUTLANDER 850,2020-12-14,5,8,IN,US,13,1676
OUTLANDER 450,2020-12-14,4,5,IN,US,9,1504
OUTLANDER 1000,2020-12-21,0,6,IN,US,6,1470
OUTLANDER 850,2020-12-21,10,1,IN,US,11,1687
OUTLANDER 450,2020-12-21,11,10,IN,US,21,1525
OUTLANDER 1000,2020-12-28,14,1,IN,US,15,1485
OUTLANDER 850,2020-12-28,12,9,IN,US,21,1708
OUTLANDER 450,2020-12-28,0,5,IN,US,5,1530
OUTLANDER 1000,2021-01-04,10,5,IN,US,15,1500
OUTLANDER 850,2021-01-04,5,13,IN,US,18,1726
OUTLANDER 450,2021-01-04,2,6,IN,US,8,1538
OUTLANDER 1000,2021-01-11,14,5,IN,US,19,1519
OUTLANDER 850,2021-01-11,13,14,IN,US,27,1753
OUTLANDER 450,2021-01-11,9,6,IN,US,15,1553
OUTLANDER 1000,2021-01-18,11,12,IN,US,23,1542
OUTLANDER 850,2021-01-18,10,11,IN,US,21,1774
OUTLANDER 450,2021-01-18,1,2,IN,US,3,1556
OUTLANDER 1000,2021-01-25,12,8,IN,US,20,1562
OUTLANDER 850,2021-01-25,7,7,IN,US,14,1788
OUTLANDER 450,2021-01-25,3,3,IN,US,6,1562
OUTLANDER 1000,2021-02-01,4,9,IN,US,13,1575
OUTLANDER 850,2021-02-01,11,6,IN,US,17,1805
OUTLANDER 450,2021-02-01,3,4,IN,US,7,1569
OUTLANDER 1000,2021-02-08,2,9,IN,US,11,1586
OUTLANDER 850,2021-02-08,2,2,IN,US,4,1809
OUTLANDER 450,2021-02-08,10,12,IN,US,22,1591
OUTLANDER 1000,2021-02-15,10,7,IN,US,17,1603
OUTLANDER 850,2021-02-15,13,1,IN,US,14,1823
OUTLANDER 450,2021-02-15,9,5,IN,US,14,1605
OUTLANDER 1000,2021-02-22,4,6,IN,US,10,1613
OUTLANDER 850,2021-02-22,11,15,IN,US,26,1849
OUTLANDER 450,2021-02-22,7,6,IN,US,13,1618
OUTLANDER 1000,2021-03-01,7,15,IN,US,22,1635
OUTLANDER 850,2021-03-01,13,8,IN,US,21,1870
OUTLANDER 450,2021-03-01,10,4,IN,US,14,1632
OUTLANDER 1000,2021-03-08,13,2,IN,US,15,1650
OUTLANDER 850,2021-03-08,10,9,IN,US,19,1889
OUTLANDER 450,2021-03-08,9,13,IN,US,22,1654
OUTLANDER 1000,2021-03-15,1,12,IN,US,13,1663
OUTLANDER 850,2021-03-15,4,13,IN,US,17,1906
OUTLANDER 450,2021-03-15,2,10,IN,US,12,1666
OUTLANDER 1000,2021-03-22,9,3,IN,US,12,1675
OUTLANDER 850,2021-03-22,9,11,IN,US,20,1926
OUTLANDER 450,2021-03-22,3,4,IN,US,7,1673
OUTLANDER 1000,2021-03-29,1,9,IN,US,10,1685
OUTLANDER 850,2021-03-29,6,1,IN,US,7,1933
OUTLANDER 450,2021-03-29,7,0,IN,US,7,1680
OUTLANDER 1000,2021-04-05,5,14,IN,US,19,1704
OUTLANDER 850,2021-04-05,12,9,IN,US,21,1954
OUTLANDER 450,2021-04-05,14,6,IN,US,20,1700
OUTLANDER 1000,2021-04-12,11,10,IN,US,21,1725
OUTLANDER 850,2021-04-12,4,13,IN,US,17,1971
OUTLANDER 450,2021-04-12,1,14,IN,US,15,1715
OUTLANDER 1000,2021-04-19,12,2,IN,US,14,1739
OUTLANDER 850,2021-04-19,7,4,IN,US,11,1982
OUTLANDER 450,2021-04-19,11,10,IN,US,21,1736
OUTLANDER 1000,2021-04-26,9,12,IN,US,21,1760
OUTLANDER 850,2021-04-26,1,13,IN,US,14,1996
OUTLANDER 450,2021-04-26,2,1,IN,US,3,1739
OUTLANDER 1000,2021-05-03,14,1,IN,US,15,1775
OUTLANDER 850,2021-05-03,2,4,IN,US,6,2002
OUTLANDER 450,2021-05-03,2,10,IN,US,12,1751
OUTLANDER 1000,2021-05-10,3,2,IN,US,5,1780
OUTLANDER 850,2021-05-10,9,6,IN,US,15,2017
OUTLANDER 450,2021-05-10,7,9,IN,US,16,1767
OUTLANDER 1000,2021-05-17,4,5,IN,US,9,1789
OUTLANDER 850,2021-05-17,12,9,IN,US,21,2038
OUTLANDER 450,2021-05-17,8,7,IN,US,15,1782
OUTLANDER 1000,2021-05-24,1,8,IN,US,9,1798
OUTLANDER 850,2021-05-24,13,14,IN,US,27,2065
OUTLANDER 450,2021-05-24,11,6,IN,US,17,1799
OUTLANDER 1000,2021-05-31,6,6,IN,US,12,1810
OUTLANDER 850,2021-05-31,2,14,IN,US,16,2081
OUTLANDER 450,2021-05-31,2,3,IN,US,5,1804
OUTLANDER 1000,2021-06-07,6,3,IN,US,9,1819
OUTLANDER 850,2021-06-07,12,7,IN,US,19,2100
OUTLANDER 450,2021-06-07,8,13,IN,US,21,1825
OUTLANDER 1000,2021-06-14,10,9,IN,US,19,1838
OUTLANDER 850,2021-06-14,0,7,IN,US,7,2107
OUTLANDER 450,2021-06-14,8,1,IN,US,9,1834
OUTLANDER 1000,2021-06-21,14,9,IN,US,23,1861
OUTLANDER 850,2021-06-21,14,7,IN,US,21,2128
OUTLANDER 450,2021-06-21,13,3,IN,US,16,1850
OUTLANDER 1000,2021-06-28,7,2,IN,US,9,1870
OUTLANDER 850,2021-06-28,4,5,IN,US,9,2137
OUTLANDER 450,2021-06-28,3,7,IN,US,10,1860
OUTLANDER 1000,2021-07-05,12,1,IN,US,13,1883
OUTLANDER 850,2021-07-05,9,10,IN,US,19,2156
OUTLANDER 450,2021-07-05,0,3,IN,US,3,1863
OUTLANDER 1000,2021-07-12,9,4,IN,US,13,1896
OUTLANDER 850,2021-07-12,1,13,IN,US,14,2170
OUTLANDER 450,2021-07-12,6,0,IN,US,6,1869
OUTLANDER 1000,2021-07-19,14,4,IN,US,18,1914
OUTLANDER 850,2021-07-19,12,12,IN,US,24,2194
OUTLANDER 450,2021-07-19,3,15,IN,US,18,1887
OUTLANDER 1000,2021-07-26,1,13,IN,US,14,1928
OUTLANDER 850,2021-07-26,4,13,IN,US,17,2211
OUTLANDER 450,2021-07-26,3,4,IN,US,7,1894
OUTLANDER 1000,2021-08-02,5,0,IN,US,5,1933
OUTLANDER 850,2021-08-02,2,4,IN,US,6,2217
OUTLANDER 450,2021-08-02,11,6,IN,US,17,1911
OUTLANDER 1000,2021-08-09,14,2,IN,US,16,1949
OUTLANDER 850,2021-08-09,1,14,IN,US,15,2232
OUTLANDER 450,2021-08-09,1,8,IN,US,9,1920
OUTLANDER 1000,2021-08-16,12,9,IN,US,21,1970
OUTLANDER 850,2021-08-16,4,11,IN,US,15,2247
OUTLANDER 450,2021-08-16,11,14,IN,US,25,1945
OUTLANDER 1000,2021-08-23,6,12,IN,US,18,1988
OUTLANDER 850,2021-08-23,12,14,IN,US,26,2273
OUTLANDER 450,2021-08-23,6,4,IN,US,10,1955
OUTLANDER 1000,2021-08-30,7,10,IN,US,17,2005
OUTLANDER 850,2021-08-30,11,1,IN,US,12,2285
OUTLANDER 450,2021-08-30,11,12,IN,US,23,1978
OUTLANDER 1000,2021-09-06,9,11,IN,US,20,2025
OUTLANDER 850,2021-09-06,7,4,IN,US,11,2296
OUTLANDER 450,2021-09-06,8,3,IN,US,11,1989
OUTLANDER 1000,2021-09-13,8,1,IN,US,9,2034
OUTLANDER 850,2021-09-13,9,1,IN,US,10,2306
OUTLANDER 450,2021-09-13,2,2,IN,US,4,1993
OUTLANDER 1000,2021-09-20,12,3,IN,US,15,2049
OUTLANDER 850,2021-09-20,11,2,IN,US,13,2319
OUTLANDER 450,2021-09-20,8,6,IN,US,14,2007
OUTLANDER 1000,2021-09-27,8,6,IN,US,14,2063
OUTLANDER 850,2021-09-27,0,9,IN,US,9,2328
OUTLANDER 450,2021-09-27,11,8,IN,US,19,2026
OUTLANDER 1000,2021-10-04,8,9,IN,US,17,2080
OUTLANDER 850,2021-10-04,10,8,IN,US,18,2346
OUTLANDER 450,2021-10-04,10,9,IN,US,19,2045
OUTLANDER 1000,2021-10-11,14,3,IN,US,17,2097
OUTLANDER 850,2021-10-11,1,1,IN,US,2,2348
OUTLANDER 450,2021-10-11,6,11,IN,US,17,2062
OUTLANDER 1000,2021-10-18,14,7,IN,US,21,2118
OUTLANDER 850,2021-10-18,5,4,IN,US,9,2357
OUTLANDER 450,2021-10-18,2,9,IN,US,11,2073
OUTLANDER 1000,2021-10-25,14,12,IN,US,26,2144
OUTLANDER 850,2021-10-25,10,2,IN,US,12,2369
OUTLANDER 450,2021-10-25,10,9,IN,US,19,2092
OUTLANDER 1000,2021-11-01,12,8,IN,US,20,2164
OUTLANDER 850,2021-11-01,12,5,IN,US,17,2386
OUTLANDER 450,2021-11-01,15,12,IN,US,27,2119
OUTLANDER 1000,2021-11-08,5,3,IN,US,8,2172
OUTLANDER 850,2021-11-08,14,12,IN,US,26,2412
OUTLANDER 450,2021-11-08,11,5,IN,US,16,2135
OUTLANDER 1000,2021-11-15,12,15,IN,US,27,2199
OUTLANDER 850,2021-11-15,5,7,IN,US,12,2424
OUTLANDER 450,2021-11-15,10,8,IN,US,18,2153
OUTLANDER 1000,2021-11-22,9,2,IN,US,11,2210
OUTLANDER 850,2021-11-22,9,5,IN,US,14,2438
OUTLANDER 450,2021-11-22,13,3,IN,US,16,2169
OUTLANDER 1000,2021-11-29,6,11,IN,US,17,2227
OUTLANDER 850,2021-11-29,11,3,IN,US,14,2452
OUTLANDER 450,2021-11-29,14,4,IN,US,18,2187
OUTLANDER 1000,2021-12-06,14,3,IN,US,17,2244
OUTLANDER 850,2021-12-06,6,5,IN,US,11,2463
OUTLANDER 450,2021-12-06,0,4,IN,US,4,2191
OUTLANDER 1000,2021-12-13,13,8,IN,US,21,2265
OUTLANDER 850,2021-12-13,9,8,IN,US,17,2480
OUTLANDER 450,2021-12-13,13,2,IN,US,15,2206
OUTLANDER 1000,2021-12-20,10,7,IN,US,17,2282
OUTLANDER 850,2021-12-20,3,11,IN,US,14,2494
OUTLANDER 450,2021-12-20,11,4,IN,US,15,2221
OUTLANDER 1000,2021-12-27,14,1,IN,US,15,2297
OUTLANDER 850,2021-12-27,14,3,IN,US,17,2511
OUTLANDER 450,2021-12-27,5,14,IN,US,19,2240
OUTLANDER 1000,2019-01-07,11,3,IA,US,14,14
OUTLANDER 850,2019-01-07,11,10,IA,US,21,21
OUTLANDER 450,2019-01-07,1,5,IA,US,6,6
OUTLANDER 1000,2019-01-14,7,7,IA,US,14,28
OUTLANDER 850,2019-01-14,6,5,IA,US,11,32
OUTLANDER 450,2019-01-14,0,10,IA,US,10,16
OUTLANDER 1000,2019-01-21,0,14,IA,US,14,42
OUTLANDER 850,2019-01-21,6,3,IA,US,9,41
OUTLANDER 450,2019-01-21,10,2,IA,US,12,28
OUTLANDER 1000,2019-01-28,10,4,IA,US,14,56
OUTLANDER 850,2019-01-28,14,9,IA,US,23,64
OUTLANDER 450,2019-01-28,7,13,IA,US,20,48
OUTLANDER 1000,2019-02-04,0,8,IA,US,8,64
OUTLANDER 850,2019-02-04,6,0,IA,US,6,70
OUTLANDER 450,2019-02-04,5,9,IA,US,14,62
OUTLANDER 1000,2019-02-11,9,6,IA,US,15,79
OUTLANDER 850,2019-02-11,6,6,IA,US,12,82
OUTLANDER 450,2019-02-11,2,11,IA,US,13,75
OUTLANDER 1000,2019-02-18,4,8,IA,US,12,91
OUTLANDER 850,2019-02-18,5,8,IA,US,13,95
OUTLANDER 450,2019-02-18,15,10,IA,US,25,100
OUTLANDER 1000,2019-02-25,3,1,IA,US,4,95
OUTLANDER 850,2019-02-25,3,8,IA,US,11,106
OUTLANDER 450,2019-02-25,10,8,IA,US,18,118
OUTLANDER 1000,2019-03-04,14,9,IA,US,23,118
OUTLANDER 850,2019-03-04,5,11,IA,US,16,122
OUTLANDER 450,2019-03-04,14,13,IA,US,27,145
OUTLANDER 1000,2019-03-11,9,9,IA,US,18,136
OUTLANDER 850,2019-03-11,2,15,IA,US,17,139
OUTLANDER 450,2019-03-11,11,9,IA,US,20,165
OUTLANDER 1000,2019-03-18,1,8,IA,US,9,145
OUTLANDER 850,2019-03-18,9,6,IA,US,15,154
OUTLANDER 450,2019-03-18,2,7,IA,US,9,174
OUTLANDER 1000,2019-03-25,6,7,IA,US,13,158
OUTLANDER 850,2019-03-25,11,15,IA,US,26,180
OUTLANDER 450,2019-03-25,6,10,IA,US,16,190
OUTLANDER 1000,2019-04-01,12,14,IA,US,26,184
OUTLANDER 850,2019-04-01,9,2,IA,US,11,191
OUTLANDER 450,2019-04-01,0,3,IA,US,3,193
OUTLANDER 1000,2019-04-08,3,1,IA,US,4,188
OUTLANDER 850,2019-04-08,4,14,IA,US,18,209
OUTLANDER 450,2019-04-08,9,0,IA,US,9,202
OUTLANDER 1000,2019-04-15,4,10,IA,US,14,202
OUTLANDER 850,2019-04-15,11,7,IA,US,18,227
OUTLANDER 450,2019-04-15,8,8,IA,US,16,218
OUTLANDER 1000,2019-04-22,8,11,IA,US,19,221
OUTLANDER 850,2019-04-22,1,15,IA,US,16,243
OUTLANDER 450,2019-04-22,12,10,IA,US,22,240
OUTLANDER 1000,2019-04-29,0,8,IA,US,8,229
OUTLANDER 850,2019-04-29,15,7,IA,US,22,265
OUTLANDER 450,2019-04-29,10,12,IA,US,22,262
OUTLANDER 1000,2019-05-06,13,5,IA,US,18,247
OUTLANDER 850,2019-05-06,14,13,IA,US,27,292
OUTLANDER 450,2019-05-06,3,2,IA,US,5,267
OUTLANDER 1000,2019-05-13,11,2,IA,US,13,260
OUTLANDER 850,2019-05-13,2,10,IA,US,12,304
OUTLANDER 450,2019-05-13,10,9,IA,US,19,286
OUTLANDER 1000,2019-05-20,7,6,IA,US,13,273
OUTLANDER 850,2019-05-20,14,9,IA,US,23,327
OUTLANDER 450,2019-05-20,1,12,IA,US,13,299
OUTLANDER 1000,2019-05-27,6,3,IA,US,9,282
OUTLANDER 850,2019-05-27,15,13,IA,US,28,355
OUTLANDER 450,2019-05-27,9,2,IA,US,11,310
OUTLANDER 1000,2019-06-03,11,9,IA,US,20,302
OUTLANDER 850,2019-06-03,9,4,IA,US,13,368
OUTLANDER 450,2019-06-03,15,10,IA,US,25,335
OUTLANDER 1000,2019-06-10,14,0,IA,US,14,316
OUTLANDER 850,2019-06-10,7,12,IA,US,19,387
OUTLANDER 450,2019-06-10,7,1,IA,US,8,343
OUTLANDER 1000,2019-06-17,2,14,IA,US,16,332
OUTLANDER 850,2019-06-17,8,14,IA,US,22,409
OUTLANDER 450,2019-06-17,1,3,IA,US,4,347
OUTLANDER 1000,2019-06-24,12,13,IA,US,25,357
OUTLANDER 850,2019-06-24,10,10,IA,US,20,429
OUTLANDER 450,2019-06-24,14,12,IA,US,26,373
OUTLANDER 1000,2019-07-01,2,3,IA,US,5,362
OUTLANDER 850,2019-07-01,11,9,IA,US,20,449
OUTLANDER 450,2019-07-01,4,2,IA,US,6,379
OUTLANDER 1000,2019-07-08,7,0,IA,US,7,369
OUTLANDER 850,2019-07-08,6,4,IA,US,10,459
OUTLANDER 450,2019-07-08,11,15,IA,US,26,405
OUTLANDER 1000,2019-07-15,2,12,IA,US,14,383
OUTLANDER 850,2019-07-15,5,10,IA,US,15,474
OUTLANDER 450,2019-07-15,10,13,IA,US,23,428
OUTLANDER 1000,2019-07-22,4,8,IA,US,12,395
OUTLANDER 850,2019-07-22,7,7,IA,US,14,488
OUTLANDER 450,2019-07-22,15,2,IA,US,17,445
OUTLANDER 1000,2019-07-29,4,4,IA,US,8,403
OUTLANDER 850,2019-07-29,2,10,IA,US,12,500
OUTLANDER 450,2019-07-29,7,4,IA,US,11,456
OUTLANDER 1000,2019-08-05,2,7,IA,US,9,412
OUTLANDER 850,2019-08-05,9,9,IA,US,18,518
OUTLANDER 450,2019-08-05,10,12,IA,US,22,478
OUTLANDER 1000,2019-08-12,11,10,IA,US,21,433
OUTLANDER 850,2019-08-12,13,6,IA,US,19,537
OUTLANDER 450,2019-08-12,14,15,IA,US,29,507
OUTLANDER 1000,2019-08-19,6,11,IA,US,17,450
OUTLANDER 850,2019-08-19,6,7,IA,US,13,550
OUTLANDER 450,2019-08-19,14,8,IA,US,22,529
OUTLANDER 1000,2019-08-26,2,9,IA,US,11,461
OUTLANDER 850,2019-08-26,7,5,IA,US,12,562
OUTLANDER 450,2019-08-26,5,13,IA,US,18,547
OUTLANDER 1000,2019-09-02,12,2,IA,US,14,475
OUTLANDER 850,2019-09-02,4,14,IA,US,18,580
OUTLANDER 450,2019-09-02,12,8,IA,US,20,567
OUTLANDER 1000,2019-09-09,8,2,IA,US,10,485
OUTLANDER 850,2019-09-09,10,14,IA,US,24,604
OUTLANDER 450,2019-09-09,7,4,IA,US,11,578
OUTLANDER 1000,2019-09-16,12,0,IA,US,12,497
OUTLANDER 850,2019-09-16,3,11,IA,US,14,618
OUTLANDER 450,2019-09-16,6,8,IA,US,14,592
OUTLANDER 1000,2019-09-23,3,11,IA,US,14,511
OUTLANDER 850,2019-09-23,9,3,IA,US,12,630
OUTLANDER 450,2019-09-23,2,11,IA,US,13,605
OUTLANDER 1000,2019-09-30,14,2,IA,US,16,527
OUTLANDER 850,2019-09-30,10,5,IA,US,15,645
OUTLANDER 450,2019-09-30,6,6,IA,US,12,617
OUTLANDER 1000,2019-10-07,12,8,IA,US,20,547
OUTLANDER 850,2019-10-07,10,14,IA,US,24,669
OUTLANDER 450,2019-10-07,14,4,IA,US,18,635
OUTLANDER 1000,2019-10-14,13,14,IA,US,27,574
OUTLANDER 850,2019-10-14,7,1,IA,US,8,677
OUTLANDER 450,2019-10-14,4,6,IA,US,10,645
OUTLANDER 1000,2019-10-21,10,14,IA,US,24,598
OUTLANDER 850,2019-10-21,15,7,IA,US,22,699
OUTLANDER 450,2019-10-21,3,12,IA,US,15,660
OUTLANDER 1000,2019-10-28,5,9,IA,US,14,612
OUTLANDER 850,2019-10-28,12,3,IA,US,15,714
OUTLANDER 450,2019-10-28,0,1,IA,US,1,661
OUTLANDER 1000,2019-11-04,2,2,IA,US,4,616
OUTLANDER 850,2019-11-04,12,14,IA,US,26,740
OUTLANDER 450,2019-11-04,1,11,IA,US,12,673
OUTLANDER 1000,2019-11-11,9,3,IA,US,12,628
OUTLANDER 850,2019-11-11,3,13,IA,US,16,756
OUTLANDER 450,2019-11-11,8,9,IA,US,17,690
OUTLANDER 1000,2019-11-18,14,2,IA,US,16,644
OUTLANDER 850,2019-11-18,2,14,IA,US,16,772
OUTLANDER 450,2019-11-18,12,9,IA,US,21,711
OUTLANDER 1000,2019-11-25,1,0,IA,US,1,645
OUTLANDER 850,2019-11-25,14,8,IA,US,22,794
OUTLANDER 450,2019-11-25,13,2,IA,US,15,726
OUTLANDER 1000,2019-12-02,6,15,IA,US,21,666
OUTLANDER 850,2019-12-02,5,2,IA,US,7,801
OUTLANDER 450,2019-12-02,4,5,IA,US,9,735
OUTLANDER 1000,2019-12-09,6,10,IA,US,16,682
OUTLANDER 850,2019-12-09,12,11,IA,US,23,824
OUTLANDER 450,2019-12-09,11,9,IA,US,20,755
OUTLANDER 1000,2019-12-16,9,1,IA,US,10,692
OUTLANDER 850,2019-12-16,9,5,IA,US,14,838
OUTLANDER 450,2019-12-16,6,11,IA,US,17,772
OUTLANDER 1000,2019-12-23,6,11,IA,US,17,709
OUTLANDER 850,2019-12-23,5,5,IA,US,10,848
OUTLANDER 450,2019-12-23,15,1,IA,US,16,788
OUTLANDER 1000,2019-12-30,2,3,IA,US,5,714
OUTLANDER 850,2019-12-30,3,4,IA,US,7,855
OUTLANDER 450,2019-12-30,9,13,IA,US,22,810
OUTLANDER 1000,2020-01-06,5,13,IA,US,18,732
OUTLANDER 850,2020-01-06,4,12,IA,US,16,871
OUTLANDER 450,2020-01-06,8,2,IA,US,10,820
OUTLANDER 1000,2020-01-13,13,7,IA,US,20,752
OUTLANDER 850,2020-01-13,8,11,IA,US,19,890
OUTLANDER 450,2020-01-13,3,2,IA,US,5,825
OUTLANDER 1000,2020-01-20,1,10,IA,US,11,763
OUTLANDER 850,2020-01-20,15,7,IA,US,22,912
OUTLANDER 450,2020-01-20,2,8,IA,US,10,835
OUTLANDER 1000,2020-01-27,5,4,IA,US,9,772
OUTLANDER 850,2020-01-27,8,8,IA,US,16,928
OUTLANDER 450,2020-01-27,8,11,IA,US,19,854
OUTLANDER 1000,2020-02-03,13,13,IA,US,26,798
OUTLANDER 850,2020-02-03,7,9,IA,US,16,944
OUTLANDER 450,2020-02-03,2,11,IA,US,13,867
OUTLANDER 1000,2020-02-10,0,13,IA,US,13,811
OUTLANDER 850,2020-02-10,8,8,IA,US,16,960
OUTLANDER 450,2020-02-10,10,14,IA,US,24,891
OUTLANDER 1000,2020-02-17,7,14,IA,US,21,832
OUTLANDER 850,2020-02-17,9,13,IA,US,22,982
OUTLANDER 450,2020-02-17,1,12,IA,US,13,904
OUTLANDER 1000,2020-02-24,1,10,IA,US,11,843
OUTLANDER 850,2020-02-24,12,5,IA,US,17,999
OUTLANDER 450,2020-02-24,2,1,IA,US,3,907
OUTLANDER 1000,2020-03-02,11,11,IA,US,22,865
OUTLANDER 850,2020-03-02,6,0,IA,US,6,1005
OUTLANDER 450,2020-03-02,12,7,IA,US,19,926
OUTLANDER 1000,2020-03-09,7,7,IA,US,14,879
OUTLANDER 850,2020-03-09,8,7,IA,US,15,1020
OUTLANDER 450,2020-03-09,1,5,IA,US,6,932
OUTLANDER 1000,2020-03-16,8,9,IA,US,17,896
OUTLANDER 850,2020-03-16,11,10,IA,US,21,1041
OUTLANDER 450,2020-03-16,5,2,IA,US,7,939
OUTLANDER 1000,2020-03-23,10,3,IA,US,13,909
OUTLANDER 850,2020-03-23,6,1,IA,US,7,1048
OUTLANDER 450,2020-03-23,2,1,IA,US,3,942
OUTLANDER 1000,2020-03-30,3,6,IA,US,9,918
OUTLANDER 850,2020-03-30,15,5,IA,US,20,1068
OUTLANDER 450,2020-03-30,4,14,IA,US,18,960
OUTLANDER 1000,2020-04-06,11,13,IA,US,24,942
OUTLANDER 850,2020-04-06,4,6,IA,US,10,1078
OUTLANDER 450,2020-04-06,7,7,IA,US,14,974
OUTLANDER 1000,2020-04-13,5,15,IA,US,20,962
OUTLANDER 850,2020-04-13,7,6,IA,US,13,1091
OUTLANDER 450,2020-04-13,10,10,IA,US,20,994
OUTLANDER 1000,2020-04-20,6,3,IA,US,9,971
OUTLANDER 850,2020-04-20,11,0,IA,US,11,1102
OUTLANDER 450,2020-04-20,12,7,IA,US,19,1013
OUTLANDER 1000,2020-04-27,11,5,IA,US,16,987
OUTLANDER 850,2020-04-27,9,14,IA,US,23,1125
OUTLANDER 450,2020-04-27,12,9,IA,US,21,1034
OUTLANDER 1000,2020-05-04,4,14,IA,US,18,1005
OUTLANDER 850,2020-05-04,13,5,IA,US,18,1143
OUTLANDER 450,2020-05-04,2,8,IA,US,10,1044
OUTLANDER 1000,2020-05-11,7,0,IA,US,7,1012
OUTLANDER 850,2020-05-11,2,11,IA,US,13,1156
OUTLANDER 450,2020-05-11,2,5,IA,US,7,1051
OUTLANDER 1000,2020-05-18,0,9,IA,US,9,1021
OUTLANDER 850,2020-05-18,14,6,IA,US,20,1176
OUTLANDER 450,2020-05-18,7,11,IA,US,18,1069
OUTLANDER 1000,2020-05-25,10,2,IA,US,12,1033
OUTLANDER 850,2020-05-25,2,8,IA,US,10,1186
OUTLANDER 450,2020-05-25,10,12,IA,US,22,1091
OUTLANDER 1000,2020-06-01,12,14,IA,US,26,1059
OUTLANDER 850,2020-06-01,1,6,IA,US,7,1193
OUTLANDER 450,2020-06-01,11,3,IA,US,14,1105
OUTLANDER 1000,2020-06-08,11,11,IA,US,22,1081
OUTLANDER 850,2020-06-08,11,15,IA,US,26,1219
OUTLANDER 450,2020-06-08,11,11,IA,US,22,1127
OUTLANDER 1000,2020-06-15,11,11,IA,US,22,1103
OUTLANDER 850,2020-06-15,5,11,IA,US,16,1235
OUTLANDER 450,2020-06-15,6,6,IA,US,12,1139
OUTLANDER 1000,2020-06-22,7,6,IA,US,13,1116
OUTLANDER 850,2020-06-22,14,9,IA,US,23,1258
OUTLANDER 450,2020-06-22,6,11,IA,US,17,1156
OUTLANDER 1000,2020-06-29,3,8,IA,US,11,1127
OUTLANDER 850,2020-06-29,1,11,IA,US,12,1270
OUTLANDER 450,2020-06-29,0,10,IA,US,10,1166
OUTLANDER 1000,2020-07-06,4,9,IA,US,13,1140
OUTLANDER 850,2020-07-06,9,2,IA,US,11,1281
OUTLANDER 450,2020-07-06,6,3,IA,US,9,1175
OUTLANDER 1000,2020-07-13,4,2,IA,US,6,1146
OUTLANDER 850,2020-07-13,7,11,IA,US,18,1299
OUTLANDER 450,2020-07-13,0,6,IA,US,6,1181
OUTLANDER 1000,2020-07-20,8,12,IA,US,20,1166
OUTLANDER 850,2020-07-20,10,13,IA,US,23,1322
OUTLANDER 450,2020-07-20,1,2,IA,US,3,1184
OUTLANDER 1000,2020-07-27,15,10,IA,US,25,1191
OUTLANDER 850,2020-07-27,1,4,IA,US,5,1327
OUTLANDER 450,2020-07-27,10,11,IA,US,21,1205
OUTLANDER 1000,2020-08-03,5,0,IA,US,5,1196
OUTLANDER 850,2020-08-03,4,15,IA,US,19,1346
OUTLANDER 450,2020-08-03,13,1,IA,US,14,1219
OUTLANDER 1000,2020-08-10,8,9,IA,US,17,1213
OUTLANDER 850,2020-08-10,1,0,IA,US,1,1347
OUTLANDER 450,2020-08-10,6,2,IA,US,8,1227
OUTLANDER 1000,2020-08-17,9,14,IA,US,23,1236
OUTLANDER 850,2020-08-17,4,4,IA,US,8,1355
OUTLANDER 450,2020-08-17,12,12,IA,US,24,1251
OUTLANDER 1000,2020-08-24,0,12,IA,US,12,1248
OUTLANDER 850,2020-08-24,9,10,IA,US,19,1374
OUTLANDER 450,2020-08-24,1,7,IA,US,8,1259
OUTLANDER 1000,2020-08-31,9,11,IA,US,20,1268
OUTLANDER 850,2020-08-31,11,8,IA,US,19,1393
OUTLANDER 450,2020-08-31,14,14,IA,US,28,1287
OUTLANDER 1000,2020-09-07,1,9,IA,US,10,1278
OUTLANDER 850,2020-09-07,3,10,IA,US,13,1406
OUTLANDER 450,2020-09-07,3,8,IA,US,11,1298
OUTLANDER 1000,2020-09-14,3,5,IA,US,8,1286
OUTLANDER 850,2020-09-14,12,13,IA,US,25,1431
OUTLANDER 450,2020-09-14,0,13,IA,US,13,1311
OUTLANDER 1000,2020-09-21,6,3,IA,US,9,1295
OUTLANDER 850,2020-09-21,4,9,IA,US,13,1444
OUTLANDER 450,2020-09-21,8,11,IA,US,19,1330
OUTLANDER 1000,2020-09-28,2,7,IA,US,9,1304
OUTLANDER 850,2020-09-28,1,8,IA,US,9,1453
OUTLANDER 450,2020-09-28,7,4,IA,US,11,1341
OUTLANDER 1000,2020-10-05,12,0,IA,US,12,1316
OUTLANDER 850,2020-10-05,9,10,IA,US,19,1472
OUTLANDER 450,2020-10-05,13,0,IA,US,13,1354
OUTLANDER 1000,2020-10-12,14,13,IA,US,27,1343
OUTLANDER 850,2020-10-12,12,13,IA,US,25,1497
OUTLANDER 450,2020-10-12,7,11,IA,US,18,1372
OUTLANDER 1000,2020-10-19,15,11,IA,US,26,1369
OUTLANDER 850,2020-10-19,3,10,IA,US,13,1510
OUTLANDER 450,2020-10-19,10,10,IA,US,20,1392
OUTLANDER 1000,2020-10-26,2,5,IA,US,7,1376
OUTLANDER 850,2020-10-26,1,9,IA,US,10,1520
OUTLANDER 450,2020-10-26,9,4,IA,US,13,1405
OUTLANDER 1000,2020-11-02,1,9,IA,US,10,1386
OUTLANDER 850,2020-11-02,8,5,IA,US,13,1533
OUTLANDER 450,2020-11-02,8,6,IA,US,14,1419
OUTLANDER 1000,2020-11-09,7,4,IA,US,11,1397
OUTLANDER 850,2020-11-09,13,4,IA,US,17,1550
OUTLANDER 450,2020-11-09,15,12,IA,US,27,1446
OUTLANDER 1000,2020-11-16,2,12,IA,US,14,1411
OUTLANDER 850,2020-11-16,10,5,IA,US,15,1565
OUTLANDER 450,2020-11-16,7,9,IA,US,16,1462
OUTLANDER 1000,2020-11-23,13,10,IA,US,23,1434
OUTLANDER 850,2020-11-23,14,7,IA,US,21,1586
OUTLANDER 450,2020-11-23,12,12,IA,US,24,1486
OUTLANDER 1000,2020-11-30,2,11,IA,US,13,1447
OUTLANDER 850,2020-11-30,4,2,IA,US,6,1592
OUTLANDER 450,2020-11-30,11,12,IA,US,23,1509
OUTLANDER 1000,2020-12-07,3,3,IA,US,6,1453
OUTLANDER 850,2020-12-07,6,8,IA,US,14,1606
OUTLANDER 450,2020-12-07,12,14,IA,US,26,1535
OUTLANDER 1000,2020-12-14,6,2,IA,US,8,1461
OUTLANDER 850,2020-12-14,4,10,IA,US,14,1620
OUTLANDER 450,2020-12-14,11,14,IA,US,25,1560
OUTLANDER 1000,2020-12-21,2,12,IA,US,14,1475
OUTLANDER 850,2020-12-21,14,1,IA,US,15,1635
OUTLANDER 450,2020-12-21,8,15,IA,US,23,1583
OUTLANDER 1000,2020-12-28,10,1,IA,US,11,1486
OUTLANDER 850,2020-12-28,3,6,IA,US,9,1644
OUTLANDER 450,2020-12-28,13,4,IA,US,17,1600
OUTLANDER 1000,2021-01-04,9,10,IA,US,19,1505
OUTLANDER 850,2021-01-04,1,11,IA,US,12,1656
OUTLANDER 450,2021-01-04,9,9,IA,US,18,1618
OUTLANDER 1000,2021-01-11,11,9,IA,US,20,1525
OUTLANDER 850,2021-01-11,4,11,IA,US,15,1671
OUTLANDER 450,2021-01-11,5,0,IA,US,5,1623
OUTLANDER 1000,2021-01-18,6,14,IA,US,20,1545
OUTLANDER 850,2021-01-18,12,0,IA,US,12,1683
OUTLANDER 450,2021-01-18,0,10,IA,US,10,1633
OUTLANDER 1000,2021-01-25,11,4,IA,US,15,1560
OUTLANDER 850,2021-01-25,3,2,IA,US,5,1688
OUTLANDER 450,2021-01-25,8,7,IA,US,15,1648
OUTLANDER 1000,2021-02-01,11,7,IA,US,18,1578
OUTLANDER 850,2021-02-01,10,9,IA,US,19,1707
OUTLANDER 450,2021-02-01,7,0,IA,US,7,1655
OUTLANDER 1000,2021-02-08,12,8,IA,US,20,1598
OUTLANDER 850,2021-02-08,10,0,IA,US,10,1717
OUTLANDER 450,2021-02-08,5,4,IA,US,9,1664
OUTLANDER 1000,2021-02-15,2,13,IA,US,15,1613
OUTLANDER 850,2021-02-15,13,10,IA,US,23,1740
OUTLANDER 450,2021-02-15,14,5,IA,US,19,1683
OUTLANDER 1000,2021-02-22,14,13,IA,US,27,1640
OUTLANDER 850,2021-02-22,3,6,IA,US,9,1749
OUTLANDER 450,2021-02-22,0,2,IA,US,2,1685
OUTLANDER 1000,2021-03-01,5,0,IA,US,5,1645
OUTLANDER 850,2021-03-01,13,14,IA,US,27,1776
OUTLANDER 450,2021-03-01,2,11,IA,US,13,1698
OUTLANDER 1000,2021-03-08,14,2,IA,US,16,1661
OUTLANDER 850,2021-03-08,3,10,IA,US,13,1789
OUTLANDER 450,2021-03-08,7,8,IA,US,15,1713
OUTLANDER 1000,2021-03-15,0,11,IA,US,11,1672
OUTLANDER 850,2021-03-15,15,1,IA,US,16,1805
OUTLANDER 450,2021-03-15,15,10,IA,US,25,1738
OUTLANDER 1000,2021-03-22,9,2,IA,US,11,1683
OUTLANDER 850,2021-03-22,8,10,IA,US,18,1823
OUTLANDER 450,2021-03-22,6,0,IA,US,6,1744
OUTLANDER 1000,2021-03-29,1,2,IA,US,3,1686
OUTLANDER 850,2021-03-29,5,3,IA,US,8,1831
OUTLANDER 450,2021-03-29,5,8,IA,US,13,1757
OUTLANDER 1000,2021-04-05,2,14,IA,US,16,1702
OUTLANDER 850,2021-04-05,8,1,IA,US,9,1840
OUTLANDER 450,2021-04-05,4,2,IA,US,6,1763
OUTLANDER 1000,2021-04-12,11,7,IA,US,18,1720
OUTLANDER 850,2021-04-12,14,0,IA,US,14,1854
OUTLANDER 450,2021-04-12,2,3,IA,US,5,1768
OUTLANDER 1000,2021-04-19,8,12,IA,US,20,1740
OUTLANDER 850,2021-04-19,1,3,IA,US,4,1858
OUTLANDER 450,2021-04-19,5,12,IA,US,17,1785
OUTLANDER 1000,2021-04-26,13,2,IA,US,15,1755
OUTLANDER 850,2021-04-26,7,4,IA,US,11,1869
OUTLANDER 450,2021-04-26,4,13,IA,US,17,1802
OUTLANDER 1000,2021-05-03,11,14,IA,US,25,1780
OUTLANDER 850,2021-05-03,7,6,IA,US,13,1882
OUTLANDER 450,2021-05-03,13,2,IA,US,15,1817
OUTLANDER 1000,2021-05-10,13,4,IA,US,17,1797
OUTLANDER 850,2021-05-10,13,10,IA,US,23,1905
OUTLANDER 450,2021-05-10,6,9,IA,US,15,1832
OUTLANDER 1000,2021-05-17,6,2,IA,US,8,1805
OUTLANDER 850,2021-05-17,12,15,IA,US,27,1932
OUTLANDER 450,2021-05-17,6,4,IA,US,10,1842
OUTLANDER 1000,2021-05-24,5,5,IA,US,10,1815
OUTLANDER 850,2021-05-24,11,7,IA,US,18,1950
OUTLANDER 450,2021-05-24,15,8,IA,US,23,1865
OUTLANDER 1000,2021-05-31,6,8,IA,US,14,1829
OUTLANDER 850,2021-05-31,9,4,IA,US,13,1963
OUTLANDER 450,2021-05-31,2,14,IA,US,16,1881
OUTLANDER 1000,2021-06-07,10,6,IA,US,16,1845
OUTLANDER 850,2021-06-07,1,0,IA,US,1,1964
OUTLANDER 450,2021-06-07,2,10,IA,US,12,1893
OUTLANDER 1000,2021-06-14,10,5,IA,US,15,1860
OUTLANDER 850,2021-06-14,3,5,IA,US,8,1972
OUTLANDER 450,2021-06-14,2,4,IA,US,6,1899
OUTLANDER 1000,2021-06-21,1,4,IA,US,5,1865
OUTLANDER 850,2021-06-21,12,13,IA,US,25,1997
OUTLANDER 450,2021-06-21,5,9,IA,US,14,1913
OUTLANDER 1000,2021-06-28,14,6,IA,US,20,1885
OUTLANDER 850,2021-06-28,8,8,IA,US,16,2013
OUTLANDER 450,2021-06-28,13,8,IA,US,21,1934
OUTLANDER 1000,2021-07-05,12,10,IA,US,22,1907
OUTLANDER 850,2021-07-05,3,12,IA,US,15,2028
OUTLANDER 450,2021-07-05,13,7,IA,US,20,1954
OUTLANDER 1000,2021-07-12,11,0,IA,US,11,1918
OUTLANDER 850,2021-07-12,6,14,IA,US,20,2048
OUTLANDER 450,2021-07-12,5,1,IA,US,6,1960
OUTLANDER 1000,2021-07-19,11,8,IA,US,19,1937
OUTLANDER 850,2021-07-19,11,8,IA,US,19,2067
OUTLANDER 450,2021-07-19,5,12,IA,US,17,1977
OUTLANDER 1000,2021-07-26,12,13,IA,US,25,1962
OUTLANDER 850,2021-07-26,12,11,IA,US,23,2090
OUTLANDER 450,2021-07-26,6,12,IA,US,18,1995
OUTLANDER 1000,2021-08-02,7,9,IA,US,16,1978
OUTLANDER 850,2021-08-02,5,7,IA,US,12,2102
OUTLANDER 450,2021-08-02,0,6,IA,US,6,2001
OUTLANDER 1000,2021-08-09,1,13,IA,US,14,1992
OUTLANDER 850,2021-08-09,5,7,IA,US,12,2114
OUTLANDER 450,2021-08-09,3,12,IA,US,15,2016
OUTLANDER 1000,2021-08-16,5,11,IA,US,16,2008
OUTLANDER 850,2021-08-16,11,0,IA,US,11,2125
OUTLANDER 450,2021-08-16,10,4,IA,US,14,2030
OUTLANDER 1000,2021-08-23,10,4,IA,US,14,2022
OUTLANDER 850,2021-08-23,15,1,IA,US,16,2141
OUTLANDER 450,2021-08-23,6,8,IA,US,14,2044
OUTLANDER 1000,2021-08-30,10,13,IA,US,23,2045
OUTLANDER 850,2021-08-30,4,7,IA,US,11,2152
OUTLANDER 450,2021-08-30,7,14,IA,US,21,2065
OUTLANDER 1000,2021-09-06,11,12,IA,US,23,2068
OUTLANDER 850,2021-09-06,9,10,IA,US,19,2171
OUTLANDER 450,2021-09-06,11,2,IA,US,13,2078
OUTLANDER 1000,2021-09-13,10,1,IA,US,11,2079
OUTLANDER 850,2021-09-13,3,7,IA,US,10,2181
OUTLANDER 450,2021-09-13,10,0,IA,US,10,2088
OUTLANDER 1000,2021-09-20,2,10,IA,US,12,2091
OUTLANDER 850,2021-09-20,6,9,IA,US,15,2196
OUTLANDER 450,2021-09-20,2,4,IA,US,6,2094
OUTLANDER 1000,2021-09-27,9,12,IA,US,21,2112
OUTLANDER 850,2021-09-27,3,8,IA,US,11,2207
OUTLANDER 450,2021-09-27,7,9,IA,US,16,2110
OUTLANDER 1000,2021-10-04,15,3,IA,US,18,2130
OUTLANDER 850,2021-10-04,2,1,IA,US,3,2210
OUTLANDER 450,2021-10-04,10,6,IA,US,16,2126
OUTLANDER 1000,2021-10-11,14,5,IA,US,19,2149
OUTLANDER 850,2021-10-11,11,4,IA,US,15,2225
OUTLANDER 450,2021-10-11,3,13,IA,US,16,2142
OUTLANDER 1000,2021-10-18,11,4,IA,US,15,2164
OUTLANDER 850,2021-10-18,4,14,IA,US,18,2243
OUTLANDER 450,2021-10-18,7,14,IA,US,21,2163
OUTLANDER 1000,2021-10-25,13,5,IA,US,18,2182
OUTLANDER 850,2021-10-25,13,2,IA,US,15,2258
OUTLANDER 450,2021-10-25,14,11,IA,US,25,2188
OUTLANDER 1000,2021-11-01,5,1,IA,US,6,2188
OUTLANDER 850,2021-11-01,9,2,IA,US,11,2269
OUTLANDER 450,2021-11-01,6,10,IA,US,16,2204
OUTLANDER 1000,2021-11-08,14,5,IA,US,19,2207
OUTLANDER 850,2021-11-08,5,1,IA,US,6,2275
OUTLANDER 450,2021-11-08,6,0,IA,US,6,2210
OUTLANDER 1000,2021-11-15,4,1,IA,US,5,2212
OUTLANDER 850,2021-11-15,13,6,IA,US,19,2294
OUTLANDER 450,2021-11-15,15,10,IA,US,25,2235
OUTLANDER 1000,2021-11-22,7,9,IA,US,16,2228
OUTLANDER 850,2021-11-22,3,12,IA,US,15,2309
OUTLANDER 450,2021-11-22,11,13,IA,US,24,2259
OUTLANDER 1000,2021-11-29,8,13,IA,US,21,2249
OUTLANDER 850,2021-11-29,2,11,IA,US,13,2322
OUTLANDER 450,2021-11-29,5,10,IA,US,15,2274
OUTLANDER 1000,2021-12-06,4,13,IA,US,17,2266
OUTLANDER 850,2021-12-06,9,5,IA,US,14,2336
OUTLANDER 450,2021-12-06,2,5,IA,US,7,2281
OUTLANDER 1000,2021-12-13,6,1,IA,US,7,2273
OUTLANDER 850,2021-12-13,2,8,IA,US,10,2346
OUTLANDER 450,2021-12-13,5,2,IA,US,7,2288
OUTLANDER 1000,2021-12-20,4,5,IA,US,9,2282
OUTLANDER 850,2021-12-20,6,1,IA,US,7,2353
OUTLANDER 450,2021-12-20,0,9,IA,US,9,2297
OUTLANDER 1000,2021-12-27,13,4,IA,US,17,2299
OUTLANDER 850,2021-12-27,7,12,IA,US,19,2372
OUTLANDER 450,2021-12-27,1,15,IA,US,16,2313
OUTLANDER 1000,2019-01-07,15,10,KS,US,25,25
OUTLANDER 850,2019-01-07,12,3,KS,US,15,15
OUTLANDER 450,2019-01-07,12,3,KS,US,15,15
OUTLANDER 1000,2019-01-14,13,5,KS,US,18,43
OUTLANDER 850,2019-01-14,12,1,KS,US,13,28
OUTLANDER 450,2019-01-14,9,15,KS,US,24,39
OUTLANDER 1000,2019-01-21,9,1,KS,US,10,53
OUTLANDER 850,2019-01-21,8,7,KS,US,15,43
OUTLANDER 450,2019-01-21,15,8,KS,US,23,62
OUTLANDER 1000,2019-01-28,13,2,KS,US,15,68
OUTLANDER 850,2019-01-28,14,4,KS,US,18,61
OUTLANDER 450,2019-01-28,7,3,KS,US,10,72
OUTLANDER 1000,2019-02-04,9,10,KS,US,19,87
OUTLANDER 850,2019-02-04,7,12,KS,US,19,80
OUTLANDER 450,2019-02-04,3,12,KS,US,15,87
OUTLANDER 1000,2019-02-11,7,1,KS,US,8,95
OUTLANDER 850,2019-02-11,7,1,KS,US,8,88
OUTLANDER 450,2019-02-11,2,3,KS,US,5,92
OUTLANDER 1000,2019-02-18,3,15,KS,US,18,113
OUTLANDER 850,2019-02-18,14,1,KS,US,15,103
OUTLANDER 450,2019-02-18,2,2,KS,US,4,96
OUTLANDER 1000,2019-02-25,5,3,KS,US,8,121
OUTLANDER 850,2019-02-25,13,6,KS,US,19,122
OUTLANDER 450,2019-02-25,5,6,KS,US,11,107
OUTLANDER 1000,2019-03-04,2,9,KS,US,11,132
OUTLANDER 850,2019-03-04,11,5,KS,US,16,138
OUTLANDER 450,2019-03-04,9,4,KS,US,13,120
OUTLANDER 1000,2019-03-11,3,15,KS,US,18,150
OUTLANDER 850,2019-03-11,12,0,KS,US,12,150
OUTLANDER 450,2019-03-11,11,2,KS,US,13,133
OUTLANDER 1000,2019-03-18,13,9,KS,US,22,172
OUTLANDER 850,2019-03-18,5,4,KS,US,9,159
OUTLANDER 450,2019-03-18,7,1,KS,US,8,141
OUTLANDER 1000,2019-03-25,10,3,KS,US,13,185
OUTLANDER 850,2019-03-25,1,6,KS,US,7,166
OUTLANDER 450,2019-03-25,1,4,KS,US,5,146
OUTLANDER 1000,2019-04-01,6,8,KS,US,14,199
OUTLANDER 850,2019-04-01,6,8,KS,US,14,180
OUTLANDER 450,2019-04-01,6,11,KS,US,17,163
OUTLANDER 1000,2019-04-08,0,5,KS,US,5,204
OUTLANDER 850,2019-04-08,10,3,KS,US,13,193
OUTLANDER 450,2019-04-08,14,6,KS,US,20,183
OUTLANDER 1000,2019-04-15,9,11,KS,US,20,224
OUTLANDER 850,2019-04-15,14,3,KS,US,17,210
OUTLANDER 450,2019-04-15,4,3,KS,US,7,190
OUTLANDER 1000,2019-04-22,15,14,KS,US,29,253
OUTLANDER 850,2019-04-22,5,13,KS,US,18,228
OUTLANDER 450,2019-04-22,9,12,KS,US,21,211
OUTLANDER 1000,2019-04-29,5,12,KS,US,17,270
OUTLANDER 850,2019-04-29,1,10,KS,US,11,239
OUTLANDER 450,2019-04-29,0,2,KS,US,2,213
OUTLANDER 1000,2019-05-06,12,6,KS,US,18,288
OUTLANDER 850,2019-05-06,15,11,KS,US,26,265
OUTLANDER 450,2019-05-06,0,1,KS,US,1,214
OUTLANDER 1000,2019-05-13,15,8,KS,US,23,311
OUTLANDER 850,2019-05-13,13,13,KS,US,26,291
OUTLANDER 450,2019-05-13,15,13,KS,US,28,242
OUTLANDER 1000,2019-05-20,12,14,KS,US,26,337
OUTLANDER 850,2019-05-20,15,6,KS,US,21,312
OUTLANDER 450,2019-05-20,6,6,KS,US,12,254
OUTLANDER 1000,2019-05-27,6,5,KS,US,11,348
OUTLANDER 850,2019-05-27,2,15,KS,US,17,329
OUTLANDER 450,2019-05-27,4,13,KS,US,17,271
OUTLANDER 1000,2019-06-03,11,5,KS,US,16,364
OUTLANDER 850,2019-06-03,5,6,KS,US,11,340
OUTLANDER 450,2019-06-03,1,14,KS,US,15,286
OUTLANDER 1000,2019-06-10,6,8,KS,US,14,378
OUTLANDER 850,2019-06-10,7,12,KS,US,19,359
OUTLANDER 450,2019-06-10,11,1,KS,US,12,298
OUTLANDER 1000,2019-06-17,13,0,KS,US,13,391
OUTLANDER 850,2019-06-17,11,2,KS,US,13,372
OUTLANDER 450,2019-06-17,2,1,KS,US,3,301
OUTLANDER 1000,2019-06-24,10,0,KS,US,10,401
OUTLANDER 850,2019-06-24,6,6,KS,US,12,384
OUTLANDER 450,2019-06-24,14,14,KS,US,28,329
OUTLANDER 1000,2019-07-01,12,12,KS,US,24,425
OUTLANDER 850,2019-07-01,12,11,KS,US,23,407
OUTLANDER 450,2019-07-01,10,1,KS,US,11,340
OUTLANDER 1000,2019-07-08,3,12,KS,US,15,440
OUTLANDER 850,2019-07-08,14,4,KS,US,18,425
OUTLANDER 450,2019-07-08,8,4,KS,US,12,352
OUTLANDER 1000,2019-07-15,3,11,KS,US,14,454
OUTLANDER 850,2019-07-15,8,6,KS,US,14,439
OUTLANDER 450,2019-07-15,4,11,KS,US,15,367
OUTLANDER 1000,2019-07-22,14,8,KS,US,22,476
OUTLANDER 850,2019-07-22,14,4,KS,US,18,457
OUTLANDER 450,2019-07-22,3,8,KS,US,11,378
OUTLANDER 1000,2019-07-29,7,11,KS,US,18,494
OUTLANDER 850,2019-07-29,6,1,KS,US,7,464
OUTLANDER 450,2019-07-29,6,11,KS,US,17,395
OUTLANDER 1000,2019-08-05,3,5,KS,US,8,502
OUTLANDER 850,2019-08-05,6,14,KS,US,20,484
OUTLANDER 450,2019-08-05,2,13,KS,US,15,410
OUTLANDER 1000,2019-08-12,6,11,KS,US,17,519
OUTLANDER 850,2019-08-12,5,10,KS,US,15,499
OUTLANDER 450,2019-08-12,7,14,KS,US,21,431
OUTLANDER 1000,2019-08-19,9,5,KS,US,14,533
OUTLANDER 850,2019-08-19,11,5,KS,US,16,515
OUTLANDER 450,2019-08-19,0,1,KS,US,1,432
OUTLANDER 1000,2019-08-26,11,15,KS,US,26,559
OUTLANDER 850,2019-08-26,14,14,KS,US,28,543
OUTLANDER 450,2019-08-26,3,2,KS,US,5,437
OUTLANDER 1000,2019-09-02,6,4,KS,US,10,569
OUTLANDER 850,2019-09-02,15,7,KS,US,22,565
OUTLANDER 450,2019-09-02,0,11,KS,US,11,448
OUTLANDER 1000,2019-09-09,9,15,KS,US,24,593
OUTLANDER 850,2019-09-09,15,2,KS,US,17,582
OUTLANDER 450,2019-09-09,1,2,KS,US,3,451
OUTLANDER 1000,2019-09-16,8,10,KS,US,18,611
OUTLANDER 850,2019-09-16,7,13,KS,US,20,602
OUTLANDER 450,2019-09-16,13,3,KS,US,16,467
OUTLANDER 1000,2019-09-23,10,7,KS,US,17,628
OUTLANDER 850,2019-09-23,0,9,KS,US,9,611
OUTLANDER 450,2019-09-23,4,0,KS,US,4,471
OUTLANDER 1000,2019-09-30,3,4,KS,US,7,635
OUTLANDER 850,2019-09-30,15,12,KS,US,27,638
OUTLANDER 450,2019-09-30,13,2,KS,US,15,486
OUTLANDER 1000,2019-10-07,6,4,KS,US,10,645
OUTLANDER 850,2019-10-07,12,8,KS,US,20,658
OUTLANDER 450,2019-10-07,9,13,KS,US,22,508
OUTLANDER 1000,2019-10-14,14,9,KS,US,23,668
OUTLANDER 850,2019-10-14,3,3,KS,US,6,664
OUTLANDER 450,2019-10-14,0,9,KS,US,9,517
OUTLANDER 1000,2019-10-21,5,14,KS,US,19,687
OUTLANDER 850,2019-10-21,2,0,KS,US,2,666
OUTLANDER 450,2019-10-21,13,13,KS,US,26,543
OUTLANDER 1000,2019-10-28,12,9,KS,US,21,708
OUTLANDER 850,2019-10-28,2,1,KS,US,3,669
OUTLANDER 450,2019-10-28,10,13,KS,US,23,566
OUTLANDER 1000,2019-11-04,2,4,KS,US,6,714
OUTLANDER 850,2019-11-04,2,13,KS,US,15,684
OUTLANDER 450,2019-11-04,13,6,KS,US,19,585
OUTLANDER 1000,2019-11-11,8,0,KS,US,8,722
OUTLANDER 850,2019-11-11,1,6,KS,US,7,691
OUTLANDER 450,2019-11-11,9,1,KS,US,10,595
OUTLANDER 1000,2019-11-18,13,13,KS,US,26,748
OUTLANDER 850,2019-11-18,11,2,KS,US,13,704
OUTLANDER 450,2019-11-18,13,11,KS,US,24,619
OUTLANDER 1000,2019-11-25,10,14,KS,US,24,772
OUTLANDER 850,2019-11-25,15,5,KS,US,20,724
OUTLANDER 450,2019-11-25,6,4,KS,US,10,629
OUTLANDER 1000,2019-12-02,2,8,KS,US,10,782
OUTLANDER 850,2019-12-02,10,12,KS,US,22,746
OUTLANDER 450,2019-12-02,5,5,KS,US,10,639
OUTLANDER 1000,2019-12-09,3,7,KS,US,10,792
OUTLANDER 850,2019-12-09,8,8,KS,US,16,762
OUTLANDER 450,2019-12-09,5,2,KS,US,7,646
OUTLANDER 1000,2019-12-16,13,5,KS,US,18,810
OUTLANDER 850,2019-12-16,5,2,KS,US,7,769
OUTLANDER 450,2019-12-16,9,6,KS,US,15,661
OUTLANDER 1000,2019-12-23,13,12,KS,US,25,835
OUTLANDER 850,2019-12-23,9,6,KS,US,15,784
OUTLANDER 450,2019-12-23,5,12,KS,US,17,678
OUTLANDER 1000,2019-12-30,2,3,KS,US,5,840
OUTLANDER 850,2019-12-30,4,3,KS,US,7,791
OUTLANDER 450,2019-12-30,3,13,KS,US,16,694
OUTLANDER 1000,2020-01-06,4,5,KS,US,9,849
OUTLANDER 850,2020-01-06,4,1,KS,US,5,796
OUTLANDER 450,2020-01-06,14,4,KS,US,18,712
OUTLANDER 1000,2020-01-13,14,13,KS,US,27,876
OUTLANDER 850,2020-01-13,3,9,KS,US,12,808
OUTLANDER 450,2020-01-13,12,14,KS,US,26,738
OUTLANDER 1000,2020-01-20,3,6,KS,US,9,885
OUTLANDER 850,2020-01-20,7,11,KS,US,18,826
OUTLANDER 450,2020-01-20,1,11,KS,US,12,750
OUTLANDER 1000,2020-01-27,14,6,KS,US,20,905
OUTLANDER 850,2020-01-27,4,14,KS,US,18,844
OUTLANDER 450,2020-01-27,10,9,KS,US,19,769
OUTLANDER 1000,2020-02-03,11,7,KS,US,18,923
OUTLANDER 850,2020-02-03,12,11,KS,US,23,867
OUTLANDER 450,2020-02-03,5,12,KS,US,17,786
OUTLANDER 1000,2020-02-10,7,15,KS,US,22,945
OUTLANDER 850,2020-02-10,12,5,KS,US,17,884
OUTLANDER 450,2020-02-10,9,2,KS,US,11,797
OUTLANDER 1000,2020-02-17,13,10,KS,US,23,968
OUTLANDER 850,2020-02-17,13,5,KS,US,18,902
OUTLANDER 450,2020-02-17,7,5,KS,US,12,809
OUTLANDER 1000,2020-02-24,12,12,KS,US,24,992
OUTLANDER 850,2020-02-24,5,6,KS,US,11,913
OUTLANDER 450,2020-02-24,8,14,KS,US,22,831
OUTLANDER 1000,2020-03-02,8,8,KS,US,16,1008
OUTLANDER 850,2020-03-02,12,14,KS,US,26,939
OUTLANDER 450,2020-03-02,13,1,KS,US,14,845
OUTLANDER 1000,2020-03-09,12,9,KS,US,21,1029
OUTLANDER 850,2020-03-09,14,9,KS,US,23,962
OUTLANDER 450,2020-03-09,2,8,KS,US,10,855
OUTLANDER 1000,2020-03-16,7,8,KS,US,15,1044
OUTLANDER 850,2020-03-16,4,2,KS,US,6,968
OUTLANDER 450,2020-03-16,11,2,KS,US,13,868
OUTLANDER 1000,2020-03-23,9,0,KS,US,9,1053
OUTLANDER 850,2020-03-23,8,14,KS,US,22,990
OUTLANDER 450,2020-03-23,1,12,KS,US,13,881
OUTLANDER 1000,2020-03-30,14,13,KS,US,27,1080
OUTLANDER 850,2020-03-30,9,3,KS,US,12,1002
OUTLANDER 450,2020-03-30,14,7,KS,US,21,902
OUTLANDER 1000,2020-04-06,12,13,KS,US,25,1105
OUTLANDER 850,2020-04-06,15,14,KS,US,29,1031
OUTLANDER 450,2020-04-06,6,4,KS,US,10,912
OUTLANDER 1000,2020-04-13,14,9,KS,US,23,1128
OUTLANDER 850,2020-04-13,13,8,KS,US,21,1052
OUTLANDER 450,2020-04-13,5,7,KS,US,12,924
OUTLANDER 1000,2020-04-20,6,5,KS,US,11,1139
OUTLANDER 850,2020-04-20,11,4,KS,US,15,1067
OUTLANDER 450,2020-04-20,2,2,KS,US,4,928
OUTLANDER 1000,2020-04-27,5,12,KS,US,17,1156
OUTLANDER 850,2020-04-27,5,13,KS,US,18,1085
OUTLANDER 450,2020-04-27,7,5,KS,US,12,940
OUTLANDER 1000,2020-05-04,11,6,KS,US,17,1173
OUTLANDER 850,2020-05-04,10,1,KS,US,11,1096
OUTLANDER 450,2020-05-04,8,10,KS,US,18,958
OUTLANDER 1000,2020-05-11,9,5,KS,US,14,1187
OUTLANDER 850,2020-05-11,9,4,KS,US,13,1109
OUTLANDER 450,2020-05-11,11,9,KS,US,20,978
OUTLANDER 1000,2020-05-18,9,0,KS,US,9,1196
OUTLANDER 850,2020-05-18,6,10,KS,US,16,1125
OUTLANDER 450,2020-05-18,1,12,KS,US,13,991
OUTLANDER 1000,2020-05-25,3,10,KS,US,13,1209
OUTLANDER 850,2020-05-25,15,3,KS,US,18,1143
OUTLANDER 450,2020-05-25,6,2,KS,US,8,999
OUTLANDER 1000,2020-06-01,10,5,KS,US,15,1224
OUTLANDER 850,2020-06-01,3,0,KS,US,3,1146
OUTLANDER 450,2020-06-01,14,8,KS,US,22,1021
OUTLANDER 1000,2020-06-08,5,11,KS,US,16,1240
OUTLANDER 850,2020-06-08,4,14,KS,US,18,1164
OUTLANDER 450,2020-06-08,10,2,KS,US,12,1033
OUTLANDER 1000,2020-06-15,10,6,KS,US,16,1256
OUTLANDER 850,2020-06-15,10,7,KS,US,17,1181
OUTLANDER 450,2020-06-15,14,6,KS,US,20,1053
OUTLANDER 1000,2020-06-22,3,6,KS,US,9,1265
OUTLANDER 850,2020-06-22,6,4,KS,US,10,1191
OUTLANDER 450,2020-06-22,9,14,KS,US,23,1076
OUTLANDER 1000,2020-06-29,10,11,KS,US,21,1286
OUTLANDER 850,2020-06-29,11,10,KS,US,21,1212
OUTLANDER 450,2020-06-29,12,3,KS,US,15,1091
OUTLANDER 1000,2020-07-06,13,7,KS,US,20,1306
OUTLANDER 850,2020-07-06,14,10,KS,US,24,1236
OUTLANDER 450,2020-07-06,7,3,KS,US,10,1101
OUTLANDER 1000,2020-07-13,9,1,KS,US,10,1316
OUTLANDER 850,2020-07-13,3,11,KS,US,14,1250
OUTLANDER 450,2020-07-13,14,2,KS,US,16,1117
OUTLANDER 1000,2020-07-20,10,11,KS,US,21,1337
OUTLANDER 850,2020-07-20,15,2,KS,US,17,1267
OUTLANDER 450,2020-07-20,7,9,KS,US,16,1133
OUTLANDER 1000,2020-07-27,4,3,KS,US,7,1344
OUTLANDER 850,2020-07-27,4,0,KS,US,4,1271
OUTLANDER 450,2020-07-27,11,13,KS,US,24,1157
OUTLANDER 1000,2020-08-03,4,6,KS,US,10,1354
OUTLANDER 850,2020-08-03,14,15,KS,US,29,1300
OUTLANDER 450,2020-08-03,9,11,KS,US,20,1177
OUTLANDER 1000,2020-08-10,12,6,KS,US,18,1372
OUTLANDER 850,2020-08-10,13,9,KS,US,22,1322
OUTLANDER 450,2020-08-10,11,3,KS,US,14,1191
OUTLANDER 1000,2020-08-17,8,10,KS,US,18,1390
OUTLANDER 850,2020-08-17,15,4,KS,US,19,1341
OUTLANDER 450,2020-08-17,4,7,KS,US,11,1202
OUTLANDER 1000,2020-08-24,10,6,KS,US,16,1406
OUTLANDER 850,2020-08-24,3,2,KS,US,5,1346
OUTLANDER 450,2020-08-24,2,2,KS,US,4,1206
OUTLANDER 1000,2020-08-31,1,1,KS,US,2,1408
OUTLANDER 850,2020-08-31,11,2,KS,US,13,1359
OUTLANDER 450,2020-08-31,3,1,KS,US,4,1210
OUTLANDER 1000,2020-09-07,14,12,KS,US,26,1434
OUTLANDER 850,2020-09-07,5,13,KS,US,18,1377
OUTLANDER 450,2020-09-07,10,3,KS,US,13,1223
OUTLANDER 1000,2020-09-14,12,12,KS,US,24,1458
OUTLANDER 850,2020-09-14,0,10,KS,US,10,1387
OUTLANDER 450,2020-09-14,15,9,KS,US,24,1247
OUTLANDER 1000,2020-09-21,11,4,KS,US,15,1473
OUTLANDER 850,2020-09-21,13,13,KS,US,26,1413
OUTLANDER 450,2020-09-21,10,13,KS,US,23,1270
OUTLANDER 1000,2020-09-28,10,12,KS,US,22,1495
OUTLANDER 850,2020-09-28,12,11,KS,US,23,1436
OUTLANDER 450,2020-09-28,2,1,KS,US,3,1273
OUTLANDER 1000,2020-10-05,12,2,KS,US,14,1509
OUTLANDER 850,2020-10-05,9,2,KS,US,11,1447
OUTLANDER 450,2020-10-05,4,3,KS,US,7,1280
OUTLANDER 1000,2020-10-12,2,13,KS,US,15,1524
OUTLANDER 850,2020-10-12,15,8,KS,US,23,1470
OUTLANDER 450,2020-10-12,7,1,KS,US,8,1288
OUTLANDER 1000,2020-10-19,10,7,KS,US,17,1541
OUTLANDER 850,2020-10-19,2,2,KS,US,4,1474
OUTLANDER 450,2020-10-19,8,9,KS,US,17,1305
OUTLANDER 1000,2020-10-26,3,5,KS,US,8,1549
OUTLANDER 850,2020-10-26,2,6,KS,US,8,1482
OUTLANDER 450,2020-10-26,13,1,KS,US,14,1319
OUTLANDER 1000,2020-11-02,5,1,KS,US,6,1555
OUTLANDER 850,2020-11-02,7,14,KS,US,21,1503
OUTLANDER 450,2020-11-02,4,4,KS,US,8,1327
OUTLANDER 1000,2020-11-09,7,13,KS,US,20,1575
OUTLANDER 850,2020-11-09,8,5,KS,US,13,1516
OUTLANDER 450,2020-11-09,13,5,KS,US,18,1345
OUTLANDER 1000,2020-11-16,1,11,KS,US,12,1587
OUTLANDER 850,2020-11-16,7,10,KS,US,17,1533
OUTLANDER 450,2020-11-16,6,2,KS,US,8,1353
OUTLANDER 1000,2020-11-23,8,7,KS,US,15,1602
OUTLANDER 850,2020-11-23,3,11,KS,US,14,1547
OUTLANDER 450,2020-11-23,6,4,KS,US,10,1363
OUTLANDER 1000,2020-11-30,11,15,KS,US,26,1628
OUTLANDER 850,2020-11-30,6,14,KS,US,20,1567
OUTLANDER 450,2020-11-30,12,8,KS,US,20,1383
OUTLANDER 1000,2020-12-07,10,0,KS,US,10,1638
OUTLANDER 850,2020-12-07,5,13,KS,US,18,1585
OUTLANDER 450,2020-12-07,8,9,KS,US,17,1400
OUTLANDER 1000,2020-12-14,13,15,KS,US,28,1666
OUTLANDER 850,2020-12-14,11,4,KS,US,15,1600
OUTLANDER 450,2020-12-14,7,5,KS,US,12,1412
OUTLANDER 1000,2020-12-21,6,12,KS,US,18,1684
OUTLANDER 850,2020-12-21,15,15,KS,US,30,1630
OUTLANDER 450,2020-12-21,12,0,KS,US,12,1424
OUTLANDER 1000,2020-12-28,4,1,KS,US,5,1689
OUTLANDER 850,2020-12-28,6,4,KS,US,10,1640
OUTLANDER 450,2020-12-28,10,8,KS,US,18,1442
OUTLANDER 1000,2021-01-04,7,8,KS,US,15,1704
OUTLANDER 850,2021-01-04,7,6,KS,US,13,1653
OUTLANDER 450,2021-01-04,15,13,KS,US,28,1470
OUTLANDER 1000,2021-01-11,14,5,KS,US,19,1723
OUTLANDER 850,2021-01-11,2,2,KS,US,4,1657
OUTLANDER 450,2021-01-11,0,2,KS,US,2,1472
OUTLANDER 1000,2021-01-18,11,3,KS,US,14,1737
OUTLANDER 850,2021-01-18,13,4,KS,US,17,1674
OUTLANDER 450,2021-01-18,0,13,KS,US,13,1485
OUTLANDER 1000,2021-01-25,12,9,KS,US,21,1758
OUTLANDER 850,2021-01-25,1,14,KS,US,15,1689
OUTLANDER 450,2021-01-25,5,3,KS,US,8,1493
OUTLANDER 1000,2021-02-01,13,12,KS,US,25,1783
OUTLANDER 850,2021-02-01,0,13,KS,US,13,1702
OUTLANDER 450,2021-02-01,9,7,KS,US,16,1509
OUTLANDER 1000,2021-02-08,9,13,KS,US,22,1805
OUTLANDER 850,2021-02-08,6,9,KS,US,15,1717
OUTLANDER 450,2021-02-08,6,8,KS,US,14,1523
OUTLANDER 1000,2021-02-15,13,13,KS,US,26,1831
OUTLANDER 850,2021-02-15,11,11,KS,US,22,1739
OUTLANDER 450,2021-02-15,6,13,KS,US,19,1542
OUTLANDER 1000,2021-02-22,10,4,KS,US,14,1845
OUTLANDER 850,2021-02-22,10,7,KS,US,17,1756
OUTLANDER 450,2021-02-22,6,6,KS,US,12,1554
OUTLANDER 1000,2021-03-01,4,4,KS,US,8,1853
OUTLANDER 850,2021-03-01,10,1,KS,US,11,1767
OUTLANDER 450,2021-03-01,13,2,KS,US,15,1569
OUTLANDER 1000,2021-03-08,10,7,KS,US,17,1870
OUTLANDER 850,2021-03-08,7,1,KS,US,8,1775
OUTLANDER 450,2021-03-08,6,6,KS,US,12,1581
OUTLANDER 1000,2021-03-15,4,2,KS,US,6,1876
OUTLANDER 850,2021-03-15,3,13,KS,US,16,1791
OUTLANDER 450,2021-03-15,9,6,KS,US,15,1596
OUTLANDER 1000,2021-03-22,11,10,KS,US,21,1897
OUTLANDER 850,2021-03-22,12,13,KS,US,25,1816
OUTLANDER 450,2021-03-22,12,6,KS,US,18,1614
OUTLANDER 1000,2021-03-29,7,3,KS,US,10,1907
OUTLANDER 850,2021-03-29,1,7,KS,US,8,1824
OUTLANDER 450,2021-03-29,6,10,KS,US,16,1630
OUTLANDER 1000,2021-04-05,4,9,KS,US,13,1920
OUTLANDER 850,2021-04-05,11,10,KS,US,21,1845
OUTLANDER 450,2021-04-05,13,1,KS,US,14,1644
OUTLANDER 1000,2021-04-12,14,4,KS,US,18,1938
OUTLANDER 850,2021-04-12,6,5,KS,US,11,1856
OUTLANDER 450,2021-04-12,14,9,KS,US,23,1667
OUTLANDER 1000,2021-04-19,2,6,KS,US,8,1946
OUTLANDER 850,2021-04-19,13,10,KS,US,23,1879
OUTLANDER 450,2021-04-19,2,3,KS,US,5,1672
OUTLANDER 1000,2021-04-26,14,8,KS,US,22,1968
OUTLANDER 850,2021-04-26,9,14,KS,US,23,1902
OUTLANDER 450,2021-04-26,10,5,KS,US,15,1687
OUTLANDER 1000,2021-05-03,1,1,KS,US,2,1970
OUTLANDER 850,2021-05-03,8,13,KS,US,21,1923
OUTLANDER 450,2021-05-03,11,6,KS,US,17,1704
OUTLANDER 1000,2021-05-10,10,6,KS,US,16,1986
OUTLANDER 850,2021-05-10,9,3,KS,US,12,1935
OUTLANDER 450,2021-05-10,12,4,KS,US,16,1720
OUTLANDER 1000,2021-05-17,7,2,KS,US,9,1995
OUTLANDER 850,2021-05-17,4,6,KS,US,10,1945
OUTLANDER 450,2021-05-17,12,5,KS,US,17,1737
OUTLANDER 1000,2021-05-24,5,8,KS,US,13,2008
OUTLANDER 850,2021-05-24,1,2,KS,US,3,1948
OUTLANDER 450,2021-05-24,2,10,KS,US,12,1749
OUTLANDER 1000,2021-05-31,14,2,KS,US,16,2024
OUTLANDER 850,2021-05-31,15,10,KS,US,25,1973
OUTLANDER 450,2021-05-31,9,11,KS,US,20,1769
OUTLANDER 1000,2021-06-07,5,1,KS,US,6,2030
OUTLANDER 850,2021-06-07,0,11,KS,US,11,1984
OUTLANDER 450,2021-06-07,7,14,KS,US,21,1790
OUTLANDER 1000,2021-06-14,8,1,KS,US,9,2039
OUTLANDER 850,2021-06-14,5,1,KS,US,6,1990
OUTLANDER 450,2021-06-14,11,5,KS,US,16,1806
OUTLANDER 1000,2021-06-21,13,9,KS,US,22,2061
OUTLANDER 850,2021-06-21,9,13,KS,US,22,2012
OUTLANDER 450,2021-06-21,12,13,KS,US,25,1831
OUTLANDER 1000,2021-06-28,9,3,KS,US,12,2073
OUTLANDER 850,2021-06-28,3,2,KS,US,5,2017
OUTLANDER 450,2021-06-28,7,13,KS,US,20,1851
OUTLANDER 1000,2021-07-05,5,10,KS,US,15,2088
OUTLANDER 850,2021-07-05,11,1,KS,US,12,2029
OUTLANDER 450,2021-07-05,4,4,KS,US,8,1859
OUTLANDER 1000,2021-07-12,14,1,KS,US,15,2103
OUTLANDER 850,2021-07-12,6,9,KS,US,15,2044
OUTLANDER 450,2021-07-12,10,10,KS,US,20,1879
OUTLANDER 1000,2021-07-19,5,6,KS,US,11,2114
OUTLANDER 850,2021-07-19,4,5,KS,US,9,2053
OUTLANDER 450,2021-07-19,12,4,KS,US,16,1895
OUTLANDER 1000,2021-07-26,9,2,KS,US,11,2125
OUTLANDER 850,2021-07-26,13,11,KS,US,24,2077
OUTLANDER 450,2021-07-26,6,13,KS,US,19,1914
OUTLANDER 1000,2021-08-02,4,6,KS,US,10,2135
OUTLANDER 850,2021-08-02,11,2,KS,US,13,2090
OUTLANDER 450,2021-08-02,10,7,KS,US,17,1931
OUTLANDER 1000,2021-08-09,1,11,KS,US,12,2147
OUTLANDER 850,2021-08-09,13,8,KS,US,21,2111
OUTLANDER 450,2021-08-09,2,0,KS,US,2,1933
OUTLANDER 1000,2021-08-16,15,4,KS,US,19,2166
OUTLANDER 850,2021-08-16,9,3,KS,US,12,2123
OUTLANDER 450,2021-08-16,12,9,KS,US,21,1954
OUTLANDER 1000,2021-08-23,9,1,KS,US,10,2176
OUTLANDER 850,2021-08-23,15,13,KS,US,28,2151
OUTLANDER 450,2021-08-23,3,9,KS,US,12,1966
OUTLANDER 1000,2021-08-30,1,0,KS,US,1,2177
OUTLANDER 850,2021-08-30,8,5,KS,US,13,2164
OUTLANDER 450,2021-08-30,10,3,KS,US,13,1979
OUTLANDER 1000,2021-09-06,6,2,KS,US,8,2185
OUTLANDER 850,2021-09-06,5,3,KS,US,8,2172
OUTLANDER 450,2021-09-06,11,4,KS,US,15,1994
OUTLANDER 1000,2021-09-13,10,8,KS,US,18,2203
OUTLANDER 850,2021-09-13,13,4,KS,US,17,2189
OUTLANDER 450,2021-09-13,3,2,KS,US,5,1999
OUTLANDER 1000,2021-09-20,15,12,KS,US,27,2230
OUTLANDER 850,2021-09-20,5,7,KS,US,12,2201
OUTLANDER 450,2021-09-20,2,13,KS,US,15,2014
OUTLANDER 1000,2021-09-27,2,15,KS,US,17,2247
OUTLANDER 850,2021-09-27,11,1,KS,US,12,2213
OUTLANDER 450,2021-09-27,10,4,KS,US,14,2028
OUTLANDER 1000,2021-10-04,1,7,KS,US,8,2255
OUTLANDER 850,2021-10-04,5,7,KS,US,12,2225
OUTLANDER 450,2021-10-04,15,8,KS,US,23,2051
OUTLANDER 1000,2021-10-11,3,6,KS,US,9,2264
OUTLANDER 850,2021-10-11,2,4,KS,US,6,2231
OUTLANDER 450,2021-10-11,11,6,KS,US,17,2068
OUTLANDER 1000,2021-10-18,11,5,KS,US,16,2280
OUTLANDER 850,2021-10-18,12,6,KS,US,18,2249
OUTLANDER 450,2021-10-18,4,1,KS,US,5,2073
OUTLANDER 1000,2021-10-25,12,9,KS,US,21,2301
OUTLANDER 850,2021-10-25,15,9,KS,US,24,2273
OUTLANDER 450,2021-10-25,6,4,KS,US,10,2083
OUTLANDER 1000,2021-11-01,10,1,KS,US,11,2312
OUTLANDER 850,2021-11-01,3,4,KS,US,7,2280
OUTLANDER 450,2021-11-01,11,4,KS,US,15,2098
OUTLANDER 1000,2021-11-08,1,4,KS,US,5,2317
OUTLANDER 850,2021-11-08,1,14,KS,US,15,2295
OUTLANDER 450,2021-11-08,8,6,KS,US,14,2112
OUTLANDER 1000,2021-11-15,6,2,KS,US,8,2325
OUTLANDER 850,2021-11-15,15,0,KS,US,15,2310
OUTLANDER 450,2021-11-15,11,7,KS,US,18,2130
OUTLANDER 1000,2021-11-22,1,12,KS,US,13,2338
OUTLANDER 850,2021-11-22,10,9,KS,US,19,2329
OUTLANDER 450,2021-11-22,1,0,KS,US,1,2131
OUTLANDER 1000,2021-11-29,4,2,KS,US,6,2344
OUTLANDER 850,2021-11-29,4,5,KS,US,9,2338
OUTLANDER 450,2021-11-29,3,4,KS,US,7,2138
OUTLANDER 1000,2021-12-06,14,5,KS,US,19,2363
OUTLANDER 850,2021-12-06,7,2,KS,US,9,2347
OUTLANDER 450,2021-12-06,9,9,KS,US,18,2156
OUTLANDER 1000,2021-12-13,10,8,KS,US,18,2381
OUTLANDER 850,2021-12-13,4,1,KS,US,5,2352
OUTLANDER 450,2021-12-13,13,9,KS,US,22,2178
OUTLANDER 1000,2021-12-20,3,1,KS,US,4,2385
OUTLANDER 850,2021-12-20,9,5,KS,US,14,2366
OUTLANDER 450,2021-12-20,7,11,KS,US,18,2196
OUTLANDER 1000,2021-12-27,14,8,KS,US,22,2407
OUTLANDER 850,2021-12-27,10,10,KS,US,20,2386
OUTLANDER 450,2021-12-27,6,5,KS,US,11,2207
OUTLANDER 1000,2019-01-07,4,11,KY,US,15,15
OUTLANDER 850,2019-01-07,10,6,KY,US,16,16
OUTLANDER 450,2019-01-07,13,2,KY,US,15,15
OUTLANDER 1000,2019-01-14,11,7,KY,US,18,33
OUTLANDER 850,2019-01-14,8,13,KY,US,21,37
OUTLANDER 450,2019-01-14,13,14,KY,US,27,42
OUTLANDER 1000,2019-01-21,8,12,KY,US,20,53
OUTLANDER 850,2019-01-21,11,3,KY,US,14,51
OUTLANDER 450,2019-01-21,12,5,KY,US,17,59
OUTLANDER 1000,2019-01-28,12,11,KY,US,23,76
OUTLANDER 850,2019-01-28,8,12,KY,US,20,71
OUTLANDER 450,2019-01-28,9,7,KY,US,16,75
OUTLANDER 1000,2019-02-04,11,7,KY,US,18,94
OUTLANDER 850,2019-02-04,2,10,KY,US,12,83
OUTLANDER 450,2019-02-04,8,5,KY,US,13,88
OUTLANDER 1000,2019-02-11,1,13,KY,US,14,108
OUTLANDER 850,2019-02-11,14,7,KY,US,21,104
OUTLANDER 450,2019-02-11,6,0,KY,US,6,94
OUTLANDER 1000,2019-02-18,13,2,KY,US,15,123
OUTLANDER 850,2019-02-18,1,6,KY,US,7,111
OUTLANDER 450,2019-02-18,3,5,KY,US,8,102
OUTLANDER 1000,2019-02-25,2,14,KY,US,16,139
OUTLANDER 850,2019-02-25,8,1,KY,US,9,120
OUTLANDER 450,2019-02-25,10,12,KY,US,22,124
OUTLANDER 1000,2019-03-04,14,3,KY,US,17,156
OUTLANDER 850,2019-03-04,2,11,KY,US,13,133
OUTLANDER 450,2019-03-04,6,11,KY,US,17,141
OUTLANDER 1000,2019-03-11,14,4,KY,US,18,174
OUTLANDER 850,2019-03-11,10,5,KY,US,15,148
OUTLANDER 450,2019-03-11,2,7,KY,US,9,150
OUTLANDER 1000,2019-03-18,7,3,KY,US,10,184
OUTLANDER 850,2019-03-18,6,3,KY,US,9,157
OUTLANDER 450,2019-03-18,3,12,KY,US,15,165
OUTLANDER 1000,2019-03-25,11,4,KY,US,15,199
OUTLANDER 850,2019-03-25,6,14,KY,US,20,177
OUTLANDER 450,2019-03-25,1,4,KY,US,5,170
OUTLANDER 1000,2019-04-01,5,4,KY,US,9,208
OUTLANDER 850,2019-04-01,1,6,KY,US,7,184
OUTLANDER 450,2019-04-01,7,11,KY,US,18,188
OUTLANDER 1000,2019-04-08,8,1,KY,US,9,217
OUTLANDER 850,2019-04-08,12,3,KY,US,15,199
OUTLANDER 450,2019-04-08,5,1,KY,US,6,194
OUTLANDER 1000,2019-04-15,0,6,KY,US,6,223
OUTLANDER 850,2019-04-15,8,1,KY,US,9,208
OUTLANDER 450,2019-04-15,13,4,KY,US,17,211
OUTLANDER 1000,2019-04-22,0,4,KY,US,4,227
OUTLANDER 850,2019-04-22,10,10,KY,US,20,228
OUTLANDER 450,2019-04-22,14,4,KY,US,18,229
OUTLANDER 1000,2019-04-29,14,3,KY,US,17,244
OUTLANDER 850,2019-04-29,13,2,KY,US,15,243
OUTLANDER 450,2019-04-29,5,5,KY,US,10,239
OUTLANDER 1000,2019-05-06,11,11,KY,US,22,266
OUTLANDER 850,2019-05-06,4,6,KY,US,10,253
OUTLANDER 450,2019-05-06,6,5,KY,US,11,250
OUTLANDER 1000,2019-05-13,4,8,KY,US,12,278
OUTLANDER 850,2019-05-13,8,9,KY,US,17,270
OUTLANDER 450,2019-05-13,14,3,KY,US,17,267
OUTLANDER 1000,2019-05-20,13,11,KY,US,24,302
OUTLANDER 850,2019-05-20,4,9,KY,US,13,283
OUTLANDER 450,2019-05-20,3,5,KY,US,8,275
OUTLANDER 1000,2019-05-27,6,0,KY,US,6,308
OUTLANDER 850,2019-05-27,10,5,KY,US,15,298
OUTLANDER 450,2019-05-27,3,6,KY,US,9,284
OUTLANDER 1000,2019-06-03,4,10,KY,US,14,322
OUTLANDER 850,2019-06-03,12,8,KY,US,20,318
OUTLANDER 450,2019-06-03,9,0,KY,US,9,293
OUTLANDER 1000,2019-06-10,14,8,KY,US,22,344
OUTLANDER 850,2019-06-10,7,11,KY,US,18,336
OUTLANDER 450,2019-06-10,5,2,KY,US,7,300
OUTLANDER 1000,2019-06-17,13,14,KY,US,27,371
OUTLANDER 850,2019-06-17,3,14,KY,US,17,353
OUTLANDER 450,2019-06-17,1,6,KY,US,7,307
OUTLANDER 1000,2019-06-24,12,7,KY,US,19,390
OUTLANDER 850,2019-06-24,14,0,KY,US,14,367
OUTLANDER 450,2019-06-24,6,6,KY,US,12,319
OUTLANDER 1000,2019-07-01,11,14,KY,US,25,415
OUTLANDER 850,2019-07-01,1,2,KY,US,3,370
OUTLANDER 450,2019-07-01,12,13,KY,US,25,344
OUTLANDER 1000,2019-07-08,0,1,KY,US,1,416
OUTLANDER 850,2019-07-08,9,14,KY,US,23,393
OUTLANDER 450,2019-07-08,5,1,KY,US,6,350
OUTLANDER 1000,2019-07-15,8,5,KY,US,13,429
OUTLANDER 850,2019-07-15,5,12,KY,US,17,410
OUTLANDER 450,2019-07-15,14,13,KY,US,27,377
OUTLANDER 1000,2019-07-22,14,9,KY,US,23,452
OUTLANDER 850,2019-07-22,6,0,KY,US,6,416
OUTLANDER 450,2019-07-22,5,4,KY,US,9,386
OUTLANDER 1000,2019-07-29,9,10,KY,US,19,471
OUTLANDER 850,2019-07-29,4,10,KY,US,14,430
OUTLANDER 450,2019-07-29,2,11,KY,US,13,399
OUTLANDER 1000,2019-08-05,14,3,KY,US,17,488
OUTLANDER 850,2019-08-05,9,11,KY,US,20,450
OUTLANDER 450,2019-08-05,4,6,KY,US,10,409
OUTLANDER 1000,2019-08-12,10,3,KY,US,13,501
OUTLANDER 850,2019-08-12,6,5,KY,US,11,461
OUTLANDER 450,2019-08-12,1,4,KY,US,5,414
OUTLANDER 1000,2019-08-19,8,12,KY,US,20,521
OUTLANDER 850,2019-08-19,6,6,KY,US,12,473
OUTLANDER 450,2019-08-19,5,2,KY,US,7,421
OUTLANDER 1000,2019-08-26,9,8,KY,US,17,538
OUTLANDER 850,2019-08-26,8,10,KY,US,18,491
OUTLANDER 450,2019-08-26,4,12,KY,US,16,437
OUTLANDER 1000,2019-09-02,2,4,KY,US,6,544
OUTLANDER 850,2019-09-02,1,1,KY,US,2,493
OUTLANDER 450,2019-09-02,10,0,KY,US,10,447
OUTLANDER 1000,2019-09-09,7,12,KY,US,19,563
OUTLANDER 850,2019-09-09,13,14,KY,US,27,520
OUTLANDER 450,2019-09-09,11,3,KY,US,14,461
OUTLANDER 1000,2019-09-16,13,13,KY,US,26,589
OUTLANDER 850,2019-09-16,8,1,KY,US,9,529
OUTLANDER 450,2019-09-16,11,4,KY,US,15,476
OUTLANDER 1000,2019-09-23,3,3,KY,US,6,595
OUTLANDER 850,2019-09-23,8,12,KY,US,20,549
OUTLANDER 450,2019-09-23,14,14,KY,US,28,504
OUTLANDER 1000,2019-09-30,13,5,KY,US,18,613
OUTLANDER 850,2019-09-30,2,1,KY,US,3,552
OUTLANDER 450,2019-09-30,3,1,KY,US,4,508
OUTLANDER 1000,2019-10-07,14,8,KY,US,22,635
OUTLANDER 850,2019-10-07,7,10,KY,US,17,569
OUTLANDER 450,2019-10-07,3,3,KY,US,6,514
OUTLANDER 1000,2019-10-14,2,8,KY,US,10,645
OUTLANDER 850,2019-10-14,14,8,KY,US,22,591
OUTLANDER 450,2019-10-14,14,12,KY,US,26,540
OUTLANDER 1000,2019-10-21,12,8,KY,US,20,665
OUTLANDER 850,2019-10-21,13,1,KY,US,14,605
OUTLANDER 450,2019-10-21,13,11,KY,US,24,564
OUTLANDER 1000,2019-10-28,9,1,KY,US,10,675
OUTLANDER 850,2019-10-28,6,11,KY,US,17,622
OUTLANDER 450,2019-10-28,13,11,KY,US,24,588
OUTLANDER 1000,2019-11-04,14,7,KY,US,21,696
OUTLANDER 850,2019-11-04,13,4,KY,US,17,639
OUTLANDER 450,2019-11-04,6,5,KY,US,11,599
OUTLANDER 1000,2019-11-11,1,14,KY,US,15,711
OUTLANDER 850,2019-11-11,13,2,KY,US,15,654
OUTLANDER 450,2019-11-11,7,3,KY,US,10,609
OUTLANDER 1000,2019-11-18,7,3,KY,US,10,721
OUTLANDER 850,2019-11-18,13,2,KY,US,15,669
OUTLANDER 450,2019-11-18,5,15,KY,US,20,629
OUTLANDER 1000,2019-11-25,5,5,KY,US,10,731
OUTLANDER 850,2019-11-25,3,5,KY,US,8,677
OUTLANDER 450,2019-11-25,9,4,KY,US,13,642
OUTLANDER 1000,2019-12-02,14,9,KY,US,23,754
OUTLANDER 850,2019-12-02,2,2,KY,US,4,681
OUTLANDER 450,2019-12-02,5,10,KY,US,15,657
OUTLANDER 1000,2019-12-09,8,10,KY,US,18,772
OUTLANDER 850,2019-12-09,3,7,KY,US,10,691
OUTLANDER 450,2019-12-09,10,0,KY,US,10,667
OUTLANDER 1000,2019-12-16,10,2,KY,US,12,784
OUTLANDER 850,2019-12-16,12,13,KY,US,25,716
OUTLANDER 450,2019-12-16,8,11,KY,US,19,686
OUTLANDER 1000,2019-12-23,1,2,KY,US,3,787
OUTLANDER 850,2019-12-23,4,5,KY,US,9,725
OUTLANDER 450,2019-12-23,1,9,KY,US,10,696
OUTLANDER 1000,2019-12-30,10,13,KY,US,23,810
OUTLANDER 850,2019-12-30,9,13,KY,US,22,747
OUTLANDER 450,2019-12-30,3,10,KY,US,13,709
OUTLANDER 1000,2020-01-06,12,2,KY,US,14,824
OUTLANDER 850,2020-01-06,2,11,KY,US,13,760
OUTLANDER 450,2020-01-06,13,11,KY,US,24,733
OUTLANDER 1000,2020-01-13,1,12,KY,US,13,837
OUTLANDER 850,2020-01-13,12,1,KY,US,13,773
OUTLANDER 450,2020-01-13,15,6,KY,US,21,754
OUTLANDER 1000,2020-01-20,8,10,KY,US,18,855
OUTLANDER 850,2020-01-20,15,11,KY,US,26,799
OUTLANDER 450,2020-01-20,9,3,KY,US,12,766
OUTLANDER 1000,2020-01-27,1,13,KY,US,14,869
OUTLANDER 850,2020-01-27,14,2,KY,US,16,815
OUTLANDER 450,2020-01-27,14,9,KY,US,23,789
OUTLANDER 1000,2020-02-03,4,14,KY,US,18,887
OUTLANDER 850,2020-02-03,0,9,KY,US,9,824
OUTLANDER 450,2020-02-03,0,9,KY,US,9,798
OUTLANDER 1000,2020-02-10,6,5,KY,US,11,898
OUTLANDER 850,2020-02-10,10,10,KY,US,20,844
OUTLANDER 450,2020-02-10,10,7,KY,US,17,815
OUTLANDER 1000,2020-02-17,13,11,KY,US,24,922
OUTLANDER 850,2020-02-17,15,2,KY,US,17,861
OUTLANDER 450,2020-02-17,12,14,KY,US,26,841
OUTLANDER 1000,2020-02-24,13,5,KY,US,18,940
OUTLANDER 850,2020-02-24,9,1,KY,US,10,871
OUTLANDER 450,2020-02-24,7,12,KY,US,19,860
OUTLANDER 1000,2020-03-02,10,4,KY,US,14,954
OUTLANDER 850,2020-03-02,7,11,KY,US,18,889
OUTLANDER 450,2020-03-02,8,13,KY,US,21,881
OUTLANDER 1000,2020-03-09,12,8,KY,US,20,974
OUTLANDER 850,2020-03-09,10,15,KY,US,25,914
OUTLANDER 450,2020-03-09,8,13,KY,US,21,902
OUTLANDER 1000,2020-03-16,1,5,KY,US,6,980
OUTLANDER 850,2020-03-16,8,11,KY,US,19,933
OUTLANDER 450,2020-03-16,9,10,KY,US,19,921
OUTLANDER 1000,2020-03-23,6,10,KY,US,16,996
OUTLANDER 850,2020-03-23,4,13,KY,US,17,950
OUTLANDER 450,2020-03-23,12,12,KY,US,24,945
OUTLANDER 1000,2020-03-30,14,9,KY,US,23,1019
OUTLANDER 850,2020-03-30,1,9,KY,US,10,960
OUTLANDER 450,2020-03-30,11,6,KY,US,17,962
OUTLANDER 1000,2020-04-06,1,15,KY,US,16,1035
OUTLANDER 850,2020-04-06,1,10,KY,US,11,971
OUTLANDER 450,2020-04-06,14,4,KY,US,18,980
OUTLANDER 1000,2020-04-13,11,7,KY,US,18,1053
OUTLANDER 850,2020-04-13,11,8,KY,US,19,990
OUTLANDER 450,2020-04-13,14,11,KY,US,25,1005
OUTLANDER 1000,2020-04-20,5,12,KY,US,17,1070
OUTLANDER 850,2020-04-20,2,6,KY,US,8,998
OUTLANDER 450,2020-04-20,1,14,KY,US,15,1020
OUTLANDER 1000,2020-04-27,5,4,KY,US,9,1079
OUTLANDER 850,2020-04-27,3,9,KY,US,12,1010
OUTLANDER 450,2020-04-27,6,6,KY,US,12,1032
OUTLANDER 1000,2020-05-04,6,3,KY,US,9,1088
OUTLANDER 850,2020-05-04,3,11,KY,US,14,1024
OUTLANDER 450,2020-05-04,14,3,KY,US,17,1049
OUTLANDER 1000,2020-05-11,13,14,KY,US,27,1115
OUTLANDER 850,2020-05-11,9,15,KY,US,24,1048
OUTLANDER 450,2020-05-11,6,9,KY,US,15,1064
OUTLANDER 1000,2020-05-18,3,15,KY,US,18,1133
OUTLANDER 850,2020-05-18,14,5,KY,US,19,1067
OUTLANDER 450,2020-05-18,8,11,KY,US,19,1083
OUTLANDER 1000,2020-05-25,2,2,KY,US,4,1137
OUTLANDER 850,2020-05-25,9,10,KY,US,19,1086
OUTLANDER 450,2020-05-25,11,6,KY,US,17,1100
OUTLANDER 1000,2020-06-01,12,3,KY,US,15,1152
OUTLANDER 850,2020-06-01,11,14,KY,US,25,1111
OUTLANDER 450,2020-06-01,3,1,KY,US,4,1104
OUTLANDER 1000,2020-06-08,11,5,KY,US,16,1168
OUTLANDER 850,2020-06-08,11,14,KY,US,25,1136
OUTLANDER 450,2020-06-08,6,11,KY,US,17,1121
OUTLANDER 1000,2020-06-15,8,2,KY,US,10,1178
OUTLANDER 850,2020-06-15,1,14,KY,US,15,1151
OUTLANDER 450,2020-06-15,6,10,KY,US,16,1137
OUTLANDER 1000,2020-06-22,9,7,KY,US,16,1194
OUTLANDER 850,2020-06-22,7,14,KY,US,21,1172
OUTLANDER 450,2020-06-22,14,3,KY,US,17,1154
OUTLANDER 1000,2020-06-29,9,6,KY,US,15,1209
OUTLANDER 850,2020-06-29,13,2,KY,US,15,1187
OUTLANDER 450,2020-06-29,14,11,KY,US,25,1179
OUTLANDER 1000,2020-07-06,8,6,KY,US,14,1223
OUTLANDER 850,2020-07-06,7,10,KY,US,17,1204
OUTLANDER 450,2020-07-06,7,7,KY,US,14,1193
OUTLANDER 1000,2020-07-13,8,6,KY,US,14,1237
OUTLANDER 850,2020-07-13,14,6,KY,US,20,1224
OUTLANDER 450,2020-07-13,1,5,KY,US,6,1199
OUTLANDER 1000,2020-07-20,3,11,KY,US,14,1251
OUTLANDER 850,2020-07-20,10,10,KY,US,20,1244
OUTLANDER 450,2020-07-20,1,4,KY,US,5,1204
OUTLANDER 1000,2020-07-27,5,14,KY,US,19,1270
OUTLANDER 850,2020-07-27,8,5,KY,US,13,1257
OUTLANDER 450,2020-07-27,3,14,KY,US,17,1221
OUTLANDER 1000,2020-08-03,14,14,KY,US,28,1298
OUTLANDER 850,2020-08-03,10,15,KY,US,25,1282
OUTLANDER 450,2020-08-03,10,2,KY,US,12,1233
OUTLANDER 1000,2020-08-10,7,2,KY,US,9,1307
OUTLANDER 850,2020-08-10,3,9,KY,US,12,1294
OUTLANDER 450,2020-08-10,5,11,KY,US,16,1249
OUTLANDER 1000,2020-08-17,11,6,KY,US,17,1324
OUTLANDER 850,2020-08-17,10,13,KY,US,23,1317
OUTLANDER 450,2020-08-17,4,3,KY,US,7,1256
OUTLANDER 1000,2020-08-24,11,2,KY,US,13,1337
OUTLANDER 850,2020-08-24,14,15,KY,US,29,1346
OUTLANDER 450,2020-08-24,9,12,KY,US,21,1277
OUTLANDER 1000,2020-08-31,13,14,KY,US,27,1364
OUTLANDER 850,2020-08-31,12,6,KY,US,18,1364
OUTLANDER 450,2020-08-31,6,1,KY,US,7,1284
OUTLANDER 1000,2020-09-07,0,14,KY,US,14,1378
OUTLANDER 850,2020-09-07,6,10,KY,US,16,1380
OUTLANDER 450,2020-09-07,1,3,KY,US,4,1288
OUTLANDER 1000,2020-09-14,14,2,KY,US,16,1394
OUTLANDER 850,2020-09-14,12,11,KY,US,23,1403
OUTLANDER 450,2020-09-14,6,10,KY,US,16,1304
OUTLANDER 1000,2020-09-21,2,11,KY,US,13,1407
OUTLANDER 850,2020-09-21,9,11,KY,US,20,1423
OUTLANDER 450,2020-09-21,2,13,KY,US,15,1319
OUTLANDER 1000,2020-09-28,1,13,KY,US,14,1421
OUTLANDER 850,2020-09-28,10,8,KY,US,18,1441
OUTLANDER 450,2020-09-28,6,3,KY,US,9,1328
OUTLANDER 1000,2020-10-05,7,12,KY,US,19,1440
OUTLANDER 850,2020-10-05,10,10,KY,US,20,1461
OUTLANDER 450,2020-10-05,6,6,KY,US,12,1340
OUTLANDER 1000,2020-10-12,0,0,KY,US,0,1440
OUTLANDER 850,2020-10-12,5,13,KY,US,18,1479
OUTLANDER 450,2020-10-12,7,9,KY,US,16,1356
OUTLANDER 1000,2020-10-19,12,4,KY,US,16,1456
OUTLANDER 850,2020-10-19,6,4,KY,US,10,1489
OUTLANDER 450,2020-10-19,12,6,KY,US,18,1374
OUTLANDER 1000,2020-10-26,7,1,KY,US,8,1464
OUTLANDER 850,2020-10-26,10,6,KY,US,16,1505
OUTLANDER 450,2020-10-26,14,8,KY,US,22,1396
OUTLANDER 1000,2020-11-02,13,6,KY,US,19,1483
OUTLANDER 850,2020-11-02,10,8,KY,US,18,1523
OUTLANDER 450,2020-11-02,2,7,KY,US,9,1405
OUTLANDER 1000,2020-11-09,0,2,KY,US,2,1485
OUTLANDER 850,2020-11-09,11,10,KY,US,21,1544
OUTLANDER 450,2020-11-09,6,13,KY,US,19,1424
OUTLANDER 1000,2020-11-16,4,6,KY,US,10,1495
OUTLANDER 850,2020-11-16,3,1,KY,US,4,1548
OUTLANDER 450,2020-11-16,9,4,KY,US,13,1437
OUTLANDER 1000,2020-11-23,4,12,KY,US,16,1511
OUTLANDER 850,2020-11-23,10,14,KY,US,24,1572
OUTLANDER 450,2020-11-23,11,0,KY,US,11,1448
OUTLANDER 1000,2020-11-30,4,4,KY,US,8,1519
OUTLANDER 850,2020-11-30,1,14,KY,US,15,1587
OUTLANDER 450,2020-11-30,0,0,KY,US,0,1448
OUTLANDER 1000,2020-12-07,6,7,KY,US,13,1532
OUTLANDER 850,2020-12-07,2,5,KY,US,7,1594
OUTLANDER 450,2020-12-07,1,5,KY,US,6,1454
OUTLANDER 1000,2020-12-14,12,0,KY,US,12,1544
OUTLANDER 850,2020-12-14,0,7,KY,US,7,1601
OUTLANDER 450,2020-12-14,13,3,KY,US,16,1470
OUTLANDER 1000,2020-12-21,1,5,KY,US,6,1550
OUTLANDER 850,2020-12-21,10,6,KY,US,16,1617
OUTLANDER 450,2020-12-21,0,11,KY,US,11,1481
OUTLANDER 1000,2020-12-28,10,6,KY,US,16,1566
OUTLANDER 850,2020-12-28,15,9,KY,US,24,1641
OUTLANDER 450,2020-12-28,0,14,KY,US,14,1495
OUTLANDER 1000,2021-01-04,4,8,KY,US,12,1578
OUTLANDER 850,2021-01-04,9,2,KY,US,11,1652
OUTLANDER 450,2021-01-04,7,13,KY,US,20,1515
OUTLANDER 1000,2021-01-11,8,9,KY,US,17,1595
OUTLANDER 850,2021-01-11,15,11,KY,US,26,1678
OUTLANDER 450,2021-01-11,8,7,KY,US,15,1530
OUTLANDER 1000,2021-01-18,3,9,KY,US,12,1607
OUTLANDER 850,2021-01-18,2,11,KY,US,13,1691
OUTLANDER 450,2021-01-18,10,9,KY,US,19,1549
OUTLANDER 1000,2021-01-25,6,14,KY,US,20,1627
OUTLANDER 850,2021-01-25,10,2,KY,US,12,1703
OUTLANDER 450,2021-01-25,12,6,KY,US,18,1567
OUTLANDER 1000,2021-02-01,6,0,KY,US,6,1633
OUTLANDER 850,2021-02-01,7,12,KY,US,19,1722
OUTLANDER 450,2021-02-01,9,0,KY,US,9,1576
OUTLANDER 1000,2021-02-08,2,6,KY,US,8,1641
OUTLANDER 850,2021-02-08,6,11,KY,US,17,1739
OUTLANDER 450,2021-02-08,11,15,KY,US,26,1602
OUTLANDER 1000,2021-02-15,1,10,KY,US,11,1652
OUTLANDER 850,2021-02-15,14,6,KY,US,20,1759
OUTLANDER 450,2021-02-15,1,14,KY,US,15,1617
OUTLANDER 1000,2021-02-22,1,11,KY,US,12,1664
OUTLANDER 850,2021-02-22,8,11,KY,US,19,1778
OUTLANDER 450,2021-02-22,14,14,KY,US,28,1645
OUTLANDER 1000,2021-03-01,5,10,KY,US,15,1679
OUTLANDER 850,2021-03-01,2,3,KY,US,5,1783
OUTLANDER 450,2021-03-01,6,5,KY,US,11,1656
OUTLANDER 1000,2021-03-08,6,8,KY,US,14,1693
OUTLANDER 850,2021-03-08,10,10,KY,US,20,1803
OUTLANDER 450,2021-03-08,10,5,KY,US,15,1671
OUTLANDER 1000,2021-03-15,7,9,KY,US,16,1709
OUTLANDER 850,2021-03-15,11,1,KY,US,12,1815
OUTLANDER 450,2021-03-15,11,13,KY,US,24,1695
OUTLANDER 1000,2021-03-22,1,7,KY,US,8,1717
OUTLANDER 850,2021-03-22,12,5,KY,US,17,1832
OUTLANDER 450,2021-03-22,5,10,KY,US,15,1710
OUTLANDER 1000,2021-03-29,4,14,KY,US,18,1735
OUTLANDER 850,2021-03-29,6,4,KY,US,10,1842
OUTLANDER 450,2021-03-29,12,3,KY,US,15,1725
OUTLANDER 1000,2021-04-05,8,10,KY,US,18,1753
OUTLANDER 850,2021-04-05,3,13,KY,US,16,1858
OUTLANDER 450,2021-04-05,11,10,KY,US,21,1746
OUTLANDER 1000,2021-04-12,0,12,KY,US,12,1765
OUTLANDER 850,2021-04-12,10,5,KY,US,15,1873
OUTLANDER 450,2021-04-12,14,13,KY,US,27,1773
OUTLANDER 1000,2021-04-19,13,4,KY,US,17,1782
OUTLANDER 850,2021-04-19,10,2,KY,US,12,1885
OUTLANDER 450,2021-04-19,4,1,KY,US,5,1778
OUTLANDER 1000,2021-04-26,8,11,KY,US,19,1801
OUTLANDER 850,2021-04-26,8,12,KY,US,20,1905
OUTLANDER 450,2021-04-26,13,7,KY,US,20,1798
OUTLANDER 1000,2021-05-03,12,8,KY,US,20,1821
OUTLANDER 850,2021-05-03,11,5,KY,US,16,1921
OUTLANDER 450,2021-05-03,11,11,KY,US,22,1820
OUTLANDER 1000,2021-05-10,6,5,KY,US,11,1832
OUTLANDER 850,2021-05-10,2,3,KY,US,5,1926
OUTLANDER 450,2021-05-10,3,13,KY,US,16,1836
OUTLANDER 1000,2021-05-17,11,2,KY,US,13,1845
OUTLANDER 850,2021-05-17,11,8,KY,US,19,1945
OUTLANDER 450,2021-05-17,14,13,KY,US,27,1863
OUTLANDER 1000,2021-05-24,10,6,KY,US,16,1861
OUTLANDER 850,2021-05-24,6,6,KY,US,12,1957
OUTLANDER 450,2021-05-24,3,15,KY,US,18,1881
OUTLANDER 1000,2021-05-31,12,3,KY,US,15,1876
OUTLANDER 850,2021-05-31,3,1,KY,US,4,1961
OUTLANDER 450,2021-05-31,6,10,KY,US,16,1897
OUTLANDER 1000,2021-06-07,9,1,KY,US,10,1886
OUTLANDER 850,2021-06-07,5,0,KY,US,5,1966
OUTLANDER 450,2021-06-07,7,5,KY,US,12,1909
OUTLANDER 1000,2021-06-14,12,11,KY,US,23,1909
OUTLANDER 850,2021-06-14,14,11,KY,US,25,1991
OUTLANDER 450,2021-06-14,1,10,KY,US,11,1920
OUTLANDER 1000,2021-06-21,12,5,KY,US,17,1926
OUTLANDER 850,2021-06-21,10,9,KY,US,19,2010
OUTLANDER 450,2021-06-21,3,6,KY,US,9,1929
OUTLANDER 1000,2021-06-28,3,12,KY,US,15,1941
OUTLANDER 850,2021-06-28,10,2,KY,US,12,2022
OUTLANDER 450,2021-06-28,1,4,KY,US,5,1934
OUTLANDER 1000,2021-07-05,14,10,KY,US,24,1965
OUTLANDER 850,2021-07-05,1,2,KY,US,3,2025
OUTLANDER 450,2021-07-05,1,10,KY,US,11,1945
OUTLANDER 1000,2021-07-12,3,10,KY,US,13,1978
OUTLANDER 850,2021-07-12,8,9,KY,US,17,2042
OUTLANDER 450,2021-07-12,0,11,KY,US,11,1956
OUTLANDER 1000,2021-07-19,0,14,KY,US,14,1992
OUTLANDER 850,2021-07-19,13,11,KY,US,24,2066
OUTLANDER 450,2021-07-19,10,15,KY,US,25,1981
OUTLANDER 1000,2021-07-26,11,10,KY,US,21,2013
OUTLANDER 850,2021-07-26,7,10,KY,US,17,2083
OUTLANDER 450,2021-07-26,9,12,KY,US,21,2002
OUTLANDER 1000,2021-08-02,1,15,KY,US,16,2029
OUTLANDER 850,2021-08-02,12,14,KY,US,26,2109
OUTLANDER 450,2021-08-02,2,9,KY,US,11,2013
OUTLANDER 1000,2021-08-09,1,12,KY,US,13,2042
OUTLANDER 850,2021-08-09,2,14,KY,US,16,2125
OUTLANDER 450,2021-08-09,12,12,KY,US,24,2037
OUTLANDER 1000,2021-08-16,4,11,KY,US,15,2057
OUTLANDER 850,2021-08-16,5,2,KY,US,7,2132
OUTLANDER 450,2021-08-16,6,8,KY,US,14,2051
OUTLANDER 1000,2021-08-23,5,3,KY,US,8,2065
OUTLANDER 850,2021-08-23,1,15,KY,US,16,2148
OUTLANDER 450,2021-08-23,7,14,KY,US,21,2072
OUTLANDER 1000,2021-08-30,12,11,KY,US,23,2088
OUTLANDER 850,2021-08-30,1,6,KY,US,7,2155
OUTLANDER 450,2021-08-30,7,10,KY,US,17,2089
OUTLANDER 1000,2021-09-06,4,12,KY,US,16,2104
OUTLANDER 850,2021-09-06,1,14,KY,US,15,2170
OUTLANDER 450,2021-09-06,12,3,KY,US,15,2104
OUTLANDER 1000,2021-09-13,5,1,KY,US,6,2110
OUTLANDER 850,2021-09-13,13,12,KY,US,25,2195
OUTLANDER 450,2021-09-13,6,13,KY,US,19,2123
OUTLANDER 1000,2021-09-20,8,5,KY,US,13,2123
OUTLANDER 850,2021-09-20,7,6,KY,US,13,2208
OUTLANDER 450,2021-09-20,0,2,KY,US,2,2125
OUTLANDER 1000,2021-09-27,2,14,KY,US,16,2139
OUTLANDER 850,2021-09-27,10,1,KY,US,11,2219
OUTLANDER 450,2021-09-27,13,14,KY,US,27,2152
OUTLANDER 1000,2021-10-04,14,6,KY,US,20,2159
OUTLANDER 850,2021-10-04,14,10,KY,US,24,2243
OUTLANDER 450,2021-10-04,9,4,KY,US,13,2165
OUTLANDER 1000,2021-10-11,13,8,KY,US,21,2180
OUTLANDER 850,2021-10-11,11,1,KY,US,12,2255
OUTLANDER 450,2021-10-11,4,4,KY,US,8,2173
OUTLANDER 1000,2021-10-18,4,5,KY,US,9,2189
OUTLANDER 850,2021-10-18,2,2,KY,US,4,2259
OUTLANDER 450,2021-10-18,9,4,KY,US,13,2186
OUTLANDER 1000,2021-10-25,11,8,KY,US,19,2208
OUTLANDER 850,2021-10-25,13,3,KY,US,16,2275
OUTLANDER 450,2021-10-25,3,2,KY,US,5,2191
OUTLANDER 1000,2021-11-01,5,3,KY,US,8,2216
OUTLANDER 850,2021-11-01,12,2,KY,US,14,2289
OUTLANDER 450,2021-11-01,7,14,KY,US,21,2212
OUTLANDER 1000,2021-11-08,6,10,KY,US,16,2232
OUTLANDER 850,2021-11-08,14,6,KY,US,20,2309
OUTLANDER 450,2021-11-08,2,9,KY,US,11,2223
OUTLANDER 1000,2021-11-15,14,2,KY,US,16,2248
OUTLANDER 850,2021-11-15,13,8,KY,US,21,2330
OUTLANDER 450,2021-11-15,3,1,KY,US,4,2227
OUTLANDER 1000,2021-11-22,3,3,KY,US,6,2254
OUTLANDER 850,2021-11-22,3,0,KY,US,3,2333
OUTLANDER 450,2021-11-22,9,12,KY,US,21,2248
OUTLANDER 1000,2021-11-29,14,10,KY,US,24,2278
OUTLANDER 850,2021-11-29,4,11,KY,US,15,2348
OUTLANDER 450,2021-11-29,0,2,KY,US,2,2250
OUTLANDER 1000,2021-12-06,13,12,KY,US,25,2303
OUTLANDER 850,2021-12-06,5,7,KY,US,12,2360
OUTLANDER 450,2021-12-06,3,7,KY,US,10,2260
OUTLANDER 1000,2021-12-13,13,9,KY,US,22,2325
OUTLANDER 850,2021-12-13,5,14,KY,US,19,2379
OUTLANDER 450,2021-12-13,0,5,KY,US,5,2265
OUTLANDER 1000,2021-12-20,4,6,KY,US,10,2335
OUTLANDER 850,2021-12-20,10,8,KY,US,18,2397
OUTLANDER 450,2021-12-20,8,5,KY,US,13,2278
OUTLANDER 1000,2021-12-27,10,7,KY,US,17,2352
OUTLANDER 850,2021-12-27,4,4,KY,US,8,2405
OUTLANDER 450,2021-12-27,1,0,KY,US,1,2279
OUTLANDER 1000,2019-01-07,5,6,LA,US,11,11
OUTLANDER 850,2019-01-07,5,5,LA,US,10,10
OUTLANDER 450,2019-01-07,8,6,LA,US,14,14
OUTLANDER 1000,2019-01-14,8,11,LA,US,19,30
OUTLANDER 850,2019-01-14,14,7,LA,US,21,31
OUTLANDER 450,2019-01-14,1,15,LA,US,16,30
OUTLANDER 1000,2019-01-21,15,7,LA,US,22,52
OUTLANDER 850,2019-01-21,14,0,LA,US,14,45
OUTLANDER 450,2019-01-21,7,10,LA,US,17,47
OUTLANDER 1000,2019-01-28,8,11,LA,US,19,71
OUTLANDER 850,2019-01-28,7,6,LA,US,13,58
OUTLANDER 450,2019-01-28,6,9,LA,US,15,62
OUTLANDER 1000,2019-02-04,3,8,LA,US,11,82
OUTLANDER 850,2019-02-04,14,7,LA,US,21,79
OUTLANDER 450,2019-02-04,9,3,LA,US,12,74
OUTLANDER 1000,2019-02-11,1,5,LA,US,6,88
OUTLANDER 850,2019-02-11,6,8,LA,US,14,93
OUTLANDER 450,2019-02-11,6,2,LA,US,8,82
OUTLANDER 1000,2019-02-18,3,3,LA,US,6,94
OUTLANDER 850,2019-02-18,2,3,LA,US,5,98
OUTLANDER 450,2019-02-18,9,2,LA,US,11,93
OUTLANDER 1000,2019-02-25,7,12,LA,US,19,113
OUTLANDER 850,2019-02-25,5,14,LA,US,19,117
OUTLANDER 450,2019-02-25,5,13,LA,US,18,111
OUTLANDER 1000,2019-03-04,4,13,LA,US,17,130
OUTLANDER 850,2019-03-04,10,1,LA,US,11,128
OUTLANDER 450,2019-03-04,9,8,LA,US,17,128
OUTLANDER 1000,2019-03-11,10,6,LA,US,16,146
OUTLANDER 850,2019-03-11,7,0,LA,US,7,135
OUTLANDER 450,2019-03-11,3,4,LA,US,7,135
OUTLANDER 1000,2019-03-18,12,0,LA,US,12,158
OUTLANDER 850,2019-03-18,10,8,LA,US,18,153
OUTLANDER 450,2019-03-18,14,3,LA,US,17,152
OUTLANDER 1000,2019-03-25,4,14,LA,US,18,176
OUTLANDER 850,2019-03-25,1,10,LA,US,11,164
OUTLANDER 450,2019-03-25,13,8,LA,US,21,173
OUTLANDER 1000,2019-04-01,5,8,LA,US,13,189
OUTLANDER 850,2019-04-01,14,4,LA,US,18,182
OUTLANDER 450,2019-04-01,13,10,LA,US,23,196
OUTLANDER 1000,2019-04-08,3,5,LA,US,8,197
OUTLANDER 850,2019-04-08,8,8,LA,US,16,198
OUTLANDER 450,2019-04-08,15,13,LA,US,28,224
OUTLANDER 1000,2019-04-15,1,7,LA,US,8,205
OUTLANDER 850,2019-04-15,15,1,LA,US,16,214
OUTLANDER 450,2019-04-15,13,5,LA,US,18,242
OUTLANDER 1000,2019-04-22,4,11,LA,US,15,220
OUTLANDER 850,2019-04-22,10,12,LA,US,22,236
OUTLANDER 450,2019-04-22,2,1,LA,US,3,245
OUTLANDER 1000,2019-04-29,1,7,LA,US,8,228
OUTLANDER 850,2019-04-29,4,10,LA,US,14,250
OUTLANDER 450,2019-04-29,4,9,LA,US,13,258
OUTLANDER 1000,2019-05-06,12,3,LA,US,15,243
OUTLANDER 850,2019-05-06,10,6,LA,US,16,266
OUTLANDER 450,2019-05-06,14,12,LA,US,26,284
OUTLANDER 1000,2019-05-13,13,0,LA,US,13,256
OUTLANDER 850,2019-05-13,15,1,LA,US,16,282
OUTLANDER 450,2019-05-13,10,9,LA,US,19,303
OUTLANDER 1000,2019-05-20,9,4,LA,US,13,269
OUTLANDER 850,2019-05-20,5,7,LA,US,12,294
OUTLANDER 450,2019-05-20,4,1,LA,US,5,308
OUTLANDER 1000,2019-05-27,8,13,LA,US,21,290
OUTLANDER 850,2019-05-27,4,7,LA,US,11,305
OUTLANDER 450,2019-05-27,10,11,LA,US,21,329
OUTLANDER 1000,2019-06-03,9,2,LA,US,11,301
OUTLANDER 850,2019-06-03,13,12,LA,US,25,330
OUTLANDER 450,2019-06-03,11,14,LA,US,25,354
OUTLANDER 1000,2019-06-10,12,7,LA,US,19,320
OUTLANDER 850,2019-06-10,10,14,LA,US,24,354
OUTLANDER 450,2019-06-10,8,13,LA,US,21,375
OUTLANDER 1000,2019-06-17,3,10,LA,US,13,333
OUTLANDER 850,2019-06-17,5,12,LA,US,17,371
OUTLANDER 450,2019-06-17,8,12,LA,US,20,395
OUTLANDER 1000,2019-06-24,10,0,LA,US,10,343
OUTLANDER 850,2019-06-24,1,11,LA,US,12,383
OUTLANDER 450,2019-06-24,0,8,LA,US,8,403
OUTLANDER 1000,2019-07-01,1,6,LA,US,7,350
OUTLANDER 850,2019-07-01,4,6,LA,US,10,393
OUTLANDER 450,2019-07-01,14,1,LA,US,15,418
OUTLANDER 1000,2019-07-08,6,6,LA,US,12,362
OUTLANDER 850,2019-07-08,3,4,LA,US,7,400
OUTLANDER 450,2019-07-08,8,6,LA,US,14,432
OUTLANDER 1000,2019-07-15,2,12,LA,US,14,376
OUTLANDER 850,2019-07-15,11,8,LA,US,19,419
OUTLANDER 450,2019-07-15,3,3,LA,US,6,438
OUTLANDER 1000,2019-07-22,14,8,LA,US,22,398
OUTLANDER 850,2019-07-22,1,3,LA,US,4,423
OUTLANDER 450,2019-07-22,14,6,LA,US,20,458
OUTLANDER 1000,2019-07-29,14,4,LA,US,18,416
OUTLANDER 850,2019-07-29,12,1,LA,US,13,436
OUTLANDER 450,2019-07-29,1,11,LA,US,12,470
OUTLANDER 1000,2019-08-05,3,5,LA,US,8,424
OUTLANDER 850,2019-08-05,10,12,LA,US,22,458
OUTLANDER 450,2019-08-05,4,4,LA,US,8,478
OUTLANDER 1000,2019-08-12,14,7,LA,US,21,445
OUTLANDER 850,2019-08-12,7,11,LA,US,18,476
OUTLANDER 450,2019-08-12,7,12,LA,US,19,497
OUTLANDER 1000,2019-08-19,5,8,LA,US,13,458
OUTLANDER 850,2019-08-19,12,14,LA,US,26,502
OUTLANDER 450,2019-08-19,9,6,LA,US,15,512
OUTLANDER 1000,2019-08-26,5,9,LA,US,14,472
OUTLANDER 850,2019-08-26,7,4,LA,US,11,513
OUTLANDER 450,2019-08-26,6,5,LA,US,11,523
OUTLANDER 1000,2019-09-02,13,0,LA,US,13,485
OUTLANDER 850,2019-09-02,6,4,LA,US,10,523
OUTLANDER 450,2019-09-02,13,10,LA,US,23,546
OUTLANDER 1000,2019-09-09,11,9,LA,US,20,505
OUTLANDER 850,2019-09-09,0,10,LA,US,10,533
OUTLANDER 450,2019-09-09,12,0,LA,US,12,558
OUTLANDER 1000,2019-09-16,12,2,LA,US,14,519
OUTLANDER 850,2019-09-16,10,3,LA,US,13,546
OUTLANDER 450,2019-09-16,7,0,LA,US,7,565
OUTLANDER 1000,2019-09-23,13,7,LA,US,20,539
OUTLANDER 850,2019-09-23,12,6,LA,US,18,564
OUTLANDER 450,2019-09-23,11,6,LA,US,17,582
OUTLANDER 1000,2019-09-30,12,4,LA,US,16,555
OUTLANDER 850,2019-09-30,4,3,LA,US,7,571
OUTLANDER 450,2019-09-30,7,14,LA,US,21,603
OUTLANDER 1000,2019-10-07,1,3,LA,US,4,559
OUTLANDER 850,2019-10-07,4,7,LA,US,11,582
OUTLANDER 450,2019-10-07,3,6,LA,US,9,612
OUTLANDER 1000,2019-10-14,14,8,LA,US,22,581
OUTLANDER 850,2019-10-14,1,0,LA,US,1,583
OUTLANDER 450,2019-10-14,4,11,LA,US,15,627
OUTLANDER 1000,2019-10-21,7,11,LA,US,18,599
OUTLANDER 850,2019-10-21,9,8,LA,US,17,600
OUTLANDER 450,2019-10-21,9,13,LA,US,22,649
OUTLANDER 1000,2019-10-28,9,8,LA,US,17,616
OUTLANDER 850,2019-10-28,7,9,LA,US,16,616
OUTLANDER 450,2019-10-28,3,11,LA,US,14,663
OUTLANDER 1000,2019-11-04,13,8,LA,US,21,637
OUTLANDER 850,2019-11-04,3,7,LA,US,10,626
OUTLANDER 450,2019-11-04,3,11,LA,US,14,677
OUTLANDER 1000,2019-11-11,3,6,LA,US,9,646
OUTLANDER 850,2019-11-11,1,10,LA,US,11,637
OUTLANDER 450,2019-11-11,8,9,LA,US,17,694
OUTLANDER 1000,2019-11-18,1,10,LA,US,11,657
OUTLANDER 850,2019-11-18,4,1,LA,US,5,642
OUTLANDER 450,2019-11-18,1,1,LA,US,2,696
OUTLANDER 1000,2019-11-25,15,11,LA,US,26,683
OUTLANDER 850,2019-11-25,14,9,LA,US,23,665
OUTLANDER 450,2019-11-25,8,10,LA,US,18,714
OUTLANDER 1000,2019-12-02,4,12,LA,US,16,699
OUTLANDER 850,2019-12-02,5,3,LA,US,8,673
OUTLANDER 450,2019-12-02,6,15,LA,US,21,735
OUTLANDER 1000,2019-12-09,1,1,LA,US,2,701
OUTLANDER 850,2019-12-09,9,7,LA,US,16,689
OUTLANDER 450,2019-12-09,0,15,LA,US,15,750
OUTLANDER 1000,2019-12-16,2,9,LA,US,11,712
OUTLANDER 850,2019-12-16,3,8,LA,US,11,700
OUTLANDER 450,2019-12-16,4,5,LA,US,9,759
OUTLANDER 1000,2019-12-23,8,8,LA,US,16,728
OUTLANDER 850,2019-12-23,15,13,LA,US,28,728
OUTLANDER 450,2019-12-23,7,11,LA,US,18,777
OUTLANDER 1000,2019-12-30,15,5,LA,US,20,748
OUTLANDER 850,2019-12-30,10,6,LA,US,16,744
OUTLANDER 450,2019-12-30,13,6,LA,US,19,796
OUTLANDER 1000,2020-01-06,12,12,LA,US,24,772
OUTLANDER 850,2020-01-06,4,9,LA,US,13,757
OUTLANDER 450,2020-01-06,12,0,LA,US,12,808
OUTLANDER 1000,2020-01-13,5,9,LA,US,14,786
OUTLANDER 850,2020-01-13,7,13,LA,US,20,777
OUTLANDER 450,2020-01-13,8,5,LA,US,13,821
OUTLANDER 1000,2020-01-20,4,7,LA,US,11,797
OUTLANDER 850,2020-01-20,8,1,LA,US,9,786
OUTLANDER 450,2020-01-20,14,10,LA,US,24,845
OUTLANDER 1000,2020-01-27,15,4,LA,US,19,816
OUTLANDER 850,2020-01-27,11,1,LA,US,12,798
OUTLANDER 450,2020-01-27,3,8,LA,US,11,856
OUTLANDER 1000,2020-02-03,2,9,LA,US,11,827
OUTLANDER 850,2020-02-03,8,7,LA,US,15,813
OUTLANDER 450,2020-02-03,14,9,LA,US,23,879
OUTLANDER 1000,2020-02-10,5,7,LA,US,12,839
OUTLANDER 850,2020-02-10,11,8,LA,US,19,832
OUTLANDER 450,2020-02-10,12,15,LA,US,27,906
OUTLANDER 1000,2020-02-17,3,10,LA,US,13,852
OUTLANDER 850,2020-02-17,8,13,LA,US,21,853
OUTLANDER 450,2020-02-17,12,14,LA,US,26,932
OUTLANDER 1000,2020-02-24,14,5,LA,US,19,871
OUTLANDER 850,2020-02-24,8,6,LA,US,14,867
OUTLANDER 450,2020-02-24,14,14,LA,US,28,960
OUTLANDER 1000,2020-03-02,14,0,LA,US,14,885
OUTLANDER 850,2020-03-02,7,14,LA,US,21,888
OUTLANDER 450,2020-03-02,15,15,LA,US,30,990
OUTLANDER 1000,2020-03-09,9,2,LA,US,11,896
OUTLANDER 850,2020-03-09,3,3,LA,US,6,894
OUTLANDER 450,2020-03-09,0,3,LA,US,3,993
OUTLANDER 1000,2020-03-16,9,7,LA,US,16,912
OUTLANDER 850,2020-03-16,2,3,LA,US,5,899
OUTLANDER 450,2020-03-16,6,14,LA,US,20,1013
OUTLANDER 1000,2020-03-23,8,13,LA,US,21,933
OUTLANDER 850,2020-03-23,11,10,LA,US,21,920
OUTLANDER 450,2020-03-23,6,11,LA,US,17,1030
OUTLANDER 1000,2020-03-30,11,1,LA,US,12,945
OUTLANDER 850,2020-03-30,11,13,LA,US,24,944
OUTLANDER 450,2020-03-30,6,12,LA,US,18,1048
OUTLANDER 1000,2020-04-06,4,11,LA,US,15,960
OUTLANDER 850,2020-04-06,3,13,LA,US,16,960
OUTLANDER 450,2020-04-06,6,2,LA,US,8,1056
OUTLANDER 1000,2020-04-13,9,0,LA,US,9,969
OUTLANDER 850,2020-04-13,7,3,LA,US,10,970
OUTLANDER 450,2020-04-13,6,11,LA,US,17,1073
OUTLANDER 1000,2020-04-20,15,11,LA,US,26,995
OUTLANDER 850,2020-04-20,13,9,LA,US,22,992
OUTLANDER 450,2020-04-20,8,4,LA,US,12,1085
OUTLANDER 1000,2020-04-27,2,11,LA,US,13,1008
OUTLANDER 850,2020-04-27,7,11,LA,US,18,1010
OUTLANDER 450,2020-04-27,4,14,LA,US,18,1103
OUTLANDER 1000,2020-05-04,4,4,LA,US,8,1016
OUTLANDER 850,2020-05-04,11,10,LA,US,21,1031
OUTLANDER 450,2020-05-04,0,14,LA,US,14,1117
OUTLANDER 1000,2020-05-11,13,10,LA,US,23,1039
OUTLANDER 850,2020-05-11,8,8,LA,US,16,1047
OUTLANDER 450,2020-05-11,12,3,LA,US,15,1132
OUTLANDER 1000,2020-05-18,7,1,LA,US,8,1047
OUTLANDER 850,2020-05-18,8,14,LA,US,22,1069
OUTLANDER 450,2020-05-18,2,10,LA,US,12,1144
OUTLANDER 1000,2020-05-25,13,3,LA,US,16,1063
OUTLANDER 850,2020-05-25,14,12,LA,US,26,1095
OUTLANDER 450,2020-05-25,5,13,LA,US,18,1162
OUTLANDER 1000,2020-06-01,10,3,LA,US,13,1076
OUTLANDER 850,2020-06-01,10,3,LA,US,13,1108
OUTLANDER 450,2020-06-01,9,6,LA,US,15,1177
OUTLANDER 1000,2020-06-08,4,6,LA,US,10,1086
OUTLANDER 850,2020-06-08,14,5,LA,US,19,1127
OUTLANDER 450,2020-06-08,13,4,LA,US,17,1194
OUTLANDER 1000,2020-06-15,5,15,LA,US,20,1106
OUTLANDER 850,2020-06-15,7,0,LA,US,7,1134
OUTLANDER 450,2020-06-15,6,7,LA,US,13,1207
OUTLANDER 1000,2020-06-22,4,9,LA,US,13,1119
OUTLANDER 850,2020-06-22,10,9,LA,US,19,1153
OUTLANDER 450,2020-06-22,7,6,LA,US,13,1220
OUTLANDER 1000,2020-06-29,9,8,LA,US,17,1136
OUTLANDER 850,2020-06-29,4,8,LA,US,12,1165
OUTLANDER 450,2020-06-29,0,4,LA,US,4,1224
OUTLANDER 1000,2020-07-06,6,9,LA,US,15,1151
OUTLANDER 850,2020-07-06,13,12,LA,US,25,1190
OUTLANDER 450,2020-07-06,5,1,LA,US,6,1230
OUTLANDER 1000,2020-07-13,12,9,LA,US,21,1172
OUTLANDER 850,2020-07-13,12,14,LA,US,26,1216
OUTLANDER 450,2020-07-13,1,1,LA,US,2,1232
OUTLANDER 1000,2020-07-20,13,3,LA,US,16,1188
OUTLANDER 850,2020-07-20,6,12,LA,US,18,1234
OUTLANDER 450,2020-07-20,14,8,LA,US,22,1254
OUTLANDER 1000,2020-07-27,11,6,LA,US,17,1205
OUTLANDER 850,2020-07-27,5,6,LA,US,11,1245
OUTLANDER 450,2020-07-27,5,9,LA,US,14,1268
OUTLANDER 1000,2020-08-03,11,15,LA,US,26,1231
OUTLANDER 850,2020-08-03,13,11,LA,US,24,1269
OUTLANDER 450,2020-08-03,10,11,LA,US,21,1289
OUTLANDER 1000,2020-08-10,12,12,LA,US,24,1255
OUTLANDER 850,2020-08-10,8,6,LA,US,14,1283
OUTLANDER 450,2020-08-10,3,7,LA,US,10,1299
OUTLANDER 1000,2020-08-17,9,9,LA,US,18,1273
OUTLANDER 850,2020-08-17,0,11,LA,US,11,1294
OUTLANDER 450,2020-08-17,9,8,LA,US,17,1316
OUTLANDER 1000,2020-08-24,7,6,LA,US,13,1286
OUTLANDER 850,2020-08-24,3,12,LA,US,15,1309
OUTLANDER 450,2020-08-24,14,13,LA,US,27,1343
OUTLANDER 1000,2020-08-31,5,3,LA,US,8,1294
OUTLANDER 850,2020-08-31,13,5,LA,US,18,1327
OUTLANDER 450,2020-08-31,9,13,LA,US,22,1365
OUTLANDER 1000,2020-09-07,6,1,LA,US,7,1301
OUTLANDER 850,2020-09-07,7,1,LA,US,8,1335
OUTLANDER 450,2020-09-07,8,12,LA,US,20,1385
OUTLANDER 1000,2020-09-14,4,0,LA,US,4,1305
OUTLANDER 850,2020-09-14,8,8,LA,US,16,1351
OUTLANDER 450,2020-09-14,10,6,LA,US,16,1401
OUTLANDER 1000,2020-09-21,6,10,LA,US,16,1321
OUTLANDER 850,2020-09-21,2,13,LA,US,15,1366
OUTLANDER 450,2020-09-21,13,7,LA,US,20,1421
OUTLANDER 1000,2020-09-28,9,5,LA,US,14,1335
OUTLANDER 850,2020-09-28,2,2,LA,US,4,1370
OUTLANDER 450,2020-09-28,4,6,LA,US,10,1431
OUTLANDER 1000,2020-10-05,7,1,LA,US,8,1343
OUTLANDER 850,2020-10-05,9,7,LA,US,16,1386
OUTLANDER 450,2020-10-05,12,7,LA,US,19,1450
OUTLANDER 1000,2020-10-12,4,12,LA,US,16,1359
OUTLANDER 850,2020-10-12,7,8,LA,US,15,1401
OUTLANDER 450,2020-10-12,4,9,LA,US,13,1463
OUTLANDER 1000,2020-10-19,10,1,LA,US,11,1370
OUTLANDER 850,2020-10-19,0,9,LA,US,9,1410
OUTLANDER 450,2020-10-19,1,15,LA,US,16,1479
OUTLANDER 1000,2020-10-26,10,5,LA,US,15,1385
OUTLANDER 850,2020-10-26,4,1,LA,US,5,1415
OUTLANDER 450,2020-10-26,10,5,LA,US,15,1494
OUTLANDER 1000,2020-11-02,7,9,LA,US,16,1401
OUTLANDER 850,2020-11-02,6,4,LA,US,10,1425
OUTLANDER 450,2020-11-02,3,9,LA,US,12,1506
OUTLANDER 1000,2020-11-09,6,15,LA,US,21,1422
OUTLANDER 850,2020-11-09,6,9,LA,US,15,1440
OUTLANDER 450,2020-11-09,5,4,LA,US,9,1515
OUTLANDER 1000,2020-11-16,2,2,LA,US,4,1426
OUTLANDER 850,2020-11-16,10,8,LA,US,18,1458
OUTLANDER 450,2020-11-16,1,4,LA,US,5,1520
OUTLANDER 1000,2020-11-23,7,5,LA,US,12,1438
OUTLANDER 850,2020-11-23,4,14,LA,US,18,1476
OUTLANDER 450,2020-11-23,13,9,LA,US,22,1542
OUTLANDER 1000,2020-11-30,1,12,LA,US,13,1451
OUTLANDER 850,2020-11-30,5,5,LA,US,10,1486
OUTLANDER 450,2020-11-30,9,8,LA,US,17,1559
OUTLANDER 1000,2020-12-07,5,8,LA,US,13,1464
OUTLANDER 850,2020-12-07,12,10,LA,US,22,1508
OUTLANDER 450,2020-12-07,15,14,LA,US,29,1588
OUTLANDER 1000,2020-12-14,7,8,LA,US,15,1479
OUTLANDER 850,2020-12-14,13,8,LA,US,21,1529
OUTLANDER 450,2020-12-14,12,6,LA,US,18,1606
OUTLANDER 1000,2020-12-21,9,9,LA,US,18,1497
OUTLANDER 850,2020-12-21,2,2,LA,US,4,1533
OUTLANDER 450,2020-12-21,14,6,LA,US,20,1626
OUTLANDER 1000,2020-12-28,14,12,LA,US,26,1523
OUTLANDER 850,2020-12-28,1,10,LA,US,11,1544
OUTLANDER 450,2020-12-28,8,8,LA,US,16,1642
OUTLANDER 1000,2021-01-04,6,5,LA,US,11,1534
OUTLANDER 850,2021-01-04,2,14,LA,US,16,1560
OUTLANDER 450,2021-01-04,9,8,LA,US,17,1659
OUTLANDER 1000,2021-01-11,1,4,LA,US,5,1539
OUTLANDER 850,2021-01-11,11,3,LA,US,14,1574
OUTLANDER 450,2021-01-11,9,11,LA,US,20,1679
OUTLANDER 1000,2021-01-18,5,15,LA,US,20,1559
OUTLANDER 850,2021-01-18,10,12,LA,US,22,1596
OUTLANDER 450,2021-01-18,8,4,LA,US,12,1691
OUTLANDER 1000,2021-01-25,13,13,LA,US,26,1585
OUTLANDER 850,2021-01-25,12,15,LA,US,27,1623
OUTLANDER 450,2021-01-25,1,5,LA,US,6,1697
OUTLANDER 1000,2021-02-01,2,11,LA,US,13,1598
OUTLANDER 850,2021-02-01,10,4,LA,US,14,1637
OUTLANDER 450,2021-02-01,7,10,LA,US,17,1714
OUTLANDER 1000,2021-02-08,10,14,LA,US,24,1622
OUTLANDER 850,2021-02-08,14,14,LA,US,28,1665
OUTLANDER 450,2021-02-08,2,9,LA,US,11,1725
OUTLANDER 1000,2021-02-15,15,7,LA,US,22,1644
OUTLANDER 850,2021-02-15,10,8,LA,US,18,1683
OUTLANDER 450,2021-02-15,6,9,LA,US,15,1740
OUTLANDER 1000,2021-02-22,9,10,LA,US,19,1663
OUTLANDER 850,2021-02-22,13,12,LA,US,25,1708
OUTLANDER 450,2021-02-22,11,12,LA,US,23,1763
OUTLANDER 1000,2021-03-01,6,3,LA,US,9,1672
OUTLANDER 850,2021-03-01,7,13,LA,US,20,1728
OUTLANDER 450,2021-03-01,7,13,LA,US,20,1783
OUTLANDER 1000,2021-03-08,4,14,LA,US,18,1690
OUTLANDER 850,2021-03-08,1,9,LA,US,10,1738
OUTLANDER 450,2021-03-08,0,9,LA,US,9,1792
OUTLANDER 1000,2021-03-15,2,14,LA,US,16,1706
OUTLANDER 850,2021-03-15,4,3,LA,US,7,1745
OUTLANDER 450,2021-03-15,14,4,LA,US,18,1810
OUTLANDER 1000,2021-03-22,2,4,LA,US,6,1712
OUTLANDER 850,2021-03-22,9,3,LA,US,12,1757
OUTLANDER 450,2021-03-22,12,14,LA,US,26,1836
OUTLANDER 1000,2021-03-29,10,15,LA,US,25,1737
OUTLANDER 850,2021-03-29,8,2,LA,US,10,1767
OUTLANDER 450,2021-03-29,14,3,LA,US,17,1853
OUTLANDER 1000,2021-04-05,4,4,LA,US,8,1745
OUTLANDER 850,2021-04-05,7,8,LA,US,15,1782
OUTLANDER 450,2021-04-05,10,7,LA,US,17,1870
OUTLANDER 1000,2021-04-12,9,7,LA,US,16,1761
OUTLANDER 850,2021-04-12,12,1,LA,US,13,1795
OUTLANDER 450,2021-04-12,12,10,LA,US,22,1892
OUTLANDER 1000,2021-04-19,5,0,LA,US,5,1766
OUTLANDER 850,2021-04-19,3,13,LA,US,16,1811
OUTLANDER 450,2021-04-19,2,7,LA,US,9,1901
OUTLANDER 1000,2021-04-26,13,5,LA,US,18,1784
OUTLANDER 850,2021-04-26,5,13,LA,US,18,1829
OUTLANDER 450,2021-04-26,10,4,LA,US,14,1915
OUTLANDER 1000,2021-05-03,8,15,LA,US,23,1807
OUTLANDER 850,2021-05-03,13,10,LA,US,23,1852
OUTLANDER 450,2021-05-03,10,12,LA,US,22,1937
OUTLANDER 1000,2021-05-10,12,15,LA,US,27,1834
OUTLANDER 850,2021-05-10,5,13,LA,US,18,1870
OUTLANDER 450,2021-05-10,10,12,LA,US,22,1959
OUTLANDER 1000,2021-05-17,6,1,LA,US,7,1841
OUTLANDER 850,2021-05-17,5,4,LA,US,9,1879
OUTLANDER 450,2021-05-17,5,11,LA,US,16,1975
OUTLANDER 1000,2021-05-24,12,3,LA,US,15,1856
OUTLANDER 850,2021-05-24,3,9,LA,US,12,1891
OUTLANDER 450,2021-05-24,8,9,LA,US,17,1992
OUTLANDER 1000,2021-05-31,11,9,LA,US,20,1876
OUTLANDER 850,2021-05-31,9,3,LA,US,12,1903
OUTLANDER 450,2021-05-31,4,9,LA,US,13,2005
OUTLANDER 1000,2021-06-07,3,9,LA,US,12,1888
OUTLANDER 850,2021-06-07,10,13,LA,US,23,1926
OUTLANDER 450,2021-06-07,1,1,LA,US,2,2007
OUTLANDER 1000,2021-06-14,5,5,LA,US,10,1898
OUTLANDER 850,2021-06-14,12,4,LA,US,16,1942
OUTLANDER 450,2021-06-14,1,8,LA,US,9,2016
OUTLANDER 1000,2021-06-21,14,5,LA,US,19,1917
OUTLANDER 850,2021-06-21,7,1,LA,US,8,1950
OUTLANDER 450,2021-06-21,7,1,LA,US,8,2024
OUTLANDER 1000,2021-06-28,12,12,LA,US,24,1941
OUTLANDER 850,2021-06-28,14,12,LA,US,26,1976
OUTLANDER 450,2021-06-28,9,5,LA,US,14,2038
OUTLANDER 1000,2021-07-05,1,1,LA,US,2,1943
OUTLANDER 850,2021-07-05,4,5,LA,US,9,1985
OUTLANDER 450,2021-07-05,7,1,LA,US,8,2046
OUTLANDER 1000,2021-07-12,2,2,LA,US,4,1947
OUTLANDER 850,2021-07-12,5,13,LA,US,18,2003
OUTLANDER 450,2021-07-12,0,4,LA,US,4,2050
OUTLANDER 1000,2021-07-19,10,3,LA,US,13,1960
OUTLANDER 850,2021-07-19,7,2,LA,US,9,2012
OUTLANDER 450,2021-07-19,2,5,LA,US,7,2057
OUTLANDER 1000,2021-07-26,4,8,LA,US,12,1972
OUTLANDER 850,2021-07-26,11,13,LA,US,24,2036
OUTLANDER 450,2021-07-26,2,3,LA,US,5,2062
OUTLANDER 1000,2021-08-02,1,6,LA,US,7,1979
OUTLANDER 850,2021-08-02,5,11,LA,US,16,2052
OUTLANDER 450,2021-08-02,1,14,LA,US,15,2077
OUTLANDER 1000,2021-08-09,8,11,LA,US,19,1998
OUTLANDER 850,2021-08-09,13,10,LA,US,23,2075
OUTLANDER 450,2021-08-09,15,6,LA,US,21,2098
OUTLANDER 1000,2021-08-16,13,14,LA,US,27,2025
OUTLANDER 850,2021-08-16,12,0,LA,US,12,2087
OUTLANDER 450,2021-08-16,8,5,LA,US,13,2111
OUTLANDER 1000,2021-08-23,3,11,LA,US,14,2039
OUTLANDER 850,2021-08-23,0,7,LA,US,7,2094
OUTLANDER 450,2021-08-23,1,11,LA,US,12,2123
OUTLANDER 1000,2021-08-30,1,11,LA,US,12,2051
OUTLANDER 850,2021-08-30,2,7,LA,US,9,2103
OUTLANDER 450,2021-08-30,8,7,LA,US,15,2138
OUTLANDER 1000,2021-09-06,12,12,LA,US,24,2075
OUTLANDER 850,2021-09-06,2,11,LA,US,13,2116
OUTLANDER 450,2021-09-06,9,3,LA,US,12,2150
OUTLANDER 1000,2021-09-13,8,10,LA,US,18,2093
OUTLANDER 850,2021-09-13,3,14,LA,US,17,2133
OUTLANDER 450,2021-09-13,2,10,LA,US,12,2162
OUTLANDER 1000,2021-09-20,8,1,LA,US,9,2102
OUTLANDER 850,2021-09-20,10,12,LA,US,22,2155
OUTLANDER 450,2021-09-20,12,2,LA,US,14,2176
OUTLANDER 1000,2021-09-27,5,2,LA,US,7,2109
OUTLANDER 850,2021-09-27,9,11,LA,US,20,2175
OUTLANDER 450,2021-09-27,0,5,LA,US,5,2181
OUTLANDER 1000,2021-10-04,14,9,LA,US,23,2132
OUTLANDER 850,2021-10-04,14,1,LA,US,15,2190
OUTLANDER 450,2021-10-04,7,10,LA,US,17,2198
OUTLANDER 1000,2021-10-11,14,5,LA,US,19,2151
OUTLANDER 850,2021-10-11,7,3,LA,US,10,2200
OUTLANDER 450,2021-10-11,7,14,LA,US,21,2219
OUTLANDER 1000,2021-10-18,10,6,LA,US,16,2167
OUTLANDER 850,2021-10-18,11,2,LA,US,13,2213
OUTLANDER 450,2021-10-18,11,2,LA,US,13,2232
OUTLANDER 1000,2021-10-25,14,6,LA,US,20,2187
OUTLANDER 850,2021-10-25,6,2,LA,US,8,2221
OUTLANDER 450,2021-10-25,5,6,LA,US,11,2243
OUTLANDER 1000,2021-11-01,12,11,LA,US,23,2210
OUTLANDER 850,2021-11-01,1,14,LA,US,15,2236
OUTLANDER 450,2021-11-01,12,10,LA,US,22,2265
OUTLANDER 1000,2021-11-08,10,1,LA,US,11,2221
OUTLANDER 850,2021-11-08,8,12,LA,US,20,2256
OUTLANDER 450,2021-11-08,10,7,LA,US,17,2282
OUTLANDER 1000,2021-11-15,0,12,LA,US,12,2233
OUTLANDER 850,2021-11-15,6,3,LA,US,9,2265
OUTLANDER 450,2021-11-15,4,12,LA,US,16,2298
OUTLANDER 1000,2021-11-22,6,3,LA,US,9,2242
OUTLANDER 850,2021-11-22,15,1,LA,US,16,2281
OUTLANDER 450,2021-11-22,8,13,LA,US,21,2319
OUTLANDER 1000,2021-11-29,7,13,LA,US,20,2262
OUTLANDER 850,2021-11-29,7,13,LA,US,20,2301
OUTLANDER 450,2021-11-29,7,9,LA,US,16,2335
OUTLANDER 1000,2021-12-06,11,6,LA,US,17,2279
OUTLANDER 850,2021-12-06,7,6,LA,US,13,2314
OUTLANDER 450,2021-12-06,9,9,LA,US,18,2353
OUTLANDER 1000,2021-12-13,4,12,LA,US,16,2295
OUTLANDER 850,2021-12-13,6,13,LA,US,19,2333
OUTLANDER 450,2021-12-13,12,2,LA,US,14,2367
OUTLANDER 1000,2021-12-20,6,8,LA,US,14,2309
OUTLANDER 850,2021-12-20,2,4,LA,US,6,2339
OUTLANDER 450,2021-12-20,12,9,LA,US,21,2388
OUTLANDER 1000,2021-12-27,5,5,LA,US,10,2319
OUTLANDER 850,2021-12-27,12,5,LA,US,17,2356
OUTLANDER 450,2021-12-27,3,8,LA,US,11,2399
OUTLANDER 1000,2019-01-07,10,2,ME,US,12,12
OUTLANDER 850,2019-01-07,13,4,ME,US,17,17
OUTLANDER 450,2019-01-07,7,7,ME,US,14,14
OUTLANDER 1000,2019-01-14,6,1,ME,US,7,19
OUTLANDER 850,2019-01-14,14,6,ME,US,20,37
OUTLANDER 450,2019-01-14,14,13,ME,US,27,41
OUTLANDER 1000,2019-01-21,5,9,ME,US,14,33
OUTLANDER 850,2019-01-21,3,14,ME,US,17,54
OUTLANDER 450,2019-01-21,0,1,ME,US,1,42
OUTLANDER 1000,2019-01-28,7,3,ME,US,10,43
OUTLANDER 850,2019-01-28,5,4,ME,US,9,63
OUTLANDER 450,2019-01-28,11,12,ME,US,23,65
OUTLANDER 1000,2019-02-04,2,12,ME,US,14,57
OUTLANDER 850,2019-02-04,3,14,ME,US,17,80
OUTLANDER 450,2019-02-04,4,14,ME,US,18,83
OUTLANDER 1000,2019-02-11,4,3,ME,US,7,64
OUTLANDER 850,2019-02-11,2,11,ME,US,13,93
OUTLANDER 450,2019-02-11,4,13,ME,US,17,100
OUTLANDER 1000,2019-02-18,3,2,ME,US,5,69
OUTLANDER 850,2019-02-18,3,2,ME,US,5,98
OUTLANDER 450,2019-02-18,15,5,ME,US,20,120
OUTLANDER 1000,2019-02-25,11,11,ME,US,22,91
OUTLANDER 850,2019-02-25,12,0,ME,US,12,110
OUTLANDER 450,2019-02-25,8,13,ME,US,21,141
OUTLANDER 1000,2019-03-04,1,1,ME,US,2,93
OUTLANDER 850,2019-03-04,8,0,ME,US,8,118
OUTLANDER 450,2019-03-04,1,6,ME,US,7,148
OUTLANDER 1000,2019-03-11,9,10,ME,US,19,112
OUTLANDER 850,2019-03-11,9,8,ME,US,17,135
OUTLANDER 450,2019-03-11,4,9,ME,US,13,161
OUTLANDER 1000,2019-03-18,6,11,ME,US,17,129
OUTLANDER 850,2019-03-18,1,6,ME,US,7,142
OUTLANDER 450,2019-03-18,9,4,ME,US,13,174
OUTLANDER 1000,2019-03-25,13,0,ME,US,13,142
OUTLANDER 850,2019-03-25,11,6,ME,US,17,159
OUTLANDER 450,2019-03-25,4,13,ME,US,17,191
OUTLANDER 1000,2019-04-01,10,11,ME,US,21,163
OUTLANDER 850,2019-04-01,10,8,ME,US,18,177
OUTLANDER 450,2019-04-01,11,6,ME,US,17,208
OUTLANDER 1000,2019-04-08,8,10,ME,US,18,181
OUTLANDER 850,2019-04-08,12,3,ME,US,15,192
OUTLANDER 450,2019-04-08,6,7,ME,US,13,221
OUTLANDER 1000,2019-04-15,0,11,ME,US,11,192
OUTLANDER 850,2019-04-15,7,1,ME,US,8,200
OUTLANDER 450,2019-04-15,8,4,ME,US,12,233
OUTLANDER 1000,2019-04-22,14,10,ME,US,24,216
OUTLANDER 850,2019-04-22,4,0,ME,US,4,204
OUTLANDER 450,2019-04-22,13,12,ME,US,25,258
OUTLANDER 1000,2019-04-29,4,8,ME,US,12,228
OUTLANDER 850,2019-04-29,4,12,ME,US,16,220
OUTLANDER 450,2019-04-29,11,4,ME,US,15,273
OUTLANDER 1000,2019-05-06,0,7,ME,US,7,235
OUTLANDER 850,2019-05-06,12,4,ME,US,16,236
OUTLANDER 450,2019-05-06,13,7,ME,US,20,293
OUTLANDER 1000,2019-05-13,12,7,ME,US,19,254
OUTLANDER 850,2019-05-13,12,14,ME,US,26,262
OUTLANDER 450,2019-05-13,4,5,ME,US,9,302
OUTLANDER 1000,2019-05-20,0,12,ME,US,12,266
OUTLANDER 850,2019-05-20,4,11,ME,US,15,277
OUTLANDER 450,2019-05-20,1,10,ME,US,11,313
OUTLANDER 1000,2019-05-27,9,9,ME,US,18,284
OUTLANDER 850,2019-05-27,0,14,ME,US,14,291
OUTLANDER 450,2019-05-27,11,0,ME,US,11,324
OUTLANDER 1000,2019-06-03,11,13,ME,US,24,308
OUTLANDER 850,2019-06-03,10,0,ME,US,10,301
OUTLANDER 450,2019-06-03,12,2,ME,US,14,338
OUTLANDER 1000,2019-06-10,13,0,ME,US,13,321
OUTLANDER 850,2019-06-10,7,13,ME,US,20,321
OUTLANDER 450,2019-06-10,5,14,ME,US,19,357
OUTLANDER 1000,2019-06-17,7,4,ME,US,11,332
OUTLANDER 850,2019-06-17,4,11,ME,US,15,336
OUTLANDER 450,2019-06-17,3,2,ME,US,5,362
OUTLANDER 1000,2019-06-24,14,6,ME,US,20,352
OUTLANDER 850,2019-06-24,4,10,ME,US,14,350
OUTLANDER 450,2019-06-24,7,12,ME,US,19,381
OUTLANDER 1000,2019-07-01,5,3,ME,US,8,360
OUTLANDER 850,2019-07-01,14,6,ME,US,20,370
OUTLANDER 450,2019-07-01,13,14,ME,US,27,408
OUTLANDER 1000,2019-07-08,9,11,ME,US,20,380
OUTLANDER 850,2019-07-08,8,0,ME,US,8,378
OUTLANDER 450,2019-07-08,2,5,ME,US,7,415
OUTLANDER 1000,2019-07-15,6,3,ME,US,9,389
OUTLANDER 850,2019-07-15,10,6,ME,US,16,394
OUTLANDER 450,2019-07-15,7,10,ME,US,17,432
OUTLANDER 1000,2019-07-22,12,2,ME,US,14,403
OUTLANDER 850,2019-07-22,8,6,ME,US,14,408
OUTLANDER 450,2019-07-22,5,1,ME,US,6,438
OUTLANDER 1000,2019-07-29,4,15,ME,US,19,422
OUTLANDER 850,2019-07-29,12,9,ME,US,21,429
OUTLANDER 450,2019-07-29,10,7,ME,US,17,455
OUTLANDER 1000,2019-08-05,6,8,ME,US,14,436
OUTLANDER 850,2019-08-05,11,1,ME,US,12,441
OUTLANDER 450,2019-08-05,12,15,ME,US,27,482
OUTLANDER 1000,2019-08-12,13,2,ME,US,15,451
OUTLANDER 850,2019-08-12,11,7,ME,US,18,459
OUTLANDER 450,2019-08-12,5,6,ME,US,11,493
OUTLANDER 1000,2019-08-19,5,12,ME,US,17,468
OUTLANDER 850,2019-08-19,10,7,ME,US,17,476
OUTLANDER 450,2019-08-19,3,1,ME,US,4,497
OUTLANDER 1000,2019-08-26,14,12,ME,US,26,494
OUTLANDER 850,2019-08-26,12,15,ME,US,27,503
OUTLANDER 450,2019-08-26,14,7,ME,US,21,518
OUTLANDER 1000,2019-09-02,9,2,ME,US,11,505
OUTLANDER 850,2019-09-02,11,6,ME,US,17,520
OUTLANDER 450,2019-09-02,9,0,ME,US,9,527
OUTLANDER 1000,2019-09-09,7,14,ME,US,21,526
OUTLANDER 850,2019-09-09,9,10,ME,US,19,539
OUTLANDER 450,2019-09-09,13,13,ME,US,26,553
OUTLANDER 1000,2019-09-16,13,0,ME,US,13,539
OUTLANDER 850,2019-09-16,5,13,ME,US,18,557
OUTLANDER 450,2019-09-16,12,11,ME,US,23,576
OUTLANDER 1000,2019-09-23,9,1,ME,US,10,549
OUTLANDER 850,2019-09-23,12,8,ME,US,20,577
OUTLANDER 450,2019-09-23,2,14,ME,US,16,592
OUTLANDER 1000,2019-09-30,3,9,ME,US,12,561
OUTLANDER 850,2019-09-30,9,14,ME,US,23,600
OUTLANDER 450,2019-09-30,8,2,ME,US,10,602
OUTLANDER 1000,2019-10-07,5,9,ME,US,14,575
OUTLANDER 850,2019-10-07,5,7,ME,US,12,612
OUTLANDER 450,2019-10-07,4,12,ME,US,16,618
OUTLANDER 1000,2019-10-14,4,3,ME,US,7,582
OUTLANDER 850,2019-10-14,9,0,ME,US,9,621
OUTLANDER 450,2019-10-14,10,12,ME,US,22,640
OUTLANDER 1000,2019-10-21,8,14,ME,US,22,604
OUTLANDER 850,2019-10-21,2,13,ME,US,15,636
OUTLANDER 450,2019-10-21,1,13,ME,US,14,654
OUTLANDER 1000,2019-10-28,3,0,ME,US,3,607
OUTLANDER 850,2019-10-28,7,14,ME,US,21,657
OUTLANDER 450,2019-10-28,3,9,ME,US,12,666
OUTLANDER 1000,2019-11-04,5,1,ME,US,6,613
OUTLANDER 850,2019-11-04,9,4,ME,US,13,670
OUTLANDER 450,2019-11-04,8,15,ME,US,23,689
OUTLANDER 1000,2019-11-11,15,8,ME,US,23,636
OUTLANDER 850,2019-11-11,8,14,ME,US,22,692
OUTLANDER 450,2019-11-11,1,4,ME,US,5,694
OUTLANDER 1000,2019-11-18,12,8,ME,US,20,656
OUTLANDER 850,2019-11-18,4,4,ME,US,8,700
OUTLANDER 450,2019-11-18,2,6,ME,US,8,702
OUTLANDER 1000,2019-11-25,4,15,ME,US,19,675
OUTLANDER 850,2019-11-25,12,13,ME,US,25,725
OUTLANDER 450,2019-11-25,7,5,ME,US,12,714
OUTLANDER 1000,2019-12-02,0,8,ME,US,8,683
OUTLANDER 850,2019-12-02,5,5,ME,US,10,735
OUTLANDER 450,2019-12-02,8,12,ME,US,20,734
OUTLANDER 1000,2019-12-09,4,4,ME,US,8,691
OUTLANDER 850,2019-12-09,12,14,ME,US,26,761
OUTLANDER 450,2019-12-09,8,9,ME,US,17,751
OUTLANDER 1000,2019-12-16,14,5,ME,US,19,710
OUTLANDER 850,2019-12-16,7,13,ME,US,20,781
OUTLANDER 450,2019-12-16,1,6,ME,US,7,758
OUTLANDER 1000,2019-12-23,12,5,ME,US,17,727
OUTLANDER 850,2019-12-23,6,14,ME,US,20,801
OUTLANDER 450,2019-12-23,15,13,ME,US,28,786
OUTLANDER 1000,2019-12-30,8,6,ME,US,14,741
OUTLANDER 850,2019-12-30,11,11,ME,US,22,823
OUTLANDER 450,2019-12-30,13,9,ME,US,22,808
OUTLANDER 1000,2020-01-06,5,3,ME,US,8,749
OUTLANDER 850,2020-01-06,7,8,ME,US,15,838
OUTLANDER 450,2020-01-06,14,7,ME,US,21,829
OUTLANDER 1000,2020-01-13,14,8,ME,US,22,771
OUTLANDER 850,2020-01-13,8,10,ME,US,18,856
OUTLANDER 450,2020-01-13,15,6,ME,US,21,850
OUTLANDER 1000,2020-01-20,15,14,ME,US,29,800
OUTLANDER 850,2020-01-20,3,5,ME,US,8,864
OUTLANDER 450,2020-01-20,8,9,ME,US,17,867
OUTLANDER 1000,2020-01-27,10,5,ME,US,15,815
OUTLANDER 850,2020-01-27,14,8,ME,US,22,886
OUTLANDER 450,2020-01-27,5,10,ME,US,15,882
OUTLANDER 1000,2020-02-03,6,5,ME,US,11,826
OUTLANDER 850,2020-02-03,11,14,ME,US,25,911
OUTLANDER 450,2020-02-03,3,14,ME,US,17,899
OUTLANDER 1000,2020-02-10,5,13,ME,US,18,844
OUTLANDER 850,2020-02-10,3,7,ME,US,10,921
OUTLANDER 450,2020-02-10,12,13,ME,US,25,924
OUTLANDER 1000,2020-02-17,13,2,ME,US,15,859
OUTLANDER 850,2020-02-17,6,6,ME,US,12,933
OUTLANDER 450,2020-02-17,10,11,ME,US,21,945
OUTLANDER 1000,2020-02-24,3,0,ME,US,3,862
OUTLANDER 850,2020-02-24,13,2,ME,US,15,948
OUTLANDER 450,2020-02-24,8,9,ME,US,17,962
OUTLANDER 1000,2020-03-02,2,7,ME,US,9,871
OUTLANDER 850,2020-03-02,0,11,ME,US,11,959
OUTLANDER 450,2020-03-02,8,12,ME,US,20,982
OUTLANDER 1000,2020-03-09,11,14,ME,US,25,896
OUTLANDER 850,2020-03-09,9,4,ME,US,13,972
OUTLANDER 450,2020-03-09,2,15,ME,US,17,999
OUTLANDER 1000,2020-03-16,14,4,ME,US,18,914
OUTLANDER 850,2020-03-16,8,1,ME,US,9,981
OUTLANDER 450,2020-03-16,2,9,ME,US,11,1010
OUTLANDER 1000,2020-03-23,1,7,ME,US,8,922
OUTLANDER 850,2020-03-23,7,5,ME,US,12,993
OUTLANDER 450,2020-03-23,8,3,ME,US,11,1021
OUTLANDER 1000,2020-03-30,14,1,ME,US,15,937
OUTLANDER 850,2020-03-30,14,14,ME,US,28,1021
OUTLANDER 450,2020-03-30,4,14,ME,US,18,1039
OUTLANDER 1000,2020-04-06,3,6,ME,US,9,946
OUTLANDER 850,2020-04-06,12,5,ME,US,17,1038
OUTLANDER 450,2020-04-06,6,13,ME,US,19,1058
OUTLANDER 1000,2020-04-13,8,6,ME,US,14,960
OUTLANDER 850,2020-04-13,3,13,ME,US,16,1054
OUTLANDER 450,2020-04-13,0,14,ME,US,14,1072
OUTLANDER 1000,2020-04-20,9,10,ME,US,19,979
OUTLANDER 850,2020-04-20,2,11,ME,US,13,1067
OUTLANDER 450,2020-04-20,10,14,ME,US,24,1096
OUTLANDER 1000,2020-04-27,3,11,ME,US,14,993
OUTLANDER 850,2020-04-27,5,2,ME,US,7,1074
OUTLANDER 450,2020-04-27,2,8,ME,US,10,1106
OUTLANDER 1000,2020-05-04,8,9,ME,US,17,1010
OUTLANDER 850,2020-05-04,7,7,ME,US,14,1088
OUTLANDER 450,2020-05-04,7,13,ME,US,20,1126
OUTLANDER 1000,2020-05-11,12,6,ME,US,18,1028
OUTLANDER 850,2020-05-11,14,0,ME,US,14,1102
OUTLANDER 450,2020-05-11,9,4,ME,US,13,1139
OUTLANDER 1000,2020-05-18,13,8,ME,US,21,1049
OUTLANDER 850,2020-05-18,12,14,ME,US,26,1128
OUTLANDER 450,2020-05-18,7,13,ME,US,20,1159
OUTLANDER 1000,2020-05-25,6,6,ME,US,12,1061
OUTLANDER 850,2020-05-25,7,10,ME,US,17,1145
OUTLANDER 450,2020-05-25,2,6,ME,US,8,1167
OUTLANDER 1000,2020-06-01,2,12,ME,US,14,1075
OUTLANDER 850,2020-06-01,9,14,ME,US,23,1168
OUTLANDER 450,2020-06-01,12,7,ME,US,19,1186
OUTLANDER 1000,2020-06-08,9,7,ME,US,16,1091
OUTLANDER 850,2020-06-08,2,1,ME,US,3,1171
OUTLANDER 450,2020-06-08,9,13,ME,US,22,1208
OUTLANDER 1000,2020-06-15,7,6,ME,US,13,1104
OUTLANDER 850,2020-06-15,12,12,ME,US,24,1195
OUTLANDER 450,2020-06-15,11,10,ME,US,21,1229
OUTLANDER 1000,2020-06-22,3,13,ME,US,16,1120
OUTLANDER 850,2020-06-22,4,7,ME,US,11,1206
OUTLANDER 450,2020-06-22,10,12,ME,US,22,1251
OUTLANDER 1000,2020-06-29,7,1,ME,US,8,1128
OUTLANDER 850,2020-06-29,3,13,ME,US,16,1222
OUTLANDER 450,2020-06-29,2,7,ME,US,9,1260
OUTLANDER 1000,2020-07-06,8,15,ME,US,23,1151
OUTLANDER 850,2020-07-06,9,0,ME,US,9,1231
OUTLANDER 450,2020-07-06,13,5,ME,US,18,1278
OUTLANDER 1000,2020-07-13,9,4,ME,US,13,1164
OUTLANDER 850,2020-07-13,4,3,ME,US,7,1238
OUTLANDER 450,2020-07-13,9,4,ME,US,13,1291
OUTLANDER 1000,2020-07-20,8,12,ME,US,20,1184
OUTLANDER 850,2020-07-20,1,2,ME,US,3,1241
OUTLANDER 450,2020-07-20,10,11,ME,US,21,1312
OUTLANDER 1000,2020-07-27,13,6,ME,US,19,1203
OUTLANDER 850,2020-07-27,4,7,ME,US,11,1252
OUTLANDER 450,2020-07-27,15,13,ME,US,28,1340
OUTLANDER 1000,2020-08-03,2,15,ME,US,17,1220
OUTLANDER 850,2020-08-03,10,4,ME,US,14,1266
OUTLANDER 450,2020-08-03,4,6,ME,US,10,1350
OUTLANDER 1000,2020-08-10,6,12,ME,US,18,1238
OUTLANDER 850,2020-08-10,5,11,ME,US,16,1282
OUTLANDER 450,2020-08-10,8,10,ME,US,18,1368
OUTLANDER 1000,2020-08-17,14,14,ME,US,28,1266
OUTLANDER 850,2020-08-17,1,4,ME,US,5,1287
OUTLANDER 450,2020-08-17,1,4,ME,US,5,1373
OUTLANDER 1000,2020-08-24,6,13,ME,US,19,1285
OUTLANDER 850,2020-08-24,7,12,ME,US,19,1306
OUTLANDER 450,2020-08-24,1,5,ME,US,6,1379
OUTLANDER 1000,2020-08-31,2,2,ME,US,4,1289
OUTLANDER 850,2020-08-31,9,7,ME,US,16,1322
OUTLANDER 450,2020-08-31,1,5,ME,US,6,1385
OUTLANDER 1000,2020-09-07,0,9,ME,US,9,1298
OUTLANDER 850,2020-09-07,4,8,ME,US,12,1334
OUTLANDER 450,2020-09-07,2,6,ME,US,8,1393
OUTLANDER 1000,2020-09-14,11,12,ME,US,23,1321
OUTLANDER 850,2020-09-14,2,13,ME,US,15,1349
OUTLANDER 450,2020-09-14,14,11,ME,US,25,1418
OUTLANDER 1000,2020-09-21,3,7,ME,US,10,1331
OUTLANDER 850,2020-09-21,9,1,ME,US,10,1359
OUTLANDER 450,2020-09-21,15,7,ME,US,22,1440
OUTLANDER 1000,2020-09-28,13,13,ME,US,26,1357
OUTLANDER 850,2020-09-28,4,5,ME,US,9,1368
OUTLANDER 450,2020-09-28,2,0,ME,US,2,1442
OUTLANDER 1000,2020-10-05,4,4,ME,US,8,1365
OUTLANDER 850,2020-10-05,13,3,ME,US,16,1384
OUTLANDER 450,2020-10-05,6,13,ME,US,19,1461
OUTLANDER 1000,2020-10-12,2,2,ME,US,4,1369
OUTLANDER 850,2020-10-12,14,0,ME,US,14,1398
OUTLANDER 450,2020-10-12,3,2,ME,US,5,1466
OUTLANDER 1000,2020-10-19,10,5,ME,US,15,1384
OUTLANDER 850,2020-10-19,1,6,ME,US,7,1405
OUTLANDER 450,2020-10-19,14,2,ME,US,16,1482
OUTLANDER 1000,2020-10-26,10,12,ME,US,22,1406
OUTLANDER 850,2020-10-26,13,10,ME,US,23,1428
OUTLANDER 450,2020-10-26,14,0,ME,US,14,1496
OUTLANDER 1000,2020-11-02,10,10,ME,US,20,1426
OUTLANDER 850,2020-11-02,9,9,ME,US,18,1446
OUTLANDER 450,2020-11-02,14,12,ME,US,26,1522
OUTLANDER 1000,2020-11-09,4,0,ME,US,4,1430
OUTLANDER 850,2020-11-09,15,9,ME,US,24,1470
OUTLANDER 450,2020-11-09,6,2,ME,US,8,1530
OUTLANDER 1000,2020-11-16,11,5,ME,US,16,1446
OUTLANDER 850,2020-11-16,5,3,ME,US,8,1478
OUTLANDER 450,2020-11-16,5,0,ME,US,5,1535
OUTLANDER 1000,2020-11-23,10,11,ME,US,21,1467
OUTLANDER 850,2020-11-23,8,2,ME,US,10,1488
OUTLANDER 450,2020-11-23,9,9,ME,US,18,1553
OUTLANDER 1000,2020-11-30,4,15,ME,US,19,1486
OUTLANDER 850,2020-11-30,7,15,ME,US,22,1510
OUTLANDER 450,2020-11-30,5,7,ME,US,12,1565
OUTLANDER 1000,2020-12-07,14,14,ME,US,28,1514
OUTLANDER 850,2020-12-07,12,1,ME,US,13,1523
OUTLANDER 450,2020-12-07,14,2,ME,US,16,1581
OUTLANDER 1000,2020-12-14,5,11,ME,US,16,1530
OUTLANDER 850,2020-12-14,1,2,ME,US,3,1526
OUTLANDER 450,2020-12-14,7,3,ME,US,10,1591
OUTLANDER 1000,2020-12-21,2,13,ME,US,15,1545
OUTLANDER 850,2020-12-21,1,3,ME,US,4,1530
OUTLANDER 450,2020-12-21,2,15,ME,US,17,1608
OUTLANDER 1000,2020-12-28,0,7,ME,US,7,1552
OUTLANDER 850,2020-12-28,3,1,ME,US,4,1534
OUTLANDER 450,2020-12-28,7,11,ME,US,18,1626
OUTLANDER 1000,2021-01-04,14,3,ME,US,17,1569
OUTLANDER 850,2021-01-04,1,2,ME,US,3,1537
OUTLANDER 450,2021-01-04,7,2,ME,US,9,1635
OUTLANDER 1000,2021-01-11,11,12,ME,US,23,1592
OUTLANDER 850,2021-01-11,5,11,ME,US,16,1553
OUTLANDER 450,2021-01-11,11,0,ME,US,11,1646
OUTLANDER 1000,2021-01-18,7,13,ME,US,20,1612
OUTLANDER 850,2021-01-18,2,13,ME,US,15,1568
OUTLANDER 450,2021-01-18,2,3,ME,US,5,1651
OUTLANDER 1000,2021-01-25,5,13,ME,US,18,1630
OUTLANDER 850,2021-01-25,9,14,ME,US,23,1591
OUTLANDER 450,2021-01-25,6,0,ME,US,6,1657
OUTLANDER 1000,2021-02-01,4,9,ME,US,13,1643
OUTLANDER 850,2021-02-01,11,3,ME,US,14,1605
OUTLANDER 450,2021-02-01,10,7,ME,US,17,1674
OUTLANDER 1000,2021-02-08,3,12,ME,US,15,1658
OUTLANDER 850,2021-02-08,11,12,ME,US,23,1628
OUTLANDER 450,2021-02-08,1,13,ME,US,14,1688
OUTLANDER 1000,2021-02-15,6,2,ME,US,8,1666
OUTLANDER 850,2021-02-15,1,5,ME,US,6,1634
OUTLANDER 450,2021-02-15,3,5,ME,US,8,1696
OUTLANDER 1000,2021-02-22,3,1,ME,US,4,1670
OUTLANDER 850,2021-02-22,12,12,ME,US,24,1658
OUTLANDER 450,2021-02-22,5,13,ME,US,18,1714
OUTLANDER 1000,2021-03-01,14,12,ME,US,26,1696
OUTLANDER 850,2021-03-01,10,12,ME,US,22,1680
OUTLANDER 450,2021-03-01,13,2,ME,US,15,1729
OUTLANDER 1000,2021-03-08,11,8,ME,US,19,1715
OUTLANDER 850,2021-03-08,3,3,ME,US,6,1686
OUTLANDER 450,2021-03-08,14,14,ME,US,28,1757
OUTLANDER 1000,2021-03-15,2,15,ME,US,17,1732
OUTLANDER 850,2021-03-15,7,14,ME,US,21,1707
OUTLANDER 450,2021-03-15,13,5,ME,US,18,1775
OUTLANDER 1000,2021-03-22,7,5,ME,US,12,1744
OUTLANDER 850,2021-03-22,15,5,ME,US,20,1727
OUTLANDER 450,2021-03-22,1,10,ME,US,11,1786
OUTLANDER 1000,2021-03-29,14,13,ME,US,27,1771
OUTLANDER 850,2021-03-29,6,2,ME,US,8,1735
OUTLANDER 450,2021-03-29,6,10,ME,US,16,1802
OUTLANDER 1000,2021-04-05,10,2,ME,US,12,1783
OUTLANDER 850,2021-04-05,4,13,ME,US,17,1752
OUTLANDER 450,2021-04-05,2,0,ME,US,2,1804
OUTLANDER 1000,2021-04-12,1,15,ME,US,16,1799
OUTLANDER 850,2021-04-12,8,3,ME,US,11,1763
OUTLANDER 450,2021-04-12,7,5,ME,US,12,1816
OUTLANDER 1000,2021-04-19,15,11,ME,US,26,1825
OUTLANDER 850,2021-04-19,12,2,ME,US,14,1777
OUTLANDER 450,2021-04-19,3,9,ME,US,12,1828
OUTLANDER 1000,2021-04-26,11,10,ME,US,21,1846
OUTLANDER 850,2021-04-26,10,5,ME,US,15,1792
OUTLANDER 450,2021-04-26,11,14,ME,US,25,1853
OUTLANDER 1000,2021-05-03,8,7,ME,US,15,1861
OUTLANDER 850,2021-05-03,11,8,ME,US,19,1811
OUTLANDER 450,2021-05-03,7,2,ME,US,9,1862
OUTLANDER 1000,2021-05-10,6,14,ME,US,20,1881
OUTLANDER 850,2021-05-10,14,1,ME,US,15,1826
OUTLANDER 450,2021-05-10,10,4,ME,US,14,1876
OUTLANDER 1000,2021-05-17,1,12,ME,US,13,1894
OUTLANDER 850,2021-05-17,4,8,ME,US,12,1838
OUTLANDER 450,2021-05-17,6,9,ME,US,15,1891
OUTLANDER 1000,2021-05-24,6,6,ME,US,12,1906
OUTLANDER 850,2021-05-24,4,5,ME,US,9,1847
OUTLANDER 450,2021-05-24,6,4,ME,US,10,1901
OUTLANDER 1000,2021-05-31,14,10,ME,US,24,1930
OUTLANDER 850,2021-05-31,3,5,ME,US,8,1855
OUTLANDER 450,2021-05-31,4,14,ME,US,18,1919
OUTLANDER 1000,2021-06-07,11,1,ME,US,12,1942
OUTLANDER 850,2021-06-07,13,9,ME,US,22,1877
OUTLANDER 450,2021-06-07,0,6,ME,US,6,1925
OUTLANDER 1000,2021-06-14,2,10,ME,US,12,1954
OUTLANDER 850,2021-06-14,8,5,ME,US,13,1890
OUTLANDER 450,2021-06-14,8,8,ME,US,16,1941
OUTLANDER 1000,2021-06-21,8,0,ME,US,8,1962
OUTLANDER 850,2021-06-21,14,6,ME,US,20,1910
OUTLANDER 450,2021-06-21,1,7,ME,US,8,1949
OUTLANDER 1000,2021-06-28,8,2,ME,US,10,1972
OUTLANDER 850,2021-06-28,15,14,ME,US,29,1939
OUTLANDER 450,2021-06-28,4,10,ME,US,14,1963
OUTLANDER 1000,2021-07-05,11,11,ME,US,22,1994
OUTLANDER 850,2021-07-05,3,8,ME,US,11,1950
OUTLANDER 450,2021-07-05,10,1,ME,US,11,1974
OUTLANDER 1000,2021-07-12,6,4,ME,US,10,2004
OUTLANDER 850,2021-07-12,15,4,ME,US,19,1969
OUTLANDER 450,2021-07-12,11,3,ME,US,14,1988
OUTLANDER 1000,2021-07-19,4,11,ME,US,15,2019
OUTLANDER 850,2021-07-19,14,7,ME,US,21,1990
OUTLANDER 450,2021-07-19,4,14,ME,US,18,2006
OUTLANDER 1000,2021-07-26,5,7,ME,US,12,2031
OUTLANDER 850,2021-07-26,4,5,ME,US,9,1999
OUTLANDER 450,2021-07-26,11,11,ME,US,22,2028
OUTLANDER 1000,2021-08-02,14,9,ME,US,23,2054
OUTLANDER 850,2021-08-02,5,10,ME,US,15,2014
OUTLANDER 450,2021-08-02,1,7,ME,US,8,2036
OUTLANDER 1000,2021-08-09,13,15,ME,US,28,2082
OUTLANDER 850,2021-08-09,12,9,ME,US,21,2035
OUTLANDER 450,2021-08-09,5,5,ME,US,10,2046
OUTLANDER 1000,2021-08-16,8,7,ME,US,15,2097
OUTLANDER 850,2021-08-16,2,5,ME,US,7,2042
OUTLANDER 450,2021-08-16,11,7,ME,US,18,2064
OUTLANDER 1000,2021-08-23,12,8,ME,US,20,2117
OUTLANDER 850,2021-08-23,2,9,ME,US,11,2053
OUTLANDER 450,2021-08-23,11,9,ME,US,20,2084
OUTLANDER 1000,2021-08-30,1,12,ME,US,13,2130
OUTLANDER 850,2021-08-30,4,8,ME,US,12,2065
OUTLANDER 450,2021-08-30,11,6,ME,US,17,2101
OUTLANDER 1000,2021-09-06,11,9,ME,US,20,2150
OUTLANDER 850,2021-09-06,2,0,ME,US,2,2067
OUTLANDER 450,2021-09-06,14,12,ME,US,26,2127
OUTLANDER 1000,2021-09-13,12,2,ME,US,14,2164
OUTLANDER 850,2021-09-13,13,8,ME,US,21,2088
OUTLANDER 450,2021-09-13,15,2,ME,US,17,2144
OUTLANDER 1000,2021-09-20,5,14,ME,US,19,2183
OUTLANDER 850,2021-09-20,13,14,ME,US,27,2115
OUTLANDER 450,2021-09-20,12,2,ME,US,14,2158
OUTLANDER 1000,2021-09-27,9,11,ME,US,20,2203
OUTLANDER 850,2021-09-27,3,8,ME,US,11,2126
OUTLANDER 450,2021-09-27,12,3,ME,US,15,2173
OUTLANDER 1000,2021-10-04,5,3,ME,US,8,2211
OUTLANDER 850,2021-10-04,1,13,ME,US,14,2140
OUTLANDER 450,2021-10-04,8,1,ME,US,9,2182
OUTLANDER 1000,2021-10-11,15,12,ME,US,27,2238
OUTLANDER 850,2021-10-11,7,2,ME,US,9,2149
OUTLANDER 450,2021-10-11,8,4,ME,US,12,2194
OUTLANDER 1000,2021-10-18,1,13,ME,US,14,2252
OUTLANDER 850,2021-10-18,7,14,ME,US,21,2170
OUTLANDER 450,2021-10-18,14,1,ME,US,15,2209
OUTLANDER 1000,2021-10-25,10,13,ME,US,23,2275
OUTLANDER 850,2021-10-25,9,15,ME,US,24,2194
OUTLANDER 450,2021-10-25,8,3,ME,US,11,2220
OUTLANDER 1000,2021-11-01,3,1,ME,US,4,2279
OUTLANDER 850,2021-11-01,14,13,ME,US,27,2221
OUTLANDER 450,2021-11-01,2,8,ME,US,10,2230
OUTLANDER 1000,2021-11-08,8,13,ME,US,21,2300
OUTLANDER 850,2021-11-08,4,4,ME,US,8,2229
OUTLANDER 450,2021-11-08,14,10,ME,US,24,2254
OUTLANDER 1000,2021-11-15,9,1,ME,US,10,2310
OUTLANDER 850,2021-11-15,4,5,ME,US,9,2238
OUTLANDER 450,2021-11-15,15,13,ME,US,28,2282
OUTLANDER 1000,2021-11-22,11,6,ME,US,17,2327
OUTLANDER 850,2021-11-22,10,5,ME,US,15,2253
OUTLANDER 450,2021-11-22,7,6,ME,US,13,2295
OUTLANDER 1000,2021-11-29,14,12,ME,US,26,2353
OUTLANDER 850,2021-11-29,9,9,ME,US,18,2271
OUTLANDER 450,2021-11-29,0,9,ME,US,9,2304
OUTLANDER 1000,2021-12-06,4,9,ME,US,13,2366
OUTLANDER 850,2021-12-06,6,15,ME,US,21,2292
OUTLANDER 450,2021-12-06,6,11,ME,US,17,2321
OUTLANDER 1000,2021-12-13,12,11,ME,US,23,2389
OUTLANDER 850,2021-12-13,14,3,ME,US,17,2309
OUTLANDER 450,2021-12-13,14,1,ME,US,15,2336
OUTLANDER 1000,2021-12-20,1,10,ME,US,11,2400
OUTLANDER 850,2021-12-20,14,8,ME,US,22,2331
OUTLANDER 450,2021-12-20,1,3,ME,US,4,2340
OUTLANDER 1000,2021-12-27,11,1,ME,US,12,2412
OUTLANDER 850,2021-12-27,8,13,ME,US,21,2352
OUTLANDER 450,2021-12-27,8,8,ME,US,16,2356
OUTLANDER 1000,2019-01-07,13,5,MD,US,18,18
OUTLANDER 850,2019-01-07,4,5,MD,US,9,9
OUTLANDER 450,2019-01-07,1,3,MD,US,4,4
OUTLANDER 1000,2019-01-14,14,15,MD,US,29,47
OUTLANDER 850,2019-01-14,10,8,MD,US,18,27
OUTLANDER 450,2019-01-14,11,7,MD,US,18,22
OUTLANDER 1000,2019-01-21,7,2,MD,US,9,56
OUTLANDER 850,2019-01-21,14,5,MD,US,19,46
OUTLANDER 450,2019-01-21,9,10,MD,US,19,41
OUTLANDER 1000,2019-01-28,2,2,MD,US,4,60
OUTLANDER 850,2019-01-28,8,1,MD,US,9,55
OUTLANDER 450,2019-01-28,0,8,MD,US,8,49
OUTLANDER 1000,2019-02-04,3,9,MD,US,12,72
OUTLANDER 850,2019-02-04,1,8,MD,US,9,64
OUTLANDER 450,2019-02-04,5,0,MD,US,5,54
OUTLANDER 1000,2019-02-11,4,9,MD,US,13,85
OUTLANDER 850,2019-02-11,8,9,MD,US,17,81
OUTLANDER 450,2019-02-11,1,11,MD,US,12,66
OUTLANDER 1000,2019-02-18,9,12,MD,US,21,106
OUTLANDER 850,2019-02-18,3,7,MD,US,10,91
OUTLANDER 450,2019-02-18,12,7,MD,US,19,85
OUTLANDER 1000,2019-02-25,10,12,MD,US,22,128
OUTLANDER 850,2019-02-25,9,7,MD,US,16,107
OUTLANDER 450,2019-02-25,9,5,MD,US,14,99
OUTLANDER 1000,2019-03-04,1,2,MD,US,3,131
OUTLANDER 850,2019-03-04,14,15,MD,US,29,136
OUTLANDER 450,2019-03-04,2,1,MD,US,3,102
OUTLANDER 1000,2019-03-11,1,0,MD,US,1,132
OUTLANDER 850,2019-03-11,2,8,MD,US,10,146
OUTLANDER 450,2019-03-11,5,1,MD,US,6,108
OUTLANDER 1000,2019-03-18,4,5,MD,US,9,141
OUTLANDER 850,2019-03-18,8,9,MD,US,17,163
OUTLANDER 450,2019-03-18,13,7,MD,US,20,128
OUTLANDER 1000,2019-03-25,6,6,MD,US,12,153
OUTLANDER 850,2019-03-25,9,2,MD,US,11,174
OUTLANDER 450,2019-03-25,3,10,MD,US,13,141
OUTLANDER 1000,2019-04-01,4,9,MD,US,13,166
OUTLANDER 850,2019-04-01,0,10,MD,US,10,184
OUTLANDER 450,2019-04-01,5,2,MD,US,7,148
OUTLANDER 1000,2019-04-08,0,11,MD,US,11,177
OUTLANDER 850,2019-04-08,13,14,MD,US,27,211
OUTLANDER 450,2019-04-08,13,13,MD,US,26,174
OUTLANDER 1000,2019-04-15,8,0,MD,US,8,185
OUTLANDER 850,2019-04-15,1,8,MD,US,9,220
OUTLANDER 450,2019-04-15,3,4,MD,US,7,181
OUTLANDER 1000,2019-04-22,4,12,MD,US,16,201
OUTLANDER 850,2019-04-22,4,3,MD,US,7,227
OUTLANDER 450,2019-04-22,12,6,MD,US,18,199
OUTLANDER 1000,2019-04-29,10,14,MD,US,24,225
OUTLANDER 850,2019-04-29,12,1,MD,US,13,240
OUTLANDER 450,2019-04-29,3,13,MD,US,16,215
OUTLANDER 1000,2019-05-06,12,3,MD,US,15,240
OUTLANDER 850,2019-05-06,10,14,MD,US,24,264
OUTLANDER 450,2019-05-06,1,9,MD,US,10,225
OUTLANDER 1000,2019-05-13,6,0,MD,US,6,246
OUTLANDER 850,2019-05-13,14,9,MD,US,23,287
OUTLANDER 450,2019-05-13,2,4,MD,US,6,231
OUTLANDER 1000,2019-05-20,11,5,MD,US,16,262
OUTLANDER 850,2019-05-20,13,14,MD,US,27,314
OUTLANDER 450,2019-05-20,8,15,MD,US,23,254
OUTLANDER 1000,2019-05-27,2,10,MD,US,12,274
OUTLANDER 850,2019-05-27,13,5,MD,US,18,332
OUTLANDER 450,2019-05-27,8,14,MD,US,22,276
OUTLANDER 1000,2019-06-03,8,15,MD,US,23,297
OUTLANDER 850,2019-06-03,11,4,MD,US,15,347
OUTLANDER 450,2019-06-03,6,8,MD,US,14,290
OUTLANDER 1000,2019-06-10,4,4,MD,US,8,305
OUTLANDER 850,2019-06-10,13,5,MD,US,18,365
OUTLANDER 450,2019-06-10,4,10,MD,US,14,304
OUTLANDER 1000,2019-06-17,2,8,MD,US,10,315
OUTLANDER 850,2019-06-17,1,5,MD,US,6,371
OUTLANDER 450,2019-06-17,3,8,MD,US,11,315
OUTLANDER 1000,2019-06-24,10,0,MD,US,10,325
OUTLANDER 850,2019-06-24,2,13,MD,US,15,386
OUTLANDER 450,2019-06-24,9,10,MD,US,19,334
OUTLANDER 1000,2019-07-01,13,14,MD,US,27,352
OUTLANDER 850,2019-07-01,4,10,MD,US,14,400
OUTLANDER 450,2019-07-01,5,4,MD,US,9,343
OUTLANDER 1000,2019-07-08,12,9,MD,US,21,373
OUTLANDER 850,2019-07-08,3,13,MD,US,16,416
OUTLANDER 450,2019-07-08,4,12,MD,US,16,359
OUTLANDER 1000,2019-07-15,7,9,MD,US,16,389
OUTLANDER 850,2019-07-15,13,13,MD,US,26,442
OUTLANDER 450,2019-07-15,0,5,MD,US,5,364
OUTLANDER 1000,2019-07-22,4,10,MD,US,14,403
OUTLANDER 850,2019-07-22,2,8,MD,US,10,452
OUTLANDER 450,2019-07-22,7,8,MD,US,15,379
OUTLANDER 1000,2019-07-29,11,3,MD,US,14,417
OUTLANDER 850,2019-07-29,7,12,MD,US,19,471
OUTLANDER 450,2019-07-29,10,11,MD,US,21,400
OUTLANDER 1000,2019-08-05,14,5,MD,US,19,436
OUTLANDER 850,2019-08-05,10,1,MD,US,11,482
OUTLANDER 450,2019-08-05,9,6,MD,US,15,415
OUTLANDER 1000,2019-08-12,1,8,MD,US,9,445
OUTLANDER 850,2019-08-12,2,9,MD,US,11,493
OUTLANDER 450,2019-08-12,12,9,MD,US,21,436
OUTLANDER 1000,2019-08-19,8,7,MD,US,15,460
OUTLANDER 850,2019-08-19,13,15,MD,US,28,521
OUTLANDER 450,2019-08-19,13,7,MD,US,20,456
OUTLANDER 1000,2019-08-26,9,1,MD,US,10,470
OUTLANDER 850,2019-08-26,8,5,MD,US,13,534
OUTLANDER 450,2019-08-26,11,6,MD,US,17,473
OUTLANDER 1000,2019-09-02,1,11,MD,US,12,482
OUTLANDER 850,2019-09-02,15,4,MD,US,19,553
OUTLANDER 450,2019-09-02,8,2,MD,US,10,483
OUTLANDER 1000,2019-09-09,0,7,MD,US,7,489
OUTLANDER 850,2019-09-09,6,14,MD,US,20,573
OUTLANDER 450,2019-09-09,7,13,MD,US,20,503
OUTLANDER 1000,2019-09-16,4,2,MD,US,6,495
OUTLANDER 850,2019-09-16,15,1,MD,US,16,589
OUTLANDER 450,2019-09-16,9,13,MD,US,22,525
OUTLANDER 1000,2019-09-23,4,15,MD,US,19,514
OUTLANDER 850,2019-09-23,12,10,MD,US,22,611
OUTLANDER 450,2019-09-23,14,11,MD,US,25,550
OUTLANDER 1000,2019-09-30,3,10,MD,US,13,527
OUTLANDER 850,2019-09-30,12,0,MD,US,12,623
OUTLANDER 450,2019-09-30,5,4,MD,US,9,559
OUTLANDER 1000,2019-10-07,3,12,MD,US,15,542
OUTLANDER 850,2019-10-07,12,9,MD,US,21,644
OUTLANDER 450,2019-10-07,5,1,MD,US,6,565
OUTLANDER 1000,2019-10-14,1,3,MD,US,4,546
OUTLANDER 850,2019-10-14,4,12,MD,US,16,660
OUTLANDER 450,2019-10-14,12,3,MD,US,15,580
OUTLANDER 1000,2019-10-21,13,13,MD,US,26,572
OUTLANDER 850,2019-10-21,14,4,MD,US,18,678
OUTLANDER 450,2019-10-21,11,7,MD,US,18,598
OUTLANDER 1000,2019-10-28,8,1,MD,US,9,581
OUTLANDER 850,2019-10-28,13,11,MD,US,24,702
OUTLANDER 450,2019-10-28,11,10,MD,US,21,619
OUTLANDER 1000,2019-11-04,12,4,MD,US,16,597
OUTLANDER 850,2019-11-04,14,10,MD,US,24,726
OUTLANDER 450,2019-11-04,5,3,MD,US,8,627
OUTLANDER 1000,2019-11-11,7,3,MD,US,10,607
OUTLANDER 850,2019-11-11,9,13,MD,US,22,748
OUTLANDER 450,2019-11-11,1,7,MD,US,8,635
OUTLANDER 1000,2019-11-18,6,14,MD,US,20,627
OUTLANDER 850,2019-11-18,6,12,MD,US,18,766
OUTLANDER 450,2019-11-18,10,8,MD,US,18,653
OUTLANDER 1000,2019-11-25,6,3,MD,US,9,636
OUTLANDER 850,2019-11-25,3,12,MD,US,15,781
OUTLANDER 450,2019-11-25,12,13,MD,US,25,678
OUTLANDER 1000,2019-12-02,15,6,MD,US,21,657
OUTLANDER 850,2019-12-02,14,7,MD,US,21,802
OUTLANDER 450,2019-12-02,9,13,MD,US,22,700
OUTLANDER 1000,2019-12-09,11,3,MD,US,14,671
OUTLANDER 850,2019-12-09,14,3,MD,US,17,819
OUTLANDER 450,2019-12-09,1,10,MD,US,11,711
OUTLANDER 1000,2019-12-16,0,8,MD,US,8,679
OUTLANDER 850,2019-12-16,1,2,MD,US,3,822
OUTLANDER 450,2019-12-16,11,4,MD,US,15,726
OUTLANDER 1000,2019-12-23,5,3,MD,US,8,687
OUTLANDER 850,2019-12-23,15,9,MD,US,24,846
OUTLANDER 450,2019-12-23,8,3,MD,US,11,737
OUTLANDER 1000,2019-12-30,4,8,MD,US,12,699
OUTLANDER 850,2019-12-30,14,9,MD,US,23,869
OUTLANDER 450,2019-12-30,7,9,MD,US,16,753
OUTLANDER 1000,2020-01-06,10,14,MD,US,24,723
OUTLANDER 850,2020-01-06,1,3,MD,US,4,873
OUTLANDER 450,2020-01-06,1,8,MD,US,9,762
OUTLANDER 1000,2020-01-13,10,6,MD,US,16,739
OUTLANDER 850,2020-01-13,2,8,MD,US,10,883
OUTLANDER 450,2020-01-13,13,11,MD,US,24,786
OUTLANDER 1000,2020-01-20,8,5,MD,US,13,752
OUTLANDER 850,2020-01-20,2,5,MD,US,7,890
OUTLANDER 450,2020-01-20,8,3,MD,US,11,797
OUTLANDER 1000,2020-01-27,12,15,MD,US,27,779
OUTLANDER 850,2020-01-27,11,2,MD,US,13,903
OUTLANDER 450,2020-01-27,3,3,MD,US,6,803
OUTLANDER 1000,2020-02-03,10,3,MD,US,13,792
OUTLANDER 850,2020-02-03,7,8,MD,US,15,918
OUTLANDER 450,2020-02-03,5,13,MD,US,18,821
OUTLANDER 1000,2020-02-10,14,14,MD,US,28,820
OUTLANDER 850,2020-02-10,8,11,MD,US,19,937
OUTLANDER 450,2020-02-10,4,2,MD,US,6,827
OUTLANDER 1000,2020-02-17,0,11,MD,US,11,831
OUTLANDER 850,2020-02-17,6,4,MD,US,10,947
OUTLANDER 450,2020-02-17,11,0,MD,US,11,838
OUTLANDER 1000,2020-02-24,3,8,MD,US,11,842
OUTLANDER 850,2020-02-24,3,14,MD,US,17,964
OUTLANDER 450,2020-02-24,11,6,MD,US,17,855
OUTLANDER 1000,2020-03-02,1,15,MD,US,16,858
OUTLANDER 850,2020-03-02,11,7,MD,US,18,982
OUTLANDER 450,2020-03-02,6,8,MD,US,14,869
OUTLANDER 1000,2020-03-09,4,3,MD,US,7,865
OUTLANDER 850,2020-03-09,2,7,MD,US,9,991
OUTLANDER 450,2020-03-09,15,4,MD,US,19,888
OUTLANDER 1000,2020-03-16,5,4,MD,US,9,874
OUTLANDER 850,2020-03-16,0,13,MD,US,13,1004
OUTLANDER 450,2020-03-16,5,10,MD,US,15,903
OUTLANDER 1000,2020-03-23,11,1,MD,US,12,886
OUTLANDER 850,2020-03-23,5,1,MD,US,6,1010
OUTLANDER 450,2020-03-23,14,2,MD,US,16,919
OUTLANDER 1000,2020-03-30,14,4,MD,US,18,904
OUTLANDER 850,2020-03-30,0,13,MD,US,13,1023
OUTLANDER 450,2020-03-30,14,1,MD,US,15,934
OUTLANDER 1000,2020-04-06,6,3,MD,US,9,913
OUTLANDER 850,2020-04-06,14,1,MD,US,15,1038
OUTLANDER 450,2020-04-06,8,2,MD,US,10,944
OUTLANDER 1000,2020-04-13,0,9,MD,US,9,922
OUTLANDER 850,2020-04-13,7,12,MD,US,19,1057
OUTLANDER 450,2020-04-13,5,10,MD,US,15,959
OUTLANDER 1000,2020-04-20,11,8,MD,US,19,941
OUTLANDER 850,2020-04-20,12,2,MD,US,14,1071
OUTLANDER 450,2020-04-20,1,15,MD,US,16,975
OUTLANDER 1000,2020-04-27,2,4,MD,US,6,947
OUTLANDER 850,2020-04-27,5,7,MD,US,12,1083
OUTLANDER 450,2020-04-27,10,12,MD,US,22,997
OUTLANDER 1000,2020-05-04,10,9,MD,US,19,966
OUTLANDER 850,2020-05-04,11,14,MD,US,25,1108
OUTLANDER 450,2020-05-04,15,12,MD,US,27,1024
OUTLANDER 1000,2020-05-11,14,1,MD,US,15,981
OUTLANDER 850,2020-05-11,8,5,MD,US,13,1121
OUTLANDER 450,2020-05-11,0,12,MD,US,12,1036
OUTLANDER 1000,2020-05-18,13,6,MD,US,19,1000
OUTLANDER 850,2020-05-18,4,12,MD,US,16,1137
OUTLANDER 450,2020-05-18,13,6,MD,US,19,1055
OUTLANDER 1000,2020-05-25,12,2,MD,US,14,1014
OUTLANDER 850,2020-05-25,12,12,MD,US,24,1161
OUTLANDER 450,2020-05-25,6,10,MD,US,16,1071
OUTLANDER 1000,2020-06-01,3,13,MD,US,16,1030
OUTLANDER 850,2020-06-01,11,4,MD,US,15,1176
OUTLANDER 450,2020-06-01,3,8,MD,US,11,1082
OUTLANDER 1000,2020-06-08,4,2,MD,US,6,1036
OUTLANDER 850,2020-06-08,9,3,MD,US,12,1188
OUTLANDER 450,2020-06-08,15,2,MD,US,17,1099
OUTLANDER 1000,2020-06-15,4,2,MD,US,6,1042
OUTLANDER 850,2020-06-15,11,5,MD,US,16,1204
OUTLANDER 450,2020-06-15,5,4,MD,US,9,1108
OUTLANDER 1000,2020-06-22,0,10,MD,US,10,1052
OUTLANDER 850,2020-06-22,11,8,MD,US,19,1223
OUTLANDER 450,2020-06-22,10,9,MD,US,19,1127
OUTLANDER 1000,2020-06-29,8,6,MD,US,14,1066
OUTLANDER 850,2020-06-29,4,8,MD,US,12,1235
OUTLANDER 450,2020-06-29,9,13,MD,US,22,1149
OUTLANDER 1000,2020-07-06,15,2,MD,US,17,1083
OUTLANDER 850,2020-07-06,2,1,MD,US,3,1238
OUTLANDER 450,2020-07-06,6,2,MD,US,8,1157
OUTLANDER 1000,2020-07-13,9,7,MD,US,16,1099
OUTLANDER 850,2020-07-13,1,13,MD,US,14,1252
OUTLANDER 450,2020-07-13,6,7,MD,US,13,1170
OUTLANDER 1000,2020-07-20,10,9,MD,US,19,1118
OUTLANDER 850,2020-07-20,13,5,MD,US,18,1270
OUTLANDER 450,2020-07-20,2,9,MD,US,11,1181
OUTLANDER 1000,2020-07-27,12,4,MD,US,16,1134
OUTLANDER 850,2020-07-27,14,7,MD,US,21,1291
OUTLANDER 450,2020-07-27,3,9,MD,US,12,1193
OUTLANDER 1000,2020-08-03,4,10,MD,US,14,1148
OUTLANDER 850,2020-08-03,1,3,MD,US,4,1295
OUTLANDER 450,2020-08-03,10,10,MD,US,20,1213
OUTLANDER 1000,2020-08-10,5,11,MD,US,16,1164
OUTLANDER 850,2020-08-10,10,3,MD,US,13,1308
OUTLANDER 450,2020-08-10,1,14,MD,US,15,1228
OUTLANDER 1000,2020-08-17,12,2,MD,US,14,1178
OUTLANDER 850,2020-08-17,0,10,MD,US,10,1318
OUTLANDER 450,2020-08-17,8,4,MD,US,12,1240
OUTLANDER 1000,2020-08-24,6,7,MD,US,13,1191
OUTLANDER 850,2020-08-24,9,0,MD,US,9,1327
OUTLANDER 450,2020-08-24,3,11,MD,US,14,1254
OUTLANDER 1000,2020-08-31,0,5,MD,US,5,1196
OUTLANDER 850,2020-08-31,3,11,MD,US,14,1341
OUTLANDER 450,2020-08-31,11,14,MD,US,25,1279
OUTLANDER 1000,2020-09-07,8,7,MD,US,15,1211
OUTLANDER 850,2020-09-07,6,13,MD,US,19,1360
OUTLANDER 450,2020-09-07,11,10,MD,US,21,1300
OUTLANDER 1000,2020-09-14,10,6,MD,US,16,1227
OUTLANDER 850,2020-09-14,14,7,MD,US,21,1381
OUTLANDER 450,2020-09-14,4,1,MD,US,5,1305
OUTLANDER 1000,2020-09-21,10,11,MD,US,21,1248
OUTLANDER 850,2020-09-21,8,5,MD,US,13,1394
OUTLANDER 450,2020-09-21,1,12,MD,US,13,1318
OUTLANDER 1000,2020-09-28,6,6,MD,US,12,1260
OUTLANDER 850,2020-09-28,14,1,MD,US,15,1409
OUTLANDER 450,2020-09-28,7,3,MD,US,10,1328
OUTLANDER 1000,2020-10-05,7,2,MD,US,9,1269
OUTLANDER 850,2020-10-05,4,11,MD,US,15,1424
OUTLANDER 450,2020-10-05,7,10,MD,US,17,1345
OUTLANDER 1000,2020-10-12,9,14,MD,US,23,1292
OUTLANDER 850,2020-10-12,15,4,MD,US,19,1443
OUTLANDER 450,2020-10-12,3,4,MD,US,7,1352
OUTLANDER 1000,2020-10-19,8,7,MD,US,15,1307
OUTLANDER 850,2020-10-19,14,11,MD,US,25,1468
OUTLANDER 450,2020-10-19,9,11,MD,US,20,1372
OUTLANDER 1000,2020-10-26,10,8,MD,US,18,1325
OUTLANDER 850,2020-10-26,9,7,MD,US,16,1484
OUTLANDER 450,2020-10-26,5,2,MD,US,7,1379
OUTLANDER 1000,2020-11-02,5,9,MD,US,14,1339
OUTLANDER 850,2020-11-02,2,8,MD,US,10,1494
OUTLANDER 450,2020-11-02,7,12,MD,US,19,1398
OUTLANDER 1000,2020-11-09,1,8,MD,US,9,1348
OUTLANDER 850,2020-11-09,14,10,MD,US,24,1518
OUTLANDER 450,2020-11-09,12,5,MD,US,17,1415
OUTLANDER 1000,2020-11-16,5,4,MD,US,9,1357
OUTLANDER 850,2020-11-16,3,4,MD,US,7,1525
OUTLANDER 450,2020-11-16,10,5,MD,US,15,1430
OUTLANDER 1000,2020-11-23,4,1,MD,US,5,1362
OUTLANDER 850,2020-11-23,11,9,MD,US,20,1545
OUTLANDER 450,2020-11-23,14,1,MD,US,15,1445
OUTLANDER 1000,2020-11-30,9,5,MD,US,14,1376
OUTLANDER 850,2020-11-30,10,13,MD,US,23,1568
OUTLANDER 450,2020-11-30,8,10,MD,US,18,1463
OUTLANDER 1000,2020-12-07,6,9,MD,US,15,1391
OUTLANDER 850,2020-12-07,1,12,MD,US,13,1581
OUTLANDER 450,2020-12-07,12,11,MD,US,23,1486
OUTLANDER 1000,2020-12-14,3,14,MD,US,17,1408
OUTLANDER 850,2020-12-14,6,8,MD,US,14,1595
OUTLANDER 450,2020-12-14,4,14,MD,US,18,1504
OUTLANDER 1000,2020-12-21,9,8,MD,US,17,1425
OUTLANDER 850,2020-12-21,2,9,MD,US,11,1606
OUTLANDER 450,2020-12-21,2,2,MD,US,4,1508
OUTLANDER 1000,2020-12-28,5,13,MD,US,18,1443
OUTLANDER 850,2020-12-28,2,4,MD,US,6,1612
OUTLANDER 450,2020-12-28,14,0,MD,US,14,1522
OUTLANDER 1000,2021-01-04,13,1,MD,US,14,1457
OUTLANDER 850,2021-01-04,8,8,MD,US,16,1628
OUTLANDER 450,2021-01-04,12,3,MD,US,15,1537
OUTLANDER 1000,2021-01-11,6,12,MD,US,18,1475
OUTLANDER 850,2021-01-11,5,8,MD,US,13,1641
OUTLANDER 450,2021-01-11,13,0,MD,US,13,1550
OUTLANDER 1000,2021-01-18,13,15,MD,US,28,1503
OUTLANDER 850,2021-01-18,6,7,MD,US,13,1654
OUTLANDER 450,2021-01-18,1,14,MD,US,15,1565
OUTLANDER 1000,2021-01-25,4,11,MD,US,15,1518
OUTLANDER 850,2021-01-25,9,15,MD,US,24,1678
OUTLANDER 450,2021-01-25,3,15,MD,US,18,1583
OUTLANDER 1000,2021-02-01,10,9,MD,US,19,1537
OUTLANDER 850,2021-02-01,9,5,MD,US,14,1692
OUTLANDER 450,2021-02-01,12,10,MD,US,22,1605
OUTLANDER 1000,2021-02-08,5,4,MD,US,9,1546
OUTLANDER 850,2021-02-08,14,7,MD,US,21,1713
OUTLANDER 450,2021-02-08,1,14,MD,US,15,1620
OUTLANDER 1000,2021-02-15,14,13,MD,US,27,1573
OUTLANDER 850,2021-02-15,4,6,MD,US,10,1723
OUTLANDER 450,2021-02-15,12,6,MD,US,18,1638
OUTLANDER 1000,2021-02-22,9,6,MD,US,15,1588
OUTLANDER 850,2021-02-22,13,14,MD,US,27,1750
OUTLANDER 450,2021-02-22,3,2,MD,US,5,1643
OUTLANDER 1000,2021-03-01,1,1,MD,US,2,1590
OUTLANDER 850,2021-03-01,9,5,MD,US,14,1764
OUTLANDER 450,2021-03-01,6,12,MD,US,18,1661
OUTLANDER 1000,2021-03-08,9,9,MD,US,18,1608
OUTLANDER 850,2021-03-08,4,7,MD,US,11,1775
OUTLANDER 450,2021-03-08,9,6,MD,US,15,1676
OUTLANDER 1000,2021-03-15,10,5,MD,US,15,1623
OUTLANDER 850,2021-03-15,10,4,MD,US,14,1789
OUTLANDER 450,2021-03-15,3,6,MD,US,9,1685
OUTLANDER 1000,2021-03-22,8,13,MD,US,21,1644
OUTLANDER 850,2021-03-22,4,11,MD,US,15,1804
OUTLANDER 450,2021-03-22,8,3,MD,US,11,1696
OUTLANDER 1000,2021-03-29,12,5,MD,US,17,1661
OUTLANDER 850,2021-03-29,13,3,MD,US,16,1820
OUTLANDER 450,2021-03-29,0,7,MD,US,7,1703
OUTLANDER 1000,2021-04-05,1,6,MD,US,7,1668
OUTLANDER 850,2021-04-05,10,10,MD,US,20,1840
OUTLANDER 450,2021-04-05,10,14,MD,US,24,1727
OUTLANDER 1000,2021-04-12,14,5,MD,US,19,1687
OUTLANDER 850,2021-04-12,13,11,MD,US,24,1864
OUTLANDER 450,2021-04-12,11,1,MD,US,12,1739
OUTLANDER 1000,2021-04-19,5,6,MD,US,11,1698
OUTLANDER 850,2021-04-19,10,7,MD,US,17,1881
OUTLANDER 450,2021-04-19,5,12,MD,US,17,1756
OUTLANDER 1000,2021-04-26,5,4,MD,US,9,1707
OUTLANDER 850,2021-04-26,2,7,MD,US,9,1890
OUTLANDER 450,2021-04-26,7,13,MD,US,20,1776
OUTLANDER 1000,2021-05-03,10,14,MD,US,24,1731
OUTLANDER 850,2021-05-03,9,4,MD,US,13,1903
OUTLANDER 450,2021-05-03,12,2,MD,US,14,1790
OUTLANDER 1000,2021-05-10,5,12,MD,US,17,1748
OUTLANDER 850,2021-05-10,12,7,MD,US,19,1922
OUTLANDER 450,2021-05-10,3,10,MD,US,13,1803
OUTLANDER 1000,2021-05-17,12,8,MD,US,20,1768
OUTLANDER 850,2021-05-17,12,10,MD,US,22,1944
OUTLANDER 450,2021-05-17,15,7,MD,US,22,1825
OUTLANDER 1000,2021-05-24,11,14,MD,US,25,1793
OUTLANDER 850,2021-05-24,14,15,MD,US,29,1973
OUTLANDER 450,2021-05-24,13,8,MD,US,21,1846
OUTLANDER 1000,2021-05-31,2,6,MD,US,8,1801
OUTLANDER 850,2021-05-31,2,5,MD,US,7,1980
OUTLANDER 450,2021-05-31,6,6,MD,US,12,1858
OUTLANDER 1000,2021-06-07,1,8,MD,US,9,1810
OUTLANDER 850,2021-06-07,13,6,MD,US,19,1999
OUTLANDER 450,2021-06-07,11,4,MD,US,15,1873
OUTLANDER 1000,2021-06-14,5,9,MD,US,14,1824
OUTLANDER 850,2021-06-14,12,10,MD,US,22,2021
OUTLANDER 450,2021-06-14,0,14,MD,US,14,1887
OUTLANDER 1000,2021-06-21,15,6,MD,US,21,1845
OUTLANDER 850,2021-06-21,5,14,MD,US,19,2040
OUTLANDER 450,2021-06-21,3,2,MD,US,5,1892
OUTLANDER 1000,2021-06-28,5,2,MD,US,7,1852
OUTLANDER 850,2021-06-28,3,3,MD,US,6,2046
OUTLANDER 450,2021-06-28,12,10,MD,US,22,1914
OUTLANDER 1000,2021-07-05,8,2,MD,US,10,1862
OUTLANDER 850,2021-07-05,1,2,MD,US,3,2049
OUTLANDER 450,2021-07-05,12,6,MD,US,18,1932
OUTLANDER 1000,2021-07-12,6,4,MD,US,10,1872
OUTLANDER 850,2021-07-12,14,10,MD,US,24,2073
OUTLANDER 450,2021-07-12,15,3,MD,US,18,1950
OUTLANDER 1000,2021-07-19,11,4,MD,US,15,1887
OUTLANDER 850,2021-07-19,9,9,MD,US,18,2091
OUTLANDER 450,2021-07-19,0,14,MD,US,14,1964
OUTLANDER 1000,2021-07-26,0,14,MD,US,14,1901
OUTLANDER 850,2021-07-26,11,12,MD,US,23,2114
OUTLANDER 450,2021-07-26,9,3,MD,US,12,1976
OUTLANDER 1000,2021-08-02,13,12,MD,US,25,1926
OUTLANDER 850,2021-08-02,1,12,MD,US,13,2127
OUTLANDER 450,2021-08-02,5,8,MD,US,13,1989
OUTLANDER 1000,2021-08-09,2,14,MD,US,16,1942
OUTLANDER 850,2021-08-09,12,1,MD,US,13,2140
OUTLANDER 450,2021-08-09,6,2,MD,US,8,1997
OUTLANDER 1000,2021-08-16,8,3,MD,US,11,1953
OUTLANDER 850,2021-08-16,11,14,MD,US,25,2165
OUTLANDER 450,2021-08-16,5,11,MD,US,16,2013
OUTLANDER 1000,2021-08-23,8,6,MD,US,14,1967
OUTLANDER 850,2021-08-23,0,9,MD,US,9,2174
OUTLANDER 450,2021-08-23,3,15,MD,US,18,2031
OUTLANDER 1000,2021-08-30,4,9,MD,US,13,1980
OUTLANDER 850,2021-08-30,7,1,MD,US,8,2182
OUTLANDER 450,2021-08-30,3,5,MD,US,8,2039
OUTLANDER 1000,2021-09-06,7,5,MD,US,12,1992
OUTLANDER 850,2021-09-06,12,15,MD,US,27,2209
OUTLANDER 450,2021-09-06,6,0,MD,US,6,2045
OUTLANDER 1000,2021-09-13,5,2,MD,US,7,1999
OUTLANDER 850,2021-09-13,10,2,MD,US,12,2221
OUTLANDER 450,2021-09-13,15,1,MD,US,16,2061
OUTLANDER 1000,2021-09-20,14,0,MD,US,14,2013
OUTLANDER 850,2021-09-20,14,9,MD,US,23,2244
OUTLANDER 450,2021-09-20,7,5,MD,US,12,2073
OUTLANDER 1000,2021-09-27,7,12,MD,US,19,2032
OUTLANDER 850,2021-09-27,3,13,MD,US,16,2260
OUTLANDER 450,2021-09-27,4,14,MD,US,18,2091
OUTLANDER 1000,2021-10-04,5,7,MD,US,12,2044
OUTLANDER 850,2021-10-04,14,9,MD,US,23,2283
OUTLANDER 450,2021-10-04,6,6,MD,US,12,2103
OUTLANDER 1000,2021-10-11,3,11,MD,US,14,2058
OUTLANDER 850,2021-10-11,15,5,MD,US,20,2303
OUTLANDER 450,2021-10-11,4,6,MD,US,10,2113
OUTLANDER 1000,2021-10-18,2,6,MD,US,8,2066
OUTLANDER 850,2021-10-18,9,12,MD,US,21,2324
OUTLANDER 450,2021-10-18,2,2,MD,US,4,2117
OUTLANDER 1000,2021-10-25,13,10,MD,US,23,2089
OUTLANDER 850,2021-10-25,13,9,MD,US,22,2346
OUTLANDER 450,2021-10-25,9,8,MD,US,17,2134
OUTLANDER 1000,2021-11-01,6,10,MD,US,16,2105
OUTLANDER 850,2021-11-01,8,3,MD,US,11,2357
OUTLANDER 450,2021-11-01,11,10,MD,US,21,2155
OUTLANDER 1000,2021-11-08,10,13,MD,US,23,2128
OUTLANDER 850,2021-11-08,2,13,MD,US,15,2372
OUTLANDER 450,2021-11-08,5,8,MD,US,13,2168
OUTLANDER 1000,2021-11-15,0,3,MD,US,3,2131
OUTLANDER 850,2021-11-15,7,6,MD,US,13,2385
OUTLANDER 450,2021-11-15,8,2,MD,US,10,2178
OUTLANDER 1000,2021-11-22,4,12,MD,US,16,2147
OUTLANDER 850,2021-11-22,2,11,MD,US,13,2398
OUTLANDER 450,2021-11-22,4,9,MD,US,13,2191
OUTLANDER 1000,2021-11-29,6,2,MD,US,8,2155
OUTLANDER 850,2021-11-29,4,3,MD,US,7,2405
OUTLANDER 450,2021-11-29,5,2,MD,US,7,2198
OUTLANDER 1000,2021-12-06,9,1,MD,US,10,2165
OUTLANDER 850,2021-12-06,9,14,MD,US,23,2428
OUTLANDER 450,2021-12-06,15,4,MD,US,19,2217
OUTLANDER 1000,2021-12-13,14,9,MD,US,23,2188
OUTLANDER 850,2021-12-13,0,2,MD,US,2,2430
OUTLANDER 450,2021-12-13,4,4,MD,US,8,2225
OUTLANDER 1000,2021-12-20,10,1,MD,US,11,2199
OUTLANDER 850,2021-12-20,3,8,MD,US,11,2441
OUTLANDER 450,2021-12-20,5,4,MD,US,9,2234
OUTLANDER 1000,2021-12-27,15,3,MD,US,18,2217
OUTLANDER 850,2021-12-27,0,6,MD,US,6,2447
OUTLANDER 450,2021-12-27,7,13,MD,US,20,2254
OUTLANDER 1000,2019-01-07,15,5,MA,US,20,20
OUTLANDER 850,2019-01-07,9,10,MA,US,19,19
OUTLANDER 450,2019-01-07,0,8,MA,US,8,8
OUTLANDER 1000,2019-01-14,12,4,MA,US,16,36
OUTLANDER 850,2019-01-14,5,11,MA,US,16,35
OUTLANDER 450,2019-01-14,14,6,MA,US,20,28
OUTLANDER 1000,2019-01-21,14,5,MA,US,19,55
OUTLANDER 850,2019-01-21,1,9,MA,US,10,45
OUTLANDER 450,2019-01-21,1,6,MA,US,7,35
OUTLANDER 1000,2019-01-28,1,10,MA,US,11,66
OUTLANDER 850,2019-01-28,3,3,MA,US,6,51
OUTLANDER 450,2019-01-28,9,8,MA,US,17,52
OUTLANDER 1000,2019-02-04,5,12,MA,US,17,83
OUTLANDER 850,2019-02-04,2,2,MA,US,4,55
OUTLANDER 450,2019-02-04,2,11,MA,US,13,65
OUTLANDER 1000,2019-02-11,2,3,MA,US,5,88
OUTLANDER 850,2019-02-11,6,5,MA,US,11,66
OUTLANDER 450,2019-02-11,8,7,MA,US,15,80
OUTLANDER 1000,2019-02-18,3,4,MA,US,7,95
OUTLANDER 850,2019-02-18,14,9,MA,US,23,89
OUTLANDER 450,2019-02-18,6,11,MA,US,17,97
OUTLANDER 1000,2019-02-25,14,6,MA,US,20,115
OUTLANDER 850,2019-02-25,14,6,MA,US,20,109
OUTLANDER 450,2019-02-25,3,13,MA,US,16,113
OUTLANDER 1000,2019-03-04,10,6,MA,US,16,131
OUTLANDER 850,2019-03-04,11,9,MA,US,20,129
OUTLANDER 450,2019-03-04,13,11,MA,US,24,137
OUTLANDER 1000,2019-03-11,7,3,MA,US,10,141
OUTLANDER 850,2019-03-11,12,7,MA,US,19,148
OUTLANDER 450,2019-03-11,3,14,MA,US,17,154
OUTLANDER 1000,2019-03-18,1,3,MA,US,4,145
OUTLANDER 850,2019-03-18,8,3,MA,US,11,159
OUTLANDER 450,2019-03-18,12,1,MA,US,13,167
OUTLANDER 1000,2019-03-25,10,10,MA,US,20,165
OUTLANDER 850,2019-03-25,10,8,MA,US,18,177
OUTLANDER 450,2019-03-25,7,14,MA,US,21,188
OUTLANDER 1000,2019-04-01,14,9,MA,US,23,188
OUTLANDER 850,2019-04-01,13,2,MA,US,15,192
OUTLANDER 450,2019-04-01,14,11,MA,US,25,213
OUTLANDER 1000,2019-04-08,0,13,MA,US,13,201
OUTLANDER 850,2019-04-08,1,12,MA,US,13,205
OUTLANDER 450,2019-04-08,12,4,MA,US,16,229
OUTLANDER 1000,2019-04-15,0,3,MA,US,3,204
OUTLANDER 850,2019-04-15,14,13,MA,US,27,232
OUTLANDER 450,2019-04-15,14,8,MA,US,22,251
OUTLANDER 1000,2019-04-22,1,11,MA,US,12,216
OUTLANDER 850,2019-04-22,8,11,MA,US,19,251
OUTLANDER 450,2019-04-22,7,6,MA,US,13,264
OUTLANDER 1000,2019-04-29,9,14,MA,US,23,239
OUTLANDER 850,2019-04-29,4,9,MA,US,13,264
OUTLANDER 450,2019-04-29,14,7,MA,US,21,285
OUTLANDER 1000,2019-05-06,2,4,MA,US,6,245
OUTLANDER 850,2019-05-06,10,6,MA,US,16,280
OUTLANDER 450,2019-05-06,3,7,MA,US,10,295
OUTLANDER 1000,2019-05-13,11,6,MA,US,17,262
OUTLANDER 850,2019-05-13,9,5,MA,US,14,294
OUTLANDER 450,2019-05-13,1,8,MA,US,9,304
OUTLANDER 1000,2019-05-20,0,5,MA,US,5,267
OUTLANDER 850,2019-05-20,3,3,MA,US,6,300
OUTLANDER 450,2019-05-20,2,0,MA,US,2,306
OUTLANDER 1000,2019-05-27,5,8,MA,US,13,280
OUTLANDER 850,2019-05-27,14,12,MA,US,26,326
OUTLANDER 450,2019-05-27,12,2,MA,US,14,320
OUTLANDER 1000,2019-06-03,8,5,MA,US,13,293
OUTLANDER 850,2019-06-03,9,12,MA,US,21,347
OUTLANDER 450,2019-06-03,13,8,MA,US,21,341
OUTLANDER 1000,2019-06-10,3,5,MA,US,8,301
OUTLANDER 850,2019-06-10,10,10,MA,US,20,367
OUTLANDER 450,2019-06-10,11,6,MA,US,17,358
OUTLANDER 1000,2019-06-17,6,3,MA,US,9,310
OUTLANDER 850,2019-06-17,8,10,MA,US,18,385
OUTLANDER 450,2019-06-17,15,3,MA,US,18,376
OUTLANDER 1000,2019-06-24,4,1,MA,US,5,315
OUTLANDER 850,2019-06-24,9,11,MA,US,20,405
OUTLANDER 450,2019-06-24,1,5,MA,US,6,382
OUTLANDER 1000,2019-07-01,9,10,MA,US,19,334
OUTLANDER 850,2019-07-01,11,14,MA,US,25,430
OUTLANDER 450,2019-07-01,4,12,MA,US,16,398
OUTLANDER 1000,2019-07-08,11,13,MA,US,24,358
OUTLANDER 850,2019-07-08,8,5,MA,US,13,443
OUTLANDER 450,2019-07-08,6,10,MA,US,16,414
OUTLANDER 1000,2019-07-15,0,6,MA,US,6,364
OUTLANDER 850,2019-07-15,9,15,MA,US,24,467
OUTLANDER 450,2019-07-15,15,8,MA,US,23,437
OUTLANDER 1000,2019-07-22,7,6,MA,US,13,377
OUTLANDER 850,2019-07-22,12,14,MA,US,26,493
OUTLANDER 450,2019-07-22,7,3,MA,US,10,447
OUTLANDER 1000,2019-07-29,6,6,MA,US,12,389
OUTLANDER 850,2019-07-29,5,0,MA,US,5,498
OUTLANDER 450,2019-07-29,6,12,MA,US,18,465
OUTLANDER 1000,2019-08-05,12,11,MA,US,23,412
OUTLANDER 850,2019-08-05,3,9,MA,US,12,510
OUTLANDER 450,2019-08-05,1,1,MA,US,2,467
OUTLANDER 1000,2019-08-12,3,10,MA,US,13,425
OUTLANDER 850,2019-08-12,12,12,MA,US,24,534
OUTLANDER 450,2019-08-12,4,6,MA,US,10,477
OUTLANDER 1000,2019-08-19,11,2,MA,US,13,438
OUTLANDER 850,2019-08-19,0,2,MA,US,2,536
OUTLANDER 450,2019-08-19,5,6,MA,US,11,488
OUTLANDER 1000,2019-08-26,5,8,MA,US,13,451
OUTLANDER 850,2019-08-26,8,6,MA,US,14,550
OUTLANDER 450,2019-08-26,6,15,MA,US,21,509
OUTLANDER 1000,2019-09-02,3,0,MA,US,3,454
OUTLANDER 850,2019-09-02,9,10,MA,US,19,569
OUTLANDER 450,2019-09-02,4,6,MA,US,10,519
OUTLANDER 1000,2019-09-09,6,5,MA,US,11,465
OUTLANDER 850,2019-09-09,1,13,MA,US,14,583
OUTLANDER 450,2019-09-09,7,13,MA,US,20,539
OUTLANDER 1000,2019-09-16,12,11,MA,US,23,488
OUTLANDER 850,2019-09-16,12,12,MA,US,24,607
OUTLANDER 450,2019-09-16,12,8,MA,US,20,559
OUTLANDER 1000,2019-09-23,7,6,MA,US,13,501
OUTLANDER 850,2019-09-23,13,13,MA,US,26,633
OUTLANDER 450,2019-09-23,13,6,MA,US,19,578
OUTLANDER 1000,2019-09-30,6,2,MA,US,8,509
OUTLANDER 850,2019-09-30,6,7,MA,US,13,646
OUTLANDER 450,2019-09-30,9,8,MA,US,17,595
OUTLANDER 1000,2019-10-07,1,13,MA,US,14,523
OUTLANDER 850,2019-10-07,6,2,MA,US,8,654
OUTLANDER 450,2019-10-07,8,8,MA,US,16,611
OUTLANDER 1000,2019-10-14,7,15,MA,US,22,545
OUTLANDER 850,2019-10-14,8,11,MA,US,19,673
OUTLANDER 450,2019-10-14,12,2,MA,US,14,625
OUTLANDER 1000,2019-10-21,10,10,MA,US,20,565
OUTLANDER 850,2019-10-21,8,3,MA,US,11,684
OUTLANDER 450,2019-10-21,12,1,MA,US,13,638
OUTLANDER 1000,2019-10-28,11,4,MA,US,15,580
OUTLANDER 850,2019-10-28,4,10,MA,US,14,698
OUTLANDER 450,2019-10-28,10,7,MA,US,17,655
OUTLANDER 1000,2019-11-04,13,13,MA,US,26,606
OUTLANDER 850,2019-11-04,7,5,MA,US,12,710
OUTLANDER 450,2019-11-04,14,5,MA,US,19,674
OUTLANDER 1000,2019-11-11,7,15,MA,US,22,628
OUTLANDER 850,2019-11-11,4,10,MA,US,14,724
OUTLANDER 450,2019-11-11,4,1,MA,US,5,679
OUTLANDER 1000,2019-11-18,0,12,MA,US,12,640
OUTLANDER 850,2019-11-18,3,12,MA,US,15,739
OUTLANDER 450,2019-11-18,7,5,MA,US,12,691
OUTLANDER 1000,2019-11-25,14,3,MA,US,17,657
OUTLANDER 850,2019-11-25,2,2,MA,US,4,743
OUTLANDER 450,2019-11-25,14,3,MA,US,17,708
OUTLANDER 1000,2019-12-02,6,7,MA,US,13,670
OUTLANDER 850,2019-12-02,15,3,MA,US,18,761
OUTLANDER 450,2019-12-02,1,8,MA,US,9,717
OUTLANDER 1000,2019-12-09,14,7,MA,US,21,691
OUTLANDER 850,2019-12-09,12,14,MA,US,26,787
OUTLANDER 450,2019-12-09,4,1,MA,US,5,722
OUTLANDER 1000,2019-12-16,3,13,MA,US,16,707
OUTLANDER 850,2019-12-16,14,11,MA,US,25,812
OUTLANDER 450,2019-12-16,10,11,MA,US,21,743
OUTLANDER 1000,2019-12-23,12,3,MA,US,15,722
OUTLANDER 850,2019-12-23,3,0,MA,US,3,815
OUTLANDER 450,2019-12-23,2,12,MA,US,14,757
OUTLANDER 1000,2019-12-30,1,0,MA,US,1,723
OUTLANDER 850,2019-12-30,4,1,MA,US,5,820
OUTLANDER 450,2019-12-30,14,13,MA,US,27,784
OUTLANDER 1000,2020-01-06,6,6,MA,US,12,735
OUTLANDER 850,2020-01-06,11,14,MA,US,25,845
OUTLANDER 450,2020-01-06,10,13,MA,US,23,807
OUTLANDER 1000,2020-01-13,13,5,MA,US,18,753
OUTLANDER 850,2020-01-13,1,4,MA,US,5,850
OUTLANDER 450,2020-01-13,1,4,MA,US,5,812
OUTLANDER 1000,2020-01-20,4,10,MA,US,14,767
OUTLANDER 850,2020-01-20,11,2,MA,US,13,863
OUTLANDER 450,2020-01-20,9,7,MA,US,16,828
OUTLANDER 1000,2020-01-27,10,7,MA,US,17,784
OUTLANDER 850,2020-01-27,12,2,MA,US,14,877
OUTLANDER 450,2020-01-27,7,7,MA,US,14,842
OUTLANDER 1000,2020-02-03,0,5,MA,US,5,789
OUTLANDER 850,2020-02-03,3,15,MA,US,18,895
OUTLANDER 450,2020-02-03,14,7,MA,US,21,863
OUTLANDER 1000,2020-02-10,5,7,MA,US,12,801
OUTLANDER 850,2020-02-10,2,12,MA,US,14,909
OUTLANDER 450,2020-02-10,9,14,MA,US,23,886
OUTLANDER 1000,2020-02-17,3,8,MA,US,11,812
OUTLANDER 850,2020-02-17,4,12,MA,US,16,925
OUTLANDER 450,2020-02-17,14,12,MA,US,26,912
OUTLANDER 1000,2020-02-24,12,3,MA,US,15,827
OUTLANDER 850,2020-02-24,8,2,MA,US,10,935
OUTLANDER 450,2020-02-24,13,8,MA,US,21,933
OUTLANDER 1000,2020-03-02,5,5,MA,US,10,837
OUTLANDER 850,2020-03-02,2,14,MA,US,16,951
OUTLANDER 450,2020-03-02,12,2,MA,US,14,947
OUTLANDER 1000,2020-03-09,13,10,MA,US,23,860
OUTLANDER 850,2020-03-09,11,5,MA,US,16,967
OUTLANDER 450,2020-03-09,4,11,MA,US,15,962
OUTLANDER 1000,2020-03-16,7,3,MA,US,10,870
OUTLANDER 850,2020-03-16,3,3,MA,US,6,973
OUTLANDER 450,2020-03-16,2,13,MA,US,15,977
OUTLANDER 1000,2020-03-23,7,0,MA,US,7,877
OUTLANDER 850,2020-03-23,2,3,MA,US,5,978
OUTLANDER 450,2020-03-23,5,9,MA,US,14,991
OUTLANDER 1000,2020-03-30,1,6,MA,US,7,884
OUTLANDER 850,2020-03-30,4,6,MA,US,10,988
OUTLANDER 450,2020-03-30,3,11,MA,US,14,1005
OUTLANDER 1000,2020-04-06,11,13,MA,US,24,908
OUTLANDER 850,2020-04-06,1,14,MA,US,15,1003
OUTLANDER 450,2020-04-06,6,12,MA,US,18,1023
OUTLANDER 1000,2020-04-13,13,1,MA,US,14,922
OUTLANDER 850,2020-04-13,6,8,MA,US,14,1017
OUTLANDER 450,2020-04-13,4,11,MA,US,15,1038
OUTLANDER 1000,2020-04-20,6,13,MA,US,19,941
OUTLANDER 850,2020-04-20,4,4,MA,US,8,1025
OUTLANDER 450,2020-04-20,4,2,MA,US,6,1044
OUTLANDER 1000,2020-04-27,14,3,MA,US,17,958
OUTLANDER 850,2020-04-27,3,11,MA,US,14,1039
OUTLANDER 450,2020-04-27,14,13,MA,US,27,1071
OUTLANDER 1000,2020-05-04,9,11,MA,US,20,978
OUTLANDER 850,2020-05-04,10,7,MA,US,17,1056
OUTLANDER 450,2020-05-04,6,5,MA,US,11,1082
OUTLANDER 1000,2020-05-11,10,8,MA,US,18,996
OUTLANDER 850,2020-05-11,1,15,MA,US,16,1072
OUTLANDER 450,2020-05-11,2,2,MA,US,4,1086
OUTLANDER 1000,2020-05-18,12,2,MA,US,14,1010
OUTLANDER 850,2020-05-18,7,10,MA,US,17,1089
OUTLANDER 450,2020-05-18,5,12,MA,US,17,1103
OUTLANDER 1000,2020-05-25,4,12,MA,US,16,1026
OUTLANDER 850,2020-05-25,9,12,MA,US,21,1110
OUTLANDER 450,2020-05-25,4,3,MA,US,7,1110
OUTLANDER 1000,2020-06-01,10,5,MA,US,15,1041
OUTLANDER 850,2020-06-01,8,13,MA,US,21,1131
OUTLANDER 450,2020-06-01,1,6,MA,US,7,1117
OUTLANDER 1000,2020-06-08,3,9,MA,US,12,1053
OUTLANDER 850,2020-06-08,12,8,MA,US,20,1151
OUTLANDER 450,2020-06-08,5,10,MA,US,15,1132
OUTLANDER 1000,2020-06-15,12,0,MA,US,12,1065
OUTLANDER 850,2020-06-15,1,11,MA,US,12,1163
OUTLANDER 450,2020-06-15,11,2,MA,US,13,1145
OUTLANDER 1000,2020-06-22,15,0,MA,US,15,1080
OUTLANDER 850,2020-06-22,12,3,MA,US,15,1178
OUTLANDER 450,2020-06-22,5,6,MA,US,11,1156
OUTLANDER 1000,2020-06-29,5,11,MA,US,16,1096
OUTLANDER 850,2020-06-29,8,4,MA,US,12,1190
OUTLANDER 450,2020-06-29,12,8,MA,US,20,1176
OUTLANDER 1000,2020-07-06,9,5,MA,US,14,1110
OUTLANDER 850,2020-07-06,14,13,MA,US,27,1217
OUTLANDER 450,2020-07-06,2,10,MA,US,12,1188
OUTLANDER 1000,2020-07-13,0,3,MA,US,3,1113
OUTLANDER 850,2020-07-13,6,10,MA,US,16,1233
OUTLANDER 450,2020-07-13,15,3,MA,US,18,1206
OUTLANDER 1000,2020-07-20,8,14,MA,US,22,1135
OUTLANDER 850,2020-07-20,2,6,MA,US,8,1241
OUTLANDER 450,2020-07-20,10,6,MA,US,16,1222
OUTLANDER 1000,2020-07-27,11,1,MA,US,12,1147
OUTLANDER 850,2020-07-27,3,15,MA,US,18,1259
OUTLANDER 450,2020-07-27,1,6,MA,US,7,1229
OUTLANDER 1000,2020-08-03,8,11,MA,US,19,1166
OUTLANDER 850,2020-08-03,13,7,MA,US,20,1279
OUTLANDER 450,2020-08-03,10,9,MA,US,19,1248
OUTLANDER 1000,2020-08-10,2,11,MA,US,13,1179
OUTLANDER 850,2020-08-10,13,14,MA,US,27,1306
OUTLANDER 450,2020-08-10,10,7,MA,US,17,1265
OUTLANDER 1000,2020-08-17,9,4,MA,US,13,1192
OUTLANDER 850,2020-08-17,10,10,MA,US,20,1326
OUTLANDER 450,2020-08-17,9,1,MA,US,10,1275
OUTLANDER 1000,2020-08-24,10,10,MA,US,20,1212
OUTLANDER 850,2020-08-24,6,9,MA,US,15,1341
OUTLANDER 450,2020-08-24,7,5,MA,US,12,1287
OUTLANDER 1000,2020-08-31,4,3,MA,US,7,1219
OUTLANDER 850,2020-08-31,5,3,MA,US,8,1349
OUTLANDER 450,2020-08-31,5,11,MA,US,16,1303
OUTLANDER 1000,2020-09-07,3,8,MA,US,11,1230
OUTLANDER 850,2020-09-07,0,15,MA,US,15,1364
OUTLANDER 450,2020-09-07,0,15,MA,US,15,1318
OUTLANDER 1000,2020-09-14,5,6,MA,US,11,1241
OUTLANDER 850,2020-09-14,12,11,MA,US,23,1387
OUTLANDER 450,2020-09-14,3,1,MA,US,4,1322
OUTLANDER 1000,2020-09-21,12,1,MA,US,13,1254
OUTLANDER 850,2020-09-21,11,11,MA,US,22,1409
OUTLANDER 450,2020-09-21,9,14,MA,US,23,1345
OUTLANDER 1000,2020-09-28,14,7,MA,US,21,1275
OUTLANDER 850,2020-09-28,6,12,MA,US,18,1427
OUTLANDER 450,2020-09-28,15,12,MA,US,27,1372
OUTLANDER 1000,2020-10-05,7,5,MA,US,12,1287
OUTLANDER 850,2020-10-05,14,0,MA,US,14,1441
OUTLANDER 450,2020-10-05,14,6,MA,US,20,1392
OUTLANDER 1000,2020-10-12,14,14,MA,US,28,1315
OUTLANDER 850,2020-10-12,4,3,MA,US,7,1448
OUTLANDER 450,2020-10-12,8,1,MA,US,9,1401
OUTLANDER 1000,2020-10-19,10,9,MA,US,19,1334
OUTLANDER 850,2020-10-19,14,15,MA,US,29,1477
OUTLANDER 450,2020-10-19,13,4,MA,US,17,1418
OUTLANDER 1000,2020-10-26,8,8,MA,US,16,1350
OUTLANDER 850,2020-10-26,0,9,MA,US,9,1486
OUTLANDER 450,2020-10-26,8,10,MA,US,18,1436
OUTLANDER 1000,2020-11-02,9,11,MA,US,20,1370
OUTLANDER 850,2020-11-02,12,15,MA,US,27,1513
OUTLANDER 450,2020-11-02,0,6,MA,US,6,1442
OUTLANDER 1000,2020-11-09,0,8,MA,US,8,1378
OUTLANDER 850,2020-11-09,1,4,MA,US,5,1518
OUTLANDER 450,2020-11-09,3,12,MA,US,15,1457
OUTLANDER 1000,2020-11-16,5,3,MA,US,8,1386
OUTLANDER 850,2020-11-16,7,6,MA,US,13,1531
OUTLANDER 450,2020-11-16,1,2,MA,US,3,1460
OUTLANDER 1000,2020-11-23,2,7,MA,US,9,1395
OUTLANDER 850,2020-11-23,14,4,MA,US,18,1549
OUTLANDER 450,2020-11-23,8,9,MA,US,17,1477
OUTLANDER 1000,2020-11-30,6,3,MA,US,9,1404
OUTLANDER 850,2020-11-30,11,5,MA,US,16,1565
OUTLANDER 450,2020-11-30,7,6,MA,US,13,1490
OUTLANDER 1000,2020-12-07,3,12,MA,US,15,1419
OUTLANDER 850,2020-12-07,7,13,MA,US,20,1585
OUTLANDER 450,2020-12-07,7,10,MA,US,17,1507
OUTLANDER 1000,2020-12-14,3,7,MA,US,10,1429
OUTLANDER 850,2020-12-14,4,13,MA,US,17,1602
OUTLANDER 450,2020-12-14,3,14,MA,US,17,1524
OUTLANDER 1000,2020-12-21,6,11,MA,US,17,1446
OUTLANDER 850,2020-12-21,1,6,MA,US,7,1609
OUTLANDER 450,2020-12-21,10,10,MA,US,20,1544
OUTLANDER 1000,2020-12-28,9,15,MA,US,24,1470
OUTLANDER 850,2020-12-28,4,11,MA,US,15,1624
OUTLANDER 450,2020-12-28,2,2,MA,US,4,1548
OUTLANDER 1000,2021-01-04,3,10,MA,US,13,1483
OUTLANDER 850,2021-01-04,2,5,MA,US,7,1631
OUTLANDER 450,2021-01-04,7,0,MA,US,7,1555
OUTLANDER 1000,2021-01-11,10,4,MA,US,14,1497
OUTLANDER 850,2021-01-11,13,10,MA,US,23,1654
OUTLANDER 450,2021-01-11,14,4,MA,US,18,1573
OUTLANDER 1000,2021-01-18,15,7,MA,US,22,1519
OUTLANDER 850,2021-01-18,2,3,MA,US,5,1659
OUTLANDER 450,2021-01-18,11,8,MA,US,19,1592
OUTLANDER 1000,2021-01-25,5,1,MA,US,6,1525
OUTLANDER 850,2021-01-25,9,7,MA,US,16,1675
OUTLANDER 450,2021-01-25,11,11,MA,US,22,1614
OUTLANDER 1000,2021-02-01,12,11,MA,US,23,1548
OUTLANDER 850,2021-02-01,12,7,MA,US,19,1694
OUTLANDER 450,2021-02-01,15,12,MA,US,27,1641
OUTLANDER 1000,2021-02-08,1,7,MA,US,8,1556
OUTLANDER 850,2021-02-08,4,1,MA,US,5,1699
OUTLANDER 450,2021-02-08,10,4,MA,US,14,1655
OUTLANDER 1000,2021-02-15,11,7,MA,US,18,1574
OUTLANDER 850,2021-02-15,11,3,MA,US,14,1713
OUTLANDER 450,2021-02-15,10,1,MA,US,11,1666
OUTLANDER 1000,2021-02-22,4,3,MA,US,7,1581
OUTLANDER 850,2021-02-22,0,2,MA,US,2,1715
OUTLANDER 450,2021-02-22,7,12,MA,US,19,1685
OUTLANDER 1000,2021-03-01,5,6,MA,US,11,1592
OUTLANDER 850,2021-03-01,12,3,MA,US,15,1730
OUTLANDER 450,2021-03-01,3,15,MA,US,18,1703
OUTLANDER 1000,2021-03-08,11,4,MA,US,15,1607
OUTLANDER 850,2021-03-08,9,3,MA,US,12,1742
OUTLANDER 450,2021-03-08,3,0,MA,US,3,1706
OUTLANDER 1000,2021-03-15,9,5,MA,US,14,1621
OUTLANDER 850,2021-03-15,14,7,MA,US,21,1763
OUTLANDER 450,2021-03-15,7,3,MA,US,10,1716
OUTLANDER 1000,2021-03-22,12,1,MA,US,13,1634
OUTLANDER 850,2021-03-22,5,3,MA,US,8,1771
OUTLANDER 450,2021-03-22,10,13,MA,US,23,1739
OUTLANDER 1000,2021-03-29,0,7,MA,US,7,1641
OUTLANDER 850,2021-03-29,1,11,MA,US,12,1783
OUTLANDER 450,2021-03-29,4,4,MA,US,8,1747
OUTLANDER 1000,2021-04-05,4,11,MA,US,15,1656
OUTLANDER 850,2021-04-05,1,5,MA,US,6,1789
OUTLANDER 450,2021-04-05,13,11,MA,US,24,1771
OUTLANDER 1000,2021-04-12,9,7,MA,US,16,1672
OUTLANDER 850,2021-04-12,4,10,MA,US,14,1803
OUTLANDER 450,2021-04-12,3,5,MA,US,8,1779
OUTLANDER 1000,2021-04-19,5,10,MA,US,15,1687
OUTLANDER 850,2021-04-19,6,14,MA,US,20,1823
OUTLANDER 450,2021-04-19,14,3,MA,US,17,1796
OUTLANDER 1000,2021-04-26,5,0,MA,US,5,1692
OUTLANDER 850,2021-04-26,14,0,MA,US,14,1837
OUTLANDER 450,2021-04-26,7,4,MA,US,11,1807
OUTLANDER 1000,2021-05-03,1,13,MA,US,14,1706
OUTLANDER 850,2021-05-03,4,5,MA,US,9,1846
OUTLANDER 450,2021-05-03,5,10,MA,US,15,1822
OUTLANDER 1000,2021-05-10,9,0,MA,US,9,1715
OUTLANDER 850,2021-05-10,6,10,MA,US,16,1862
OUTLANDER 450,2021-05-10,4,9,MA,US,13,1835
OUTLANDER 1000,2021-05-17,10,11,MA,US,21,1736
OUTLANDER 850,2021-05-17,5,1,MA,US,6,1868
OUTLANDER 450,2021-05-17,15,12,MA,US,27,1862
OUTLANDER 1000,2021-05-24,15,12,MA,US,27,1763
OUTLANDER 850,2021-05-24,10,11,MA,US,21,1889
OUTLANDER 450,2021-05-24,7,12,MA,US,19,1881
OUTLANDER 1000,2021-05-31,8,6,MA,US,14,1777
OUTLANDER 850,2021-05-31,3,2,MA,US,5,1894
OUTLANDER 450,2021-05-31,1,7,MA,US,8,1889
OUTLANDER 1000,2021-06-07,2,11,MA,US,13,1790
OUTLANDER 850,2021-06-07,3,11,MA,US,14,1908
OUTLANDER 450,2021-06-07,15,1,MA,US,16,1905
OUTLANDER 1000,2021-06-14,8,14,MA,US,22,1812
OUTLANDER 850,2021-06-14,1,3,MA,US,4,1912
OUTLANDER 450,2021-06-14,6,2,MA,US,8,1913
OUTLANDER 1000,2021-06-21,10,11,MA,US,21,1833
OUTLANDER 850,2021-06-21,9,0,MA,US,9,1921
OUTLANDER 450,2021-06-21,12,8,MA,US,20,1933
OUTLANDER 1000,2021-06-28,1,1,MA,US,2,1835
OUTLANDER 850,2021-06-28,10,12,MA,US,22,1943
OUTLANDER 450,2021-06-28,4,4,MA,US,8,1941
OUTLANDER 1000,2021-07-05,15,1,MA,US,16,1851
OUTLANDER 850,2021-07-05,9,9,MA,US,18,1961
OUTLANDER 450,2021-07-05,12,8,MA,US,20,1961
OUTLANDER 1000,2021-07-12,5,4,MA,US,9,1860
OUTLANDER 850,2021-07-12,15,0,MA,US,15,1976
OUTLANDER 450,2021-07-12,3,6,MA,US,9,1970
OUTLANDER 1000,2021-07-19,12,1,MA,US,13,1873
OUTLANDER 850,2021-07-19,10,10,MA,US,20,1996
OUTLANDER 450,2021-07-19,10,2,MA,US,12,1982
OUTLANDER 1000,2021-07-26,6,3,MA,US,9,1882
OUTLANDER 850,2021-07-26,9,7,MA,US,16,2012
OUTLANDER 450,2021-07-26,5,13,MA,US,18,2000
OUTLANDER 1000,2021-08-02,1,0,MA,US,1,1883
OUTLANDER 850,2021-08-02,8,2,MA,US,10,2022
OUTLANDER 450,2021-08-02,2,3,MA,US,5,2005
OUTLANDER 1000,2021-08-09,6,10,MA,US,16,1899
OUTLANDER 850,2021-08-09,11,2,MA,US,13,2035
OUTLANDER 450,2021-08-09,15,6,MA,US,21,2026
OUTLANDER 1000,2021-08-16,4,11,MA,US,15,1914
OUTLANDER 850,2021-08-16,3,10,MA,US,13,2048
OUTLANDER 450,2021-08-16,4,7,MA,US,11,2037
OUTLANDER 1000,2021-08-23,13,14,MA,US,27,1941
OUTLANDER 850,2021-08-23,6,1,MA,US,7,2055
OUTLANDER 450,2021-08-23,9,7,MA,US,16,2053
OUTLANDER 1000,2021-08-30,7,5,MA,US,12,1953
OUTLANDER 850,2021-08-30,4,9,MA,US,13,2068
OUTLANDER 450,2021-08-30,14,9,MA,US,23,2076
OUTLANDER 1000,2021-09-06,1,11,MA,US,12,1965
OUTLANDER 850,2021-09-06,3,11,MA,US,14,2082
OUTLANDER 450,2021-09-06,12,3,MA,US,15,2091
OUTLANDER 1000,2021-09-13,2,10,MA,US,12,1977
OUTLANDER 850,2021-09-13,6,11,MA,US,17,2099
OUTLANDER 450,2021-09-13,0,2,MA,US,2,2093
OUTLANDER 1000,2021-09-20,12,1,MA,US,13,1990
OUTLANDER 850,2021-09-20,3,2,MA,US,5,2104
OUTLANDER 450,2021-09-20,6,10,MA,US,16,2109
OUTLANDER 1000,2021-09-27,11,9,MA,US,20,2010
OUTLANDER 850,2021-09-27,11,9,MA,US,20,2124
OUTLANDER 450,2021-09-27,14,8,MA,US,22,2131
OUTLANDER 1000,2021-10-04,6,1,MA,US,7,2017
OUTLANDER 850,2021-10-04,13,11,MA,US,24,2148
OUTLANDER 450,2021-10-04,0,9,MA,US,9,2140
OUTLANDER 1000,2021-10-11,8,7,MA,US,15,2032
OUTLANDER 850,2021-10-11,14,13,MA,US,27,2175
OUTLANDER 450,2021-10-11,12,2,MA,US,14,2154
OUTLANDER 1000,2021-10-18,1,11,MA,US,12,2044
OUTLANDER 850,2021-10-18,15,5,MA,US,20,2195
OUTLANDER 450,2021-10-18,0,6,MA,US,6,2160
OUTLANDER 1000,2021-10-25,4,4,MA,US,8,2052
OUTLANDER 850,2021-10-25,8,6,MA,US,14,2209
OUTLANDER 450,2021-10-25,4,7,MA,US,11,2171
OUTLANDER 1000,2021-11-01,11,1,MA,US,12,2064
OUTLANDER 850,2021-11-01,9,4,MA,US,13,2222
OUTLANDER 450,2021-11-01,2,5,MA,US,7,2178
OUTLANDER 1000,2021-11-08,1,11,MA,US,12,2076
OUTLANDER 850,2021-11-08,14,9,MA,US,23,2245
OUTLANDER 450,2021-11-08,14,5,MA,US,19,2197
OUTLANDER 1000,2021-11-15,8,7,MA,US,15,2091
OUTLANDER 850,2021-11-15,4,10,MA,US,14,2259
OUTLANDER 450,2021-11-15,3,6,MA,US,9,2206
OUTLANDER 1000,2021-11-22,4,11,MA,US,15,2106
OUTLANDER 850,2021-11-22,12,2,MA,US,14,2273
OUTLANDER 450,2021-11-22,11,13,MA,US,24,2230
OUTLANDER 1000,2021-11-29,15,4,MA,US,19,2125
OUTLANDER 850,2021-11-29,9,11,MA,US,20,2293
OUTLANDER 450,2021-11-29,5,5,MA,US,10,2240
OUTLANDER 1000,2021-12-06,5,11,MA,US,16,2141
OUTLANDER 850,2021-12-06,4,11,MA,US,15,2308
OUTLANDER 450,2021-12-06,15,1,MA,US,16,2256
OUTLANDER 1000,2021-12-13,13,5,MA,US,18,2159
OUTLANDER 850,2021-12-13,7,8,MA,US,15,2323
OUTLANDER 450,2021-12-13,2,6,MA,US,8,2264
OUTLANDER 1000,2021-12-20,13,6,MA,US,19,2178
OUTLANDER 850,2021-12-20,1,2,MA,US,3,2326
OUTLANDER 450,2021-12-20,0,4,MA,US,4,2268
OUTLANDER 1000,2021-12-27,1,13,MA,US,14,2192
OUTLANDER 850,2021-12-27,7,8,MA,US,15,2341
OUTLANDER 450,2021-12-27,2,12,MA,US,14,2282
OUTLANDER 1000,2019-01-07,9,1,MI,US,10,10
OUTLANDER 850,2019-01-07,6,0,MI,US,6,6
OUTLANDER 450,2019-01-07,5,13,MI,US,18,18
OUTLANDER 1000,2019-01-14,8,2,MI,US,10,20
OUTLANDER 850,2019-01-14,5,6,MI,US,11,17
OUTLANDER 450,2019-01-14,14,1,MI,US,15,33
OUTLANDER 1000,2019-01-21,11,11,MI,US,22,42
OUTLANDER 850,2019-01-21,3,15,MI,US,18,35
OUTLANDER 450,2019-01-21,12,13,MI,US,25,58
OUTLANDER 1000,2019-01-28,10,6,MI,US,16,58
OUTLANDER 850,2019-01-28,14,9,MI,US,23,58
OUTLANDER 450,2019-01-28,6,5,MI,US,11,69
OUTLANDER 1000,2019-02-04,8,11,MI,US,19,77
OUTLANDER 850,2019-02-04,9,13,MI,US,22,80
OUTLANDER 450,2019-02-04,8,4,MI,US,12,81
OUTLANDER 1000,2019-02-11,14,12,MI,US,26,103
OUTLANDER 850,2019-02-11,7,4,MI,US,11,91
OUTLANDER 450,2019-02-11,2,2,MI,US,4,85
OUTLANDER 1000,2019-02-18,0,9,MI,US,9,112
OUTLANDER 850,2019-02-18,14,3,MI,US,17,108
OUTLANDER 450,2019-02-18,4,7,MI,US,11,96
OUTLANDER 1000,2019-02-25,14,4,MI,US,18,130
OUTLANDER 850,2019-02-25,11,10,MI,US,21,129
OUTLANDER 450,2019-02-25,11,8,MI,US,19,115
OUTLANDER 1000,2019-03-04,2,9,MI,US,11,141
OUTLANDER 850,2019-03-04,11,8,MI,US,19,148
OUTLANDER 450,2019-03-04,8,10,MI,US,18,133
OUTLANDER 1000,2019-03-11,4,15,MI,US,19,160
OUTLANDER 850,2019-03-11,12,2,MI,US,14,162
OUTLANDER 450,2019-03-11,10,1,MI,US,11,144
OUTLANDER 1000,2019-03-18,5,14,MI,US,19,179
OUTLANDER 850,2019-03-18,4,11,MI,US,15,177
OUTLANDER 450,2019-03-18,1,8,MI,US,9,153
OUTLANDER 1000,2019-03-25,2,10,MI,US,12,191
OUTLANDER 850,2019-03-25,14,7,MI,US,21,198
OUTLANDER 450,2019-03-25,14,15,MI,US,29,182
OUTLANDER 1000,2019-04-01,10,5,MI,US,15,206
OUTLANDER 850,2019-04-01,8,3,MI,US,11,209
OUTLANDER 450,2019-04-01,4,4,MI,US,8,190
OUTLANDER 1000,2019-04-08,6,6,MI,US,12,218
OUTLANDER 850,2019-04-08,11,1,MI,US,12,221
OUTLANDER 450,2019-04-08,12,2,MI,US,14,204
OUTLANDER 1000,2019-04-15,0,10,MI,US,10,228
OUTLANDER 850,2019-04-15,9,4,MI,US,13,234
OUTLANDER 450,2019-04-15,14,4,MI,US,18,222
OUTLANDER 1000,2019-04-22,11,14,MI,US,25,253
OUTLANDER 850,2019-04-22,7,9,MI,US,16,250
OUTLANDER 450,2019-04-22,1,4,MI,US,5,227
OUTLANDER 1000,2019-04-29,6,1,MI,US,7,260
OUTLANDER 850,2019-04-29,15,14,MI,US,29,279
OUTLANDER 450,2019-04-29,4,12,MI,US,16,243
OUTLANDER 1000,2019-05-06,6,5,MI,US,11,271
OUTLANDER 850,2019-05-06,8,9,MI,US,17,296
OUTLANDER 450,2019-05-06,4,6,MI,US,10,253
OUTLANDER 1000,2019-05-13,9,3,MI,US,12,283
OUTLANDER 850,2019-05-13,14,9,MI,US,23,319
OUTLANDER 450,2019-05-13,13,9,MI,US,22,275
OUTLANDER 1000,2019-05-20,14,14,MI,US,28,311
OUTLANDER 850,2019-05-20,5,10,MI,US,15,334
OUTLANDER 450,2019-05-20,12,8,MI,US,20,295
OUTLANDER 1000,2019-05-27,14,12,MI,US,26,337
OUTLANDER 850,2019-05-27,9,13,MI,US,22,356
OUTLANDER 450,2019-05-27,4,3,MI,US,7,302
OUTLANDER 1000,2019-06-03,13,2,MI,US,15,352
OUTLANDER 850,2019-06-03,10,1,MI,US,11,367
OUTLANDER 450,2019-06-03,2,8,MI,US,10,312
OUTLANDER 1000,2019-06-10,3,13,MI,US,16,368
OUTLANDER 850,2019-06-10,7,2,MI,US,9,376
OUTLANDER 450,2019-06-10,12,11,MI,US,23,335
OUTLANDER 1000,2019-06-17,6,11,MI,US,17,385
OUTLANDER 850,2019-06-17,5,10,MI,US,15,391
OUTLANDER 450,2019-06-17,5,7,MI,US,12,347
OUTLANDER 1000,2019-06-24,2,14,MI,US,16,401
OUTLANDER 850,2019-06-24,9,8,MI,US,17,408
OUTLANDER 450,2019-06-24,11,13,MI,US,24,371
OUTLANDER 1000,2019-07-01,0,15,MI,US,15,416
OUTLANDER 850,2019-07-01,1,8,MI,US,9,417
OUTLANDER 450,2019-07-01,14,3,MI,US,17,388
OUTLANDER 1000,2019-07-08,12,0,MI,US,12,428
OUTLANDER 850,2019-07-08,1,12,MI,US,13,430
OUTLANDER 450,2019-07-08,4,1,MI,US,5,393
OUTLANDER 1000,2019-07-15,15,8,MI,US,23,451
OUTLANDER 850,2019-07-15,9,6,MI,US,15,445
OUTLANDER 450,2019-07-15,2,9,MI,US,11,404
OUTLANDER 1000,2019-07-22,11,10,MI,US,21,472
OUTLANDER 850,2019-07-22,12,5,MI,US,17,462
OUTLANDER 450,2019-07-22,15,10,MI,US,25,429
OUTLANDER 1000,2019-07-29,7,3,MI,US,10,482
OUTLANDER 850,2019-07-29,8,7,MI,US,15,477
OUTLANDER 450,2019-07-29,7,5,MI,US,12,441
OUTLANDER 1000,2019-08-05,1,3,MI,US,4,486
OUTLANDER 850,2019-08-05,14,6,MI,US,20,497
OUTLANDER 450,2019-08-05,13,11,MI,US,24,465
OUTLANDER 1000,2019-08-12,5,15,MI,US,20,506
OUTLANDER 850,2019-08-12,3,5,MI,US,8,505
OUTLANDER 450,2019-08-12,11,13,MI,US,24,489
OUTLANDER 1000,2019-08-19,8,13,MI,US,21,527
OUTLANDER 850,2019-08-19,10,4,MI,US,14,519
OUTLANDER 450,2019-08-19,7,5,MI,US,12,501
OUTLANDER 1000,2019-08-26,8,4,MI,US,12,539
OUTLANDER 850,2019-08-26,13,14,MI,US,27,546
OUTLANDER 450,2019-08-26,0,13,MI,US,13,514
OUTLANDER 1000,2019-09-02,4,15,MI,US,19,558
OUTLANDER 850,2019-09-02,1,10,MI,US,11,557
OUTLANDER 450,2019-09-02,1,12,MI,US,13,527
OUTLANDER 1000,2019-09-09,5,5,MI,US,10,568
OUTLANDER 850,2019-09-09,13,6,MI,US,19,576
OUTLANDER 450,2019-09-09,0,10,MI,US,10,537
OUTLANDER 1000,2019-09-16,10,8,MI,US,18,586
OUTLANDER 850,2019-09-16,4,4,MI,US,8,584
OUTLANDER 450,2019-09-16,12,12,MI,US,24,561
OUTLANDER 1000,2019-09-23,12,7,MI,US,19,605
OUTLANDER 850,2019-09-23,7,10,MI,US,17,601
OUTLANDER 450,2019-09-23,14,13,MI,US,27,588
OUTLANDER 1000,2019-09-30,13,5,MI,US,18,623
OUTLANDER 850,2019-09-30,8,11,MI,US,19,620
OUTLANDER 450,2019-09-30,3,6,MI,US,9,597
OUTLANDER 1000,2019-10-07,6,9,MI,US,15,638
OUTLANDER 850,2019-10-07,8,11,MI,US,19,639
OUTLANDER 450,2019-10-07,13,6,MI,US,19,616
OUTLANDER 1000,2019-10-14,14,0,MI,US,14,652
OUTLANDER 850,2019-10-14,3,12,MI,US,15,654
OUTLANDER 450,2019-10-14,0,5,MI,US,5,621
OUTLANDER 1000,2019-10-21,4,1,MI,US,5,657
OUTLANDER 850,2019-10-21,8,9,MI,US,17,671
OUTLANDER 450,2019-10-21,5,12,MI,US,17,638
OUTLANDER 1000,2019-10-28,15,6,MI,US,21,678
OUTLANDER 850,2019-10-28,4,0,MI,US,4,675
OUTLANDER 450,2019-10-28,5,14,MI,US,19,657
OUTLANDER 1000,2019-11-04,9,13,MI,US,22,700
OUTLANDER 850,2019-11-04,10,14,MI,US,24,699
OUTLANDER 450,2019-11-04,9,5,MI,US,14,671
OUTLANDER 1000,2019-11-11,9,7,MI,US,16,716
OUTLANDER 850,2019-11-11,3,3,MI,US,6,705
OUTLANDER 450,2019-11-11,8,14,MI,US,22,693
OUTLANDER 1000,2019-11-18,11,9,MI,US,20,736
OUTLANDER 850,2019-11-18,14,14,MI,US,28,733
OUTLANDER 450,2019-11-18,3,3,MI,US,6,699
OUTLANDER 1000,2019-11-25,8,10,MI,US,18,754
OUTLANDER 850,2019-11-25,9,13,MI,US,22,755
OUTLANDER 450,2019-11-25,12,11,MI,US,23,722
OUTLANDER 1000,2019-12-02,10,9,MI,US,19,773
OUTLANDER 850,2019-12-02,13,13,MI,US,26,781
OUTLANDER 450,2019-12-02,14,13,MI,US,27,749
OUTLANDER 1000,2019-12-09,13,9,MI,US,22,795
OUTLANDER 850,2019-12-09,9,3,MI,US,12,793
OUTLANDER 450,2019-12-09,9,1,MI,US,10,759
OUTLANDER 1000,2019-12-16,0,11,MI,US,11,806
OUTLANDER 850,2019-12-16,0,13,MI,US,13,806
OUTLANDER 450,2019-12-16,6,8,MI,US,14,773
OUTLANDER 1000,2019-12-23,4,14,MI,US,18,824
OUTLANDER 850,2019-12-23,8,11,MI,US,19,825
OUTLANDER 450,2019-12-23,14,14,MI,US,28,801
OUTLANDER 1000,2019-12-30,1,15,MI,US,16,840
OUTLANDER 850,2019-12-30,10,14,MI,US,24,849
OUTLANDER 450,2019-12-30,3,15,MI,US,18,819
OUTLANDER 1000,2020-01-06,9,4,MI,US,13,853
OUTLANDER 850,2020-01-06,14,13,MI,US,27,876
OUTLANDER 450,2020-01-06,0,4,MI,US,4,823
OUTLANDER 1000,2020-01-13,8,5,MI,US,13,866
OUTLANDER 850,2020-01-13,12,7,MI,US,19,895
OUTLANDER 450,2020-01-13,14,14,MI,US,28,851
OUTLANDER 1000,2020-01-20,10,14,MI,US,24,890
OUTLANDER 850,2020-01-20,5,3,MI,US,8,903
OUTLANDER 450,2020-01-20,1,5,MI,US,6,857
OUTLANDER 1000,2020-01-27,2,2,MI,US,4,894
OUTLANDER 850,2020-01-27,8,13,MI,US,21,924
OUTLANDER 450,2020-01-27,1,11,MI,US,12,869
OUTLANDER 1000,2020-02-03,10,8,MI,US,18,912
OUTLANDER 850,2020-02-03,8,8,MI,US,16,940
OUTLANDER 450,2020-02-03,6,8,MI,US,14,883
OUTLANDER 1000,2020-02-10,5,7,MI,US,12,924
OUTLANDER 850,2020-02-10,8,11,MI,US,19,959
OUTLANDER 450,2020-02-10,14,7,MI,US,21,904
OUTLANDER 1000,2020-02-17,5,5,MI,US,10,934
OUTLANDER 850,2020-02-17,8,8,MI,US,16,975
OUTLANDER 450,2020-02-17,2,9,MI,US,11,915
OUTLANDER 1000,2020-02-24,8,4,MI,US,12,946
OUTLANDER 850,2020-02-24,11,10,MI,US,21,996
OUTLANDER 450,2020-02-24,13,14,MI,US,27,942
OUTLANDER 1000,2020-03-02,13,12,MI,US,25,971
OUTLANDER 850,2020-03-02,7,9,MI,US,16,1012
OUTLANDER 450,2020-03-02,14,2,MI,US,16,958
OUTLANDER 1000,2020-03-09,13,11,MI,US,24,995
OUTLANDER 850,2020-03-09,6,8,MI,US,14,1026
OUTLANDER 450,2020-03-09,13,4,MI,US,17,975
OUTLANDER 1000,2020-03-16,1,0,MI,US,1,996
OUTLANDER 850,2020-03-16,11,13,MI,US,24,1050
OUTLANDER 450,2020-03-16,12,10,MI,US,22,997
OUTLANDER 1000,2020-03-23,8,5,MI,US,13,1009
OUTLANDER 850,2020-03-23,8,2,MI,US,10,1060
OUTLANDER 450,2020-03-23,8,11,MI,US,19,1016
OUTLANDER 1000,2020-03-30,7,6,MI,US,13,1022
OUTLANDER 850,2020-03-30,9,4,MI,US,13,1073
OUTLANDER 450,2020-03-30,11,2,MI,US,13,1029
OUTLANDER 1000,2020-04-06,5,7,MI,US,12,1034
OUTLANDER 850,2020-04-06,3,8,MI,US,11,1084
OUTLANDER 450,2020-04-06,12,11,MI,US,23,1052
OUTLANDER 1000,2020-04-13,0,0,MI,US,0,1034
OUTLANDER 850,2020-04-13,0,13,MI,US,13,1097
OUTLANDER 450,2020-04-13,4,1,MI,US,5,1057
OUTLANDER 1000,2020-04-20,9,1,MI,US,10,1044
OUTLANDER 850,2020-04-20,9,13,MI,US,22,1119
OUTLANDER 450,2020-04-20,8,12,MI,US,20,1077
OUTLANDER 1000,2020-04-27,11,5,MI,US,16,1060
OUTLANDER 850,2020-04-27,14,12,MI,US,26,1145
OUTLANDER 450,2020-04-27,5,11,MI,US,16,1093
OUTLANDER 1000,2020-05-04,9,2,MI,US,11,1071
OUTLANDER 850,2020-05-04,2,6,MI,US,8,1153
OUTLANDER 450,2020-05-04,10,0,MI,US,10,1103
OUTLANDER 1000,2020-05-11,13,8,MI,US,21,1092
OUTLANDER 850,2020-05-11,14,6,MI,US,20,1173
OUTLANDER 450,2020-05-11,1,1,MI,US,2,1105
OUTLANDER 1000,2020-05-18,4,15,MI,US,19,1111
OUTLANDER 850,2020-05-18,11,8,MI,US,19,1192
OUTLANDER 450,2020-05-18,3,3,MI,US,6,1111
OUTLANDER 1000,2020-05-25,15,3,MI,US,18,1129
OUTLANDER 850,2020-05-25,8,4,MI,US,12,1204
OUTLANDER 450,2020-05-25,7,6,MI,US,13,1124
OUTLANDER 1000,2020-06-01,8,15,MI,US,23,1152
OUTLANDER 850,2020-06-01,2,8,MI,US,10,1214
OUTLANDER 450,2020-06-01,9,5,MI,US,14,1138
OUTLANDER 1000,2020-06-08,0,1,MI,US,1,1153
OUTLANDER 850,2020-06-08,12,7,MI,US,19,1233
OUTLANDER 450,2020-06-08,2,1,MI,US,3,1141
OUTLANDER 1000,2020-06-15,12,3,MI,US,15,1168
OUTLANDER 850,2020-06-15,6,13,MI,US,19,1252
OUTLANDER 450,2020-06-15,11,10,MI,US,21,1162
OUTLANDER 1000,2020-06-22,3,4,MI,US,7,1175
OUTLANDER 850,2020-06-22,3,12,MI,US,15,1267
OUTLANDER 450,2020-06-22,14,4,MI,US,18,1180
OUTLANDER 1000,2020-06-29,10,0,MI,US,10,1185
OUTLANDER 850,2020-06-29,6,3,MI,US,9,1276
OUTLANDER 450,2020-06-29,6,12,MI,US,18,1198
OUTLANDER 1000,2020-07-06,14,15,MI,US,29,1214
OUTLANDER 850,2020-07-06,8,11,MI,US,19,1295
OUTLANDER 450,2020-07-06,4,14,MI,US,18,1216
OUTLANDER 1000,2020-07-13,7,3,MI,US,10,1224
OUTLANDER 850,2020-07-13,0,3,MI,US,3,1298
OUTLANDER 450,2020-07-13,5,1,MI,US,6,1222
OUTLANDER 1000,2020-07-20,13,6,MI,US,19,1243
OUTLANDER 850,2020-07-20,8,8,MI,US,16,1314
OUTLANDER 450,2020-07-20,8,1,MI,US,9,1231
OUTLANDER 1000,2020-07-27,5,3,MI,US,8,1251
OUTLANDER 850,2020-07-27,7,5,MI,US,12,1326
OUTLANDER 450,2020-07-27,6,3,MI,US,9,1240
OUTLANDER 1000,2020-08-03,4,9,MI,US,13,1264
OUTLANDER 850,2020-08-03,13,0,MI,US,13,1339
OUTLANDER 450,2020-08-03,10,13,MI,US,23,1263
OUTLANDER 1000,2020-08-10,4,2,MI,US,6,1270
OUTLANDER 850,2020-08-10,1,4,MI,US,5,1344
OUTLANDER 450,2020-08-10,13,8,MI,US,21,1284
OUTLANDER 1000,2020-08-17,2,14,MI,US,16,1286
OUTLANDER 850,2020-08-17,14,12,MI,US,26,1370
OUTLANDER 450,2020-08-17,8,3,MI,US,11,1295
OUTLANDER 1000,2020-08-24,10,5,MI,US,15,1301
OUTLANDER 850,2020-08-24,4,10,MI,US,14,1384
OUTLANDER 450,2020-08-24,9,11,MI,US,20,1315
OUTLANDER 1000,2020-08-31,14,12,MI,US,26,1327
OUTLANDER 850,2020-08-31,13,9,MI,US,22,1406
OUTLANDER 450,2020-08-31,8,12,MI,US,20,1335
OUTLANDER 1000,2020-09-07,8,5,MI,US,13,1340
OUTLANDER 850,2020-09-07,14,12,MI,US,26,1432
OUTLANDER 450,2020-09-07,10,2,MI,US,12,1347
OUTLANDER 1000,2020-09-14,7,2,MI,US,9,1349
OUTLANDER 850,2020-09-14,8,12,MI,US,20,1452
OUTLANDER 450,2020-09-14,3,12,MI,US,15,1362
OUTLANDER 1000,2020-09-21,12,15,MI,US,27,1376
OUTLANDER 850,2020-09-21,6,4,MI,US,10,1462
OUTLANDER 450,2020-09-21,4,13,MI,US,17,1379
OUTLANDER 1000,2020-09-28,2,8,MI,US,10,1386
OUTLANDER 850,2020-09-28,9,9,MI,US,18,1480
OUTLANDER 450,2020-09-28,2,13,MI,US,15,1394
OUTLANDER 1000,2020-10-05,11,5,MI,US,16,1402
OUTLANDER 850,2020-10-05,5,10,MI,US,15,1495
OUTLANDER 450,2020-10-05,12,3,MI,US,15,1409
OUTLANDER 1000,2020-10-12,5,12,MI,US,17,1419
OUTLANDER 850,2020-10-12,0,8,MI,US,8,1503
OUTLANDER 450,2020-10-12,8,4,MI,US,12,1421
OUTLANDER 1000,2020-10-19,8,1,MI,US,9,1428
OUTLANDER 850,2020-10-19,9,13,MI,US,22,1525
OUTLANDER 450,2020-10-19,2,10,MI,US,12,1433
OUTLANDER 1000,2020-10-26,5,14,MI,US,19,1447
OUTLANDER 850,2020-10-26,6,9,MI,US,15,1540
OUTLANDER 450,2020-10-26,8,11,MI,US,19,1452
OUTLANDER 1000,2020-11-02,14,7,MI,US,21,1468
OUTLANDER 850,2020-11-02,4,8,MI,US,12,1552
OUTLANDER 450,2020-11-02,8,9,MI,US,17,1469
OUTLANDER 1000,2020-11-09,5,9,MI,US,14,1482
OUTLANDER 850,2020-11-09,7,4,MI,US,11,1563
OUTLANDER 450,2020-11-09,13,9,MI,US,22,1491
OUTLANDER 1000,2020-11-16,3,1,MI,US,4,1486
OUTLANDER 850,2020-11-16,7,5,MI,US,12,1575
OUTLANDER 450,2020-11-16,10,4,MI,US,14,1505
OUTLANDER 1000,2020-11-23,13,9,MI,US,22,1508
OUTLANDER 850,2020-11-23,7,13,MI,US,20,1595
OUTLANDER 450,2020-11-23,7,9,MI,US,16,1521
OUTLANDER 1000,2020-11-30,14,14,MI,US,28,1536
OUTLANDER 850,2020-11-30,14,3,MI,US,17,1612
OUTLANDER 450,2020-11-30,10,8,MI,US,18,1539
OUTLANDER 1000,2020-12-07,1,3,MI,US,4,1540
OUTLANDER 850,2020-12-07,13,6,MI,US,19,1631
OUTLANDER 450,2020-12-07,12,5,MI,US,17,1556
OUTLANDER 1000,2020-12-14,7,8,MI,US,15,1555
OUTLANDER 850,2020-12-14,10,6,MI,US,16,1647
OUTLANDER 450,2020-12-14,3,5,MI,US,8,1564
OUTLANDER 1000,2020-12-21,13,2,MI,US,15,1570
OUTLANDER 850,2020-12-21,12,0,MI,US,12,1659
OUTLANDER 450,2020-12-21,3,11,MI,US,14,1578
OUTLANDER 1000,2020-12-28,5,2,MI,US,7,1577
OUTLANDER 850,2020-12-28,14,14,MI,US,28,1687
OUTLANDER 450,2020-12-28,2,13,MI,US,15,1593
OUTLANDER 1000,2021-01-04,12,9,MI,US,21,1598
OUTLANDER 850,2021-01-04,8,2,MI,US,10,1697
OUTLANDER 450,2021-01-04,5,10,MI,US,15,1608
OUTLANDER 1000,2021-01-11,2,15,MI,US,17,1615
OUTLANDER 850,2021-01-11,3,2,MI,US,5,1702
OUTLANDER 450,2021-01-11,11,14,MI,US,25,1633
OUTLANDER 1000,2021-01-18,8,5,MI,US,13,1628
OUTLANDER 850,2021-01-18,4,1,MI,US,5,1707
OUTLANDER 450,2021-01-18,9,11,MI,US,20,1653
OUTLANDER 1000,2021-01-25,7,12,MI,US,19,1647
OUTLANDER 850,2021-01-25,11,3,MI,US,14,1721
OUTLANDER 450,2021-01-25,9,7,MI,US,16,1669
OUTLANDER 1000,2021-02-01,8,4,MI,US,12,1659
OUTLANDER 850,2021-02-01,5,4,MI,US,9,1730
OUTLANDER 450,2021-02-01,1,4,MI,US,5,1674
OUTLANDER 1000,2021-02-08,9,15,MI,US,24,1683
OUTLANDER 850,2021-02-08,3,4,MI,US,7,1737
OUTLANDER 450,2021-02-08,7,2,MI,US,9,1683
OUTLANDER 1000,2021-02-15,10,7,MI,US,17,1700
OUTLANDER 850,2021-02-15,10,7,MI,US,17,1754
OUTLANDER 450,2021-02-15,8,2,MI,US,10,1693
OUTLANDER 1000,2021-02-22,9,8,MI,US,17,1717
OUTLANDER 850,2021-02-22,4,12,MI,US,16,1770
OUTLANDER 450,2021-02-22,11,8,MI,US,19,1712
OUTLANDER 1000,2021-03-01,5,7,MI,US,12,1729
OUTLANDER 850,2021-03-01,15,10,MI,US,25,1795
OUTLANDER 450,2021-03-01,1,1,MI,US,2,1714
OUTLANDER 1000,2021-03-08,9,15,MI,US,24,1753
OUTLANDER 850,2021-03-08,11,15,MI,US,26,1821
OUTLANDER 450,2021-03-08,2,1,MI,US,3,1717
OUTLANDER 1000,2021-03-15,3,13,MI,US,16,1769
OUTLANDER 850,2021-03-15,2,4,MI,US,6,1827
OUTLANDER 450,2021-03-15,14,7,MI,US,21,1738
OUTLANDER 1000,2021-03-22,7,3,MI,US,10,1779
OUTLANDER 850,2021-03-22,8,9,MI,US,17,1844
OUTLANDER 450,2021-03-22,14,12,MI,US,26,1764
OUTLANDER 1000,2021-03-29,13,3,MI,US,16,1795
OUTLANDER 850,2021-03-29,6,11,MI,US,17,1861
OUTLANDER 450,2021-03-29,7,10,MI,US,17,1781
OUTLANDER 1000,2021-04-05,11,3,MI,US,14,1809
OUTLANDER 850,2021-04-05,4,2,MI,US,6,1867
OUTLANDER 450,2021-04-05,9,4,MI,US,13,1794
OUTLANDER 1000,2021-04-12,11,13,MI,US,24,1833
OUTLANDER 850,2021-04-12,4,11,MI,US,15,1882
OUTLANDER 450,2021-04-12,10,8,MI,US,18,1812
OUTLANDER 1000,2021-04-19,14,8,MI,US,22,1855
OUTLANDER 850,2021-04-19,6,14,MI,US,20,1902
OUTLANDER 450,2021-04-19,15,6,MI,US,21,1833
OUTLANDER 1000,2021-04-26,1,4,MI,US,5,1860
OUTLANDER 850,2021-04-26,4,3,MI,US,7,1909
OUTLANDER 450,2021-04-26,3,11,MI,US,14,1847
OUTLANDER 1000,2021-05-03,6,13,MI,US,19,1879
OUTLANDER 850,2021-05-03,5,12,MI,US,17,1926
OUTLANDER 450,2021-05-03,6,10,MI,US,16,1863
OUTLANDER 1000,2021-05-10,6,5,MI,US,11,1890
OUTLANDER 850,2021-05-10,1,4,MI,US,5,1931
OUTLANDER 450,2021-05-10,13,4,MI,US,17,1880
OUTLANDER 1000,2021-05-17,1,4,MI,US,5,1895
OUTLANDER 850,2021-05-17,15,8,MI,US,23,1954
OUTLANDER 450,2021-05-17,6,1,MI,US,7,1887
OUTLANDER 1000,2021-05-24,8,11,MI,US,19,1914
OUTLANDER 850,2021-05-24,2,10,MI,US,12,1966
OUTLANDER 450,2021-05-24,11,4,MI,US,15,1902
OUTLANDER 1000,2021-05-31,4,11,MI,US,15,1929
OUTLANDER 850,2021-05-31,3,5,MI,US,8,1974
OUTLANDER 450,2021-05-31,13,8,MI,US,21,1923
OUTLANDER 1000,2021-06-07,12,1,MI,US,13,1942
OUTLANDER 850,2021-06-07,2,10,MI,US,12,1986
OUTLANDER 450,2021-06-07,11,12,MI,US,23,1946
OUTLANDER 1000,2021-06-14,5,12,MI,US,17,1959
OUTLANDER 850,2021-06-14,6,1,MI,US,7,1993
OUTLANDER 450,2021-06-14,7,4,MI,US,11,1957
OUTLANDER 1000,2021-06-21,5,5,MI,US,10,1969
OUTLANDER 850,2021-06-21,13,4,MI,US,17,2010
OUTLANDER 450,2021-06-21,4,11,MI,US,15,1972
OUTLANDER 1000,2021-06-28,3,2,MI,US,5,1974
OUTLANDER 850,2021-06-28,7,6,MI,US,13,2023
OUTLANDER 450,2021-06-28,12,2,MI,US,14,1986
OUTLANDER 1000,2021-07-05,14,1,MI,US,15,1989
OUTLANDER 850,2021-07-05,7,6,MI,US,13,2036
OUTLANDER 450,2021-07-05,3,12,MI,US,15,2001
OUTLANDER 1000,2021-07-12,10,11,MI,US,21,2010
OUTLANDER 850,2021-07-12,2,9,MI,US,11,2047
OUTLANDER 450,2021-07-12,0,6,MI,US,6,2007
OUTLANDER 1000,2021-07-19,7,14,MI,US,21,2031
OUTLANDER 850,2021-07-19,7,5,MI,US,12,2059
OUTLANDER 450,2021-07-19,6,6,MI,US,12,2019
OUTLANDER 1000,2021-07-26,1,2,MI,US,3,2034
OUTLANDER 850,2021-07-26,7,12,MI,US,19,2078
OUTLANDER 450,2021-07-26,10,4,MI,US,14,2033
OUTLANDER 1000,2021-08-02,2,4,MI,US,6,2040
OUTLANDER 850,2021-08-02,15,9,MI,US,24,2102
OUTLANDER 450,2021-08-02,6,1,MI,US,7,2040
OUTLANDER 1000,2021-08-09,4,7,MI,US,11,2051
OUTLANDER 850,2021-08-09,4,3,MI,US,7,2109
OUTLANDER 450,2021-08-09,13,10,MI,US,23,2063
OUTLANDER 1000,2021-08-16,1,4,MI,US,5,2056
OUTLANDER 850,2021-08-16,7,6,MI,US,13,2122
OUTLANDER 450,2021-08-16,14,1,MI,US,15,2078
OUTLANDER 1000,2021-08-23,11,5,MI,US,16,2072
OUTLANDER 850,2021-08-23,2,2,MI,US,4,2126
OUTLANDER 450,2021-08-23,10,5,MI,US,15,2093
OUTLANDER 1000,2021-08-30,2,0,MI,US,2,2074
OUTLANDER 850,2021-08-30,1,4,MI,US,5,2131
OUTLANDER 450,2021-08-30,1,4,MI,US,5,2098
OUTLANDER 1000,2021-09-06,3,6,MI,US,9,2083
OUTLANDER 850,2021-09-06,14,5,MI,US,19,2150
OUTLANDER 450,2021-09-06,0,2,MI,US,2,2100
OUTLANDER 1000,2021-09-13,2,7,MI,US,9,2092
OUTLANDER 850,2021-09-13,14,11,MI,US,25,2175
OUTLANDER 450,2021-09-13,12,15,MI,US,27,2127
OUTLANDER 1000,2021-09-20,10,14,MI,US,24,2116
OUTLANDER 850,2021-09-20,0,1,MI,US,1,2176
OUTLANDER 450,2021-09-20,3,15,MI,US,18,2145
OUTLANDER 1000,2021-09-27,2,2,MI,US,4,2120
OUTLANDER 850,2021-09-27,14,15,MI,US,29,2205
OUTLANDER 450,2021-09-27,7,7,MI,US,14,2159
OUTLANDER 1000,2021-10-04,8,7,MI,US,15,2135
OUTLANDER 850,2021-10-04,2,8,MI,US,10,2215
OUTLANDER 450,2021-10-04,9,4,MI,US,13,2172
OUTLANDER 1000,2021-10-11,10,12,MI,US,22,2157
OUTLANDER 850,2021-10-11,1,3,MI,US,4,2219
OUTLANDER 450,2021-10-11,7,9,MI,US,16,2188
OUTLANDER 1000,2021-10-18,7,0,MI,US,7,2164
OUTLANDER 850,2021-10-18,2,9,MI,US,11,2230
OUTLANDER 450,2021-10-18,3,7,MI,US,10,2198
OUTLANDER 1000,2021-10-25,5,0,MI,US,5,2169
OUTLANDER 850,2021-10-25,8,13,MI,US,21,2251
OUTLANDER 450,2021-10-25,10,10,MI,US,20,2218
OUTLANDER 1000,2021-11-01,1,11,MI,US,12,2181
OUTLANDER 850,2021-11-01,9,14,MI,US,23,2274
OUTLANDER 450,2021-11-01,10,12,MI,US,22,2240
OUTLANDER 1000,2021-11-08,3,7,MI,US,10,2191
OUTLANDER 850,2021-11-08,2,2,MI,US,4,2278
OUTLANDER 450,2021-11-08,14,7,MI,US,21,2261
OUTLANDER 1000,2021-11-15,8,13,MI,US,21,2212
OUTLANDER 850,2021-11-15,8,7,MI,US,15,2293
OUTLANDER 450,2021-11-15,8,4,MI,US,12,2273
OUTLANDER 1000,2021-11-22,13,12,MI,US,25,2237
OUTLANDER 850,2021-11-22,13,1,MI,US,14,2307
OUTLANDER 450,2021-11-22,14,14,MI,US,28,2301
OUTLANDER 1000,2021-11-29,4,3,MI,US,7,2244
OUTLANDER 850,2021-11-29,5,4,MI,US,9,2316
OUTLANDER 450,2021-11-29,0,10,MI,US,10,2311
OUTLANDER 1000,2021-12-06,8,2,MI,US,10,2254
OUTLANDER 850,2021-12-06,3,2,MI,US,5,2321
OUTLANDER 450,2021-12-06,15,14,MI,US,29,2340
OUTLANDER 1000,2021-12-13,5,10,MI,US,15,2269
OUTLANDER 850,2021-12-13,8,14,MI,US,22,2343
OUTLANDER 450,2021-12-13,6,6,MI,US,12,2352
OUTLANDER 1000,2021-12-20,11,0,MI,US,11,2280
OUTLANDER 850,2021-12-20,1,3,MI,US,4,2347
OUTLANDER 450,2021-12-20,10,1,MI,US,11,2363
OUTLANDER 1000,2021-12-27,5,6,MI,US,11,2291
OUTLANDER 850,2021-12-27,13,14,MI,US,27,2374
OUTLANDER 450,2021-12-27,9,1,MI,US,10,2373
OUTLANDER 1000,2019-01-07,8,12,MN,US,20,20
OUTLANDER 850,2019-01-07,1,9,MN,US,10,10
OUTLANDER 450,2019-01-07,1,13,MN,US,14,14
OUTLANDER 1000,2019-01-14,1,5,MN,US,6,26
OUTLANDER 850,2019-01-14,7,4,MN,US,11,21
OUTLANDER 450,2019-01-14,1,1,MN,US,2,16
OUTLANDER 1000,2019-01-21,1,2,MN,US,3,29
OUTLANDER 850,2019-01-21,10,11,MN,US,21,42
OUTLANDER 450,2019-01-21,7,7,MN,US,14,30
OUTLANDER 1000,2019-01-28,5,9,MN,US,14,43
OUTLANDER 850,2019-01-28,1,12,MN,US,13,55
OUTLANDER 450,2019-01-28,2,8,MN,US,10,40
OUTLANDER 1000,2019-02-04,4,8,MN,US,12,55
OUTLANDER 850,2019-02-04,5,13,MN,US,18,73
OUTLANDER 450,2019-02-04,7,11,MN,US,18,58
OUTLANDER 1000,2019-02-11,8,3,MN,US,11,66
OUTLANDER 850,2019-02-11,3,14,MN,US,17,90
OUTLANDER 450,2019-02-11,6,13,MN,US,19,77
OUTLANDER 1000,2019-02-18,12,9,MN,US,21,87
OUTLANDER 850,2019-02-18,14,5,MN,US,19,109
OUTLANDER 450,2019-02-18,7,8,MN,US,15,92
OUTLANDER 1000,2019-02-25,1,13,MN,US,14,101
OUTLANDER 850,2019-02-25,12,7,MN,US,19,128
OUTLANDER 450,2019-02-25,6,6,MN,US,12,104
OUTLANDER 1000,2019-03-04,12,4,MN,US,16,117
OUTLANDER 850,2019-03-04,13,15,MN,US,28,156
OUTLANDER 450,2019-03-04,9,8,MN,US,17,121
OUTLANDER 1000,2019-03-11,12,4,MN,US,16,133
OUTLANDER 850,2019-03-11,6,9,MN,US,15,171
OUTLANDER 450,2019-03-11,14,11,MN,US,25,146
OUTLANDER 1000,2019-03-18,14,1,MN,US,15,148
OUTLANDER 850,2019-03-18,15,12,MN,US,27,198
OUTLANDER 450,2019-03-18,14,14,MN,US,28,174
OUTLANDER 1000,2019-03-25,6,5,MN,US,11,159
OUTLANDER 850,2019-03-25,0,1,MN,US,1,199
OUTLANDER 450,2019-03-25,2,15,MN,US,17,191
OUTLANDER 1000,2019-04-01,1,6,MN,US,7,166
OUTLANDER 850,2019-04-01,10,13,MN,US,23,222
OUTLANDER 450,2019-04-01,14,5,MN,US,19,210
OUTLANDER 1000,2019-04-08,4,4,MN,US,8,174
OUTLANDER 850,2019-04-08,10,10,MN,US,20,242
OUTLANDER 450,2019-04-08,14,5,MN,US,19,229
OUTLANDER 1000,2019-04-15,10,0,MN,US,10,184
OUTLANDER 850,2019-04-15,12,8,MN,US,20,262
OUTLANDER 450,2019-04-15,13,14,MN,US,27,256
OUTLANDER 1000,2019-04-22,5,13,MN,US,18,202
OUTLANDER 850,2019-04-22,0,10,MN,US,10,272
OUTLANDER 450,2019-04-22,7,3,MN,US,10,266
OUTLANDER 1000,2019-04-29,3,9,MN,US,12,214
OUTLANDER 850,2019-04-29,5,12,MN,US,17,289
OUTLANDER 450,2019-04-29,5,1,MN,US,6,272
OUTLANDER 1000,2019-05-06,9,15,MN,US,24,238
OUTLANDER 850,2019-05-06,4,12,MN,US,16,305
OUTLANDER 450,2019-05-06,14,7,MN,US,21,293
OUTLANDER 1000,2019-05-13,11,6,MN,US,17,255
OUTLANDER 850,2019-05-13,5,14,MN,US,19,324
OUTLANDER 450,2019-05-13,6,6,MN,US,12,305
OUTLANDER 1000,2019-05-20,8,15,MN,US,23,278
OUTLANDER 850,2019-05-20,7,11,MN,US,18,342
OUTLANDER 450,2019-05-20,7,13,MN,US,20,325
OUTLANDER 1000,2019-05-27,0,15,MN,US,15,293
OUTLANDER 850,2019-05-27,10,9,MN,US,19,361
OUTLANDER 450,2019-05-27,13,13,MN,US,26,351
OUTLANDER 1000,2019-06-03,1,15,MN,US,16,309
OUTLANDER 850,2019-06-03,9,0,MN,US,9,370
OUTLANDER 450,2019-06-03,8,13,MN,US,21,372
OUTLANDER 1000,2019-06-10,4,14,MN,US,18,327
OUTLANDER 850,2019-06-10,6,5,MN,US,11,381
OUTLANDER 450,2019-06-10,5,8,MN,US,13,385
OUTLANDER 1000,2019-06-17,2,5,MN,US,7,334
OUTLANDER 850,2019-06-17,9,2,MN,US,11,392
OUTLANDER 450,2019-06-17,2,2,MN,US,4,389
OUTLANDER 1000,2019-06-24,5,5,MN,US,10,344
OUTLANDER 850,2019-06-24,1,10,MN,US,11,403
OUTLANDER 450,2019-06-24,0,11,MN,US,11,400
OUTLANDER 1000,2019-07-01,1,0,MN,US,1,345
OUTLANDER 850,2019-07-01,8,14,MN,US,22,425
OUTLANDER 450,2019-07-01,1,0,MN,US,1,401
OUTLANDER 1000,2019-07-08,3,3,MN,US,6,351
OUTLANDER 850,2019-07-08,10,9,MN,US,19,444
OUTLANDER 450,2019-07-08,5,11,MN,US,16,417
OUTLANDER 1000,2019-07-15,12,3,MN,US,15,366
OUTLANDER 850,2019-07-15,6,13,MN,US,19,463
OUTLANDER 450,2019-07-15,8,3,MN,US,11,428
OUTLANDER 1000,2019-07-22,3,9,MN,US,12,378
OUTLANDER 850,2019-07-22,12,9,MN,US,21,484
OUTLANDER 450,2019-07-22,9,14,MN,US,23,451
OUTLANDER 1000,2019-07-29,7,8,MN,US,15,393
OUTLANDER 850,2019-07-29,2,9,MN,US,11,495
OUTLANDER 450,2019-07-29,8,13,MN,US,21,472
OUTLANDER 1000,2019-08-05,13,6,MN,US,19,412
OUTLANDER 850,2019-08-05,10,4,MN,US,14,509
OUTLANDER 450,2019-08-05,2,9,MN,US,11,483
OUTLANDER 1000,2019-08-12,3,14,MN,US,17,429
OUTLANDER 850,2019-08-12,10,7,MN,US,17,526
OUTLANDER 450,2019-08-12,14,5,MN,US,19,502
OUTLANDER 1000,2019-08-19,3,9,MN,US,12,441
OUTLANDER 850,2019-08-19,8,8,MN,US,16,542
OUTLANDER 450,2019-08-19,2,5,MN,US,7,509
OUTLANDER 1000,2019-08-26,12,5,MN,US,17,458
OUTLANDER 850,2019-08-26,9,2,MN,US,11,553
OUTLANDER 450,2019-08-26,15,13,MN,US,28,537
OUTLANDER 1000,2019-09-02,14,11,MN,US,25,483
OUTLANDER 850,2019-09-02,5,15,MN,US,20,573
OUTLANDER 450,2019-09-02,10,4,MN,US,14,551
OUTLANDER 1000,2019-09-09,10,3,MN,US,13,496
OUTLANDER 850,2019-09-09,7,14,MN,US,21,594
OUTLANDER 450,2019-09-09,13,5,MN,US,18,569
OUTLANDER 1000,2019-09-16,5,6,MN,US,11,507
OUTLANDER 850,2019-09-16,0,14,MN,US,14,608
OUTLANDER 450,2019-09-16,2,7,MN,US,9,578
OUTLANDER 1000,2019-09-23,6,15,MN,US,21,528
OUTLANDER 850,2019-09-23,11,13,MN,US,24,632
OUTLANDER 450,2019-09-23,9,2,MN,US,11,589
OUTLANDER 1000,2019-09-30,2,10,MN,US,12,540
OUTLANDER 850,2019-09-30,0,4,MN,US,4,636
OUTLANDER 450,2019-09-30,11,3,MN,US,14,603
OUTLANDER 1000,2019-10-07,10,10,MN,US,20,560
OUTLANDER 850,2019-10-07,4,3,MN,US,7,643
OUTLANDER 450,2019-10-07,11,8,MN,US,19,622
OUTLANDER 1000,2019-10-14,6,6,MN,US,12,572
OUTLANDER 850,2019-10-14,13,9,MN,US,22,665
OUTLANDER 450,2019-10-14,5,1,MN,US,6,628
OUTLANDER 1000,2019-10-21,11,12,MN,US,23,595
OUTLANDER 850,2019-10-21,5,2,MN,US,7,672
OUTLANDER 450,2019-10-21,5,0,MN,US,5,633
OUTLANDER 1000,2019-10-28,14,8,MN,US,22,617
OUTLANDER 850,2019-10-28,2,13,MN,US,15,687
OUTLANDER 450,2019-10-28,8,5,MN,US,13,646
OUTLANDER 1000,2019-11-04,2,4,MN,US,6,623
OUTLANDER 850,2019-11-04,13,14,MN,US,27,714
OUTLANDER 450,2019-11-04,3,2,MN,US,5,651
OUTLANDER 1000,2019-11-11,3,5,MN,US,8,631
OUTLANDER 850,2019-11-11,4,7,MN,US,11,725
OUTLANDER 450,2019-11-11,6,14,MN,US,20,671
OUTLANDER 1000,2019-11-18,3,6,MN,US,9,640
OUTLANDER 850,2019-11-18,5,7,MN,US,12,737
OUTLANDER 450,2019-11-18,11,4,MN,US,15,686
OUTLANDER 1000,2019-11-25,8,12,MN,US,20,660
OUTLANDER 850,2019-11-25,6,4,MN,US,10,747
OUTLANDER 450,2019-11-25,3,2,MN,US,5,691
OUTLANDER 1000,2019-12-02,11,5,MN,US,16,676
OUTLANDER 850,2019-12-02,3,8,MN,US,11,758
OUTLANDER 450,2019-12-02,2,4,MN,US,6,697
OUTLANDER 1000,2019-12-09,10,4,MN,US,14,690
OUTLANDER 850,2019-12-09,7,8,MN,US,15,773
OUTLANDER 450,2019-12-09,10,10,MN,US,20,717
OUTLANDER 1000,2019-12-16,10,15,MN,US,25,715
OUTLANDER 850,2019-12-16,11,3,MN,US,14,787
OUTLANDER 450,2019-12-16,7,5,MN,US,12,729
OUTLANDER 1000,2019-12-23,6,3,MN,US,9,724
OUTLANDER 850,2019-12-23,14,5,MN,US,19,806
OUTLANDER 450,2019-12-23,12,5,MN,US,17,746
OUTLANDER 1000,2019-12-30,0,11,MN,US,11,735
OUTLANDER 850,2019-12-30,5,10,MN,US,15,821
OUTLANDER 450,2019-12-30,5,3,MN,US,8,754
OUTLANDER 1000,2020-01-06,12,3,MN,US,15,750
OUTLANDER 850,2020-01-06,0,10,MN,US,10,831
OUTLANDER 450,2020-01-06,7,12,MN,US,19,773
OUTLANDER 1000,2020-01-13,4,9,MN,US,13,763
OUTLANDER 850,2020-01-13,4,10,MN,US,14,845
OUTLANDER 450,2020-01-13,6,15,MN,US,21,794
OUTLANDER 1000,2020-01-20,14,10,MN,US,24,787
OUTLANDER 850,2020-01-20,8,0,MN,US,8,853
OUTLANDER 450,2020-01-20,2,4,MN,US,6,800
OUTLANDER 1000,2020-01-27,2,2,MN,US,4,791
OUTLANDER 850,2020-01-27,10,1,MN,US,11,864
OUTLANDER 450,2020-01-27,13,6,MN,US,19,819
OUTLANDER 1000,2020-02-03,2,3,MN,US,5,796
OUTLANDER 850,2020-02-03,1,6,MN,US,7,871
OUTLANDER 450,2020-02-03,5,11,MN,US,16,835
OUTLANDER 1000,2020-02-10,8,8,MN,US,16,812
OUTLANDER 850,2020-02-10,9,1,MN,US,10,881
OUTLANDER 450,2020-02-10,10,11,MN,US,21,856
OUTLANDER 1000,2020-02-17,2,9,MN,US,11,823
OUTLANDER 850,2020-02-17,5,5,MN,US,10,891
OUTLANDER 450,2020-02-17,9,14,MN,US,23,879
OUTLANDER 1000,2020-02-24,9,14,MN,US,23,846
OUTLANDER 850,2020-02-24,14,9,MN,US,23,914
OUTLANDER 450,2020-02-24,12,14,MN,US,26,905
OUTLANDER 1000,2020-03-02,8,4,MN,US,12,858
OUTLANDER 850,2020-03-02,1,1,MN,US,2,916
OUTLANDER 450,2020-03-02,10,14,MN,US,24,929
OUTLANDER 1000,2020-03-09,8,8,MN,US,16,874
OUTLANDER 850,2020-03-09,8,6,MN,US,14,930
OUTLANDER 450,2020-03-09,11,6,MN,US,17,946
OUTLANDER 1000,2020-03-16,7,6,MN,US,13,887
OUTLANDER 850,2020-03-16,0,3,MN,US,3,933
OUTLANDER 450,2020-03-16,10,14,MN,US,24,970
OUTLANDER 1000,2020-03-23,12,4,MN,US,16,903
OUTLANDER 850,2020-03-23,1,12,MN,US,13,946
OUTLANDER 450,2020-03-23,13,5,MN,US,18,988
OUTLANDER 1000,2020-03-30,10,13,MN,US,23,926
OUTLANDER 850,2020-03-30,10,10,MN,US,20,966
OUTLANDER 450,2020-03-30,9,7,MN,US,16,1004
OUTLANDER 1000,2020-04-06,13,6,MN,US,19,945
OUTLANDER 850,2020-04-06,14,8,MN,US,22,988
OUTLANDER 450,2020-04-06,12,15,MN,US,27,1031
OUTLANDER 1000,2020-04-13,10,8,MN,US,18,963
OUTLANDER 850,2020-04-13,10,8,MN,US,18,1006
OUTLANDER 450,2020-04-13,13,10,MN,US,23,1054
OUTLANDER 1000,2020-04-20,14,3,MN,US,17,980
OUTLANDER 850,2020-04-20,6,3,MN,US,9,1015
OUTLANDER 450,2020-04-20,6,4,MN,US,10,1064
OUTLANDER 1000,2020-04-27,5,14,MN,US,19,999
OUTLANDER 850,2020-04-27,8,13,MN,US,21,1036
OUTLANDER 450,2020-04-27,9,5,MN,US,14,1078
OUTLANDER 1000,2020-05-04,4,1,MN,US,5,1004
OUTLANDER 850,2020-05-04,7,4,MN,US,11,1047
OUTLANDER 450,2020-05-04,7,13,MN,US,20,1098
OUTLANDER 1000,2020-05-11,7,6,MN,US,13,1017
OUTLANDER 850,2020-05-11,15,3,MN,US,18,1065
OUTLANDER 450,2020-05-11,1,14,MN,US,15,1113
OUTLANDER 1000,2020-05-18,4,2,MN,US,6,1023
OUTLANDER 850,2020-05-18,7,7,MN,US,14,1079
OUTLANDER 450,2020-05-18,5,11,MN,US,16,1129
OUTLANDER 1000,2020-05-25,6,2,MN,US,8,1031
OUTLANDER 850,2020-05-25,1,14,MN,US,15,1094
OUTLANDER 450,2020-05-25,4,3,MN,US,7,1136
OUTLANDER 1000,2020-06-01,8,7,MN,US,15,1046
OUTLANDER 850,2020-06-01,7,10,MN,US,17,1111
OUTLANDER 450,2020-06-01,12,14,MN,US,26,1162
OUTLANDER 1000,2020-06-08,7,7,MN,US,14,1060
OUTLANDER 850,2020-06-08,2,13,MN,US,15,1126
OUTLANDER 450,2020-06-08,9,7,MN,US,16,1178
OUTLANDER 1000,2020-06-15,11,14,MN,US,25,1085
OUTLANDER 850,2020-06-15,12,5,MN,US,17,1143
OUTLANDER 450,2020-06-15,1,6,MN,US,7,1185
OUTLANDER 1000,2020-06-22,7,10,MN,US,17,1102
OUTLANDER 850,2020-06-22,15,5,MN,US,20,1163
OUTLANDER 450,2020-06-22,2,2,MN,US,4,1189
OUTLANDER 1000,2020-06-29,7,6,MN,US,13,1115
OUTLANDER 850,2020-06-29,6,12,MN,US,18,1181
OUTLANDER 450,2020-06-29,15,12,MN,US,27,1216
OUTLANDER 1000,2020-07-06,14,8,MN,US,22,1137
OUTLANDER 850,2020-07-06,5,12,MN,US,17,1198
OUTLANDER 450,2020-07-06,13,5,MN,US,18,1234
OUTLANDER 1000,2020-07-13,10,3,MN,US,13,1150
OUTLANDER 850,2020-07-13,14,14,MN,US,28,1226
OUTLANDER 450,2020-07-13,7,5,MN,US,12,1246
OUTLANDER 1000,2020-07-20,0,7,MN,US,7,1157
OUTLANDER 850,2020-07-20,14,14,MN,US,28,1254
OUTLANDER 450,2020-07-20,6,11,MN,US,17,1263
OUTLANDER 1000,2020-07-27,4,12,MN,US,16,1173
OUTLANDER 850,2020-07-27,10,11,MN,US,21,1275
OUTLANDER 450,2020-07-27,6,14,MN,US,20,1283
OUTLANDER 1000,2020-08-03,2,8,MN,US,10,1183
OUTLANDER 850,2020-08-03,13,8,MN,US,21,1296
OUTLANDER 450,2020-08-03,4,8,MN,US,12,1295
OUTLANDER 1000,2020-08-10,10,4,MN,US,14,1197
OUTLANDER 850,2020-08-10,9,3,MN,US,12,1308
OUTLANDER 450,2020-08-10,9,1,MN,US,10,1305
OUTLANDER 1000,2020-08-17,3,6,MN,US,9,1206
OUTLANDER 850,2020-08-17,1,8,MN,US,9,1317
OUTLANDER 450,2020-08-17,6,12,MN,US,18,1323
OUTLANDER 1000,2020-08-24,1,1,MN,US,2,1208
OUTLANDER 850,2020-08-24,0,8,MN,US,8,1325
OUTLANDER 450,2020-08-24,6,9,MN,US,15,1338
OUTLANDER 1000,2020-08-31,10,6,MN,US,16,1224
OUTLANDER 850,2020-08-31,15,14,MN,US,29,1354
OUTLANDER 450,2020-08-31,1,5,MN,US,6,1344
OUTLANDER 1000,2020-09-07,5,0,MN,US,5,1229
OUTLANDER 850,2020-09-07,11,14,MN,US,25,1379
OUTLANDER 450,2020-09-07,7,12,MN,US,19,1363
OUTLANDER 1000,2020-09-14,12,7,MN,US,19,1248
OUTLANDER 850,2020-09-14,3,13,MN,US,16,1395
OUTLANDER 450,2020-09-14,2,5,MN,US,7,1370
OUTLANDER 1000,2020-09-21,8,2,MN,US,10,1258
OUTLANDER 850,2020-09-21,3,5,MN,US,8,1403
OUTLANDER 450,2020-09-21,2,2,MN,US,4,1374
OUTLANDER 1000,2020-09-28,9,3,MN,US,12,1270
OUTLANDER 850,2020-09-28,4,10,MN,US,14,1417
OUTLANDER 450,2020-09-28,1,7,MN,US,8,1382
OUTLANDER 1000,2020-10-05,5,14,MN,US,19,1289
OUTLANDER 850,2020-10-05,9,10,MN,US,19,1436
OUTLANDER 450,2020-10-05,1,9,MN,US,10,1392
OUTLANDER 1000,2020-10-12,3,1,MN,US,4,1293
OUTLANDER 850,2020-10-12,3,8,MN,US,11,1447
OUTLANDER 450,2020-10-12,12,0,MN,US,12,1404
OUTLANDER 1000,2020-10-19,14,7,MN,US,21,1314
OUTLANDER 850,2020-10-19,1,3,MN,US,4,1451
OUTLANDER 450,2020-10-19,14,6,MN,US,20,1424
OUTLANDER 1000,2020-10-26,10,13,MN,US,23,1337
OUTLANDER 850,2020-10-26,9,14,MN,US,23,1474
OUTLANDER 450,2020-10-26,7,6,MN,US,13,1437
OUTLANDER 1000,2020-11-02,7,1,MN,US,8,1345
OUTLANDER 850,2020-11-02,13,5,MN,US,18,1492
OUTLANDER 450,2020-11-02,13,7,MN,US,20,1457
OUTLANDER 1000,2020-11-09,6,14,MN,US,20,1365
OUTLANDER 850,2020-11-09,4,1,MN,US,5,1497
OUTLANDER 450,2020-11-09,3,5,MN,US,8,1465
OUTLANDER 1000,2020-11-16,13,6,MN,US,19,1384
OUTLANDER 850,2020-11-16,9,6,MN,US,15,1512
OUTLANDER 450,2020-11-16,3,12,MN,US,15,1480
OUTLANDER 1000,2020-11-23,0,14,MN,US,14,1398
OUTLANDER 850,2020-11-23,12,4,MN,US,16,1528
OUTLANDER 450,2020-11-23,7,8,MN,US,15,1495
OUTLANDER 1000,2020-11-30,0,13,MN,US,13,1411
OUTLANDER 850,2020-11-30,14,7,MN,US,21,1549
OUTLANDER 450,2020-11-30,5,1,MN,US,6,1501
OUTLANDER 1000,2020-12-07,8,8,MN,US,16,1427
OUTLANDER 850,2020-12-07,6,12,MN,US,18,1567
OUTLANDER 450,2020-12-07,7,3,MN,US,10,1511
OUTLANDER 1000,2020-12-14,3,9,MN,US,12,1439
OUTLANDER 850,2020-12-14,8,1,MN,US,9,1576
OUTLANDER 450,2020-12-14,9,15,MN,US,24,1535
OUTLANDER 1000,2020-12-21,11,6,MN,US,17,1456
OUTLANDER 850,2020-12-21,5,1,MN,US,6,1582
OUTLANDER 450,2020-12-21,13,12,MN,US,25,1560
OUTLANDER 1000,2020-12-28,0,13,MN,US,13,1469
OUTLANDER 850,2020-12-28,2,2,MN,US,4,1586
OUTLANDER 450,2020-12-28,3,11,MN,US,14,1574
OUTLANDER 1000,2021-01-04,6,1,MN,US,7,1476
OUTLANDER 850,2021-01-04,2,9,MN,US,11,1597
OUTLANDER 450,2021-01-04,12,12,MN,US,24,1598
OUTLANDER 1000,2021-01-11,11,9,MN,US,20,1496
OUTLANDER 850,2021-01-11,10,0,MN,US,10,1607
OUTLANDER 450,2021-01-11,4,9,MN,US,13,1611
OUTLANDER 1000,2021-01-18,6,11,MN,US,17,1513
OUTLANDER 850,2021-01-18,13,5,MN,US,18,1625
OUTLANDER 450,2021-01-18,9,12,MN,US,21,1632
OUTLANDER 1000,2021-01-25,0,11,MN,US,11,1524
OUTLANDER 850,2021-01-25,6,14,MN,US,20,1645
OUTLANDER 450,2021-01-25,5,1,MN,US,6,1638
OUTLANDER 1000,2021-02-01,1,15,MN,US,16,1540
OUTLANDER 850,2021-02-01,6,13,MN,US,19,1664
OUTLANDER 450,2021-02-01,10,8,MN,US,18,1656
OUTLANDER 1000,2021-02-08,5,1,MN,US,6,1546
OUTLANDER 850,2021-02-08,0,11,MN,US,11,1675
OUTLANDER 450,2021-02-08,9,5,MN,US,14,1670
OUTLANDER 1000,2021-02-15,3,6,MN,US,9,1555
OUTLANDER 850,2021-02-15,1,8,MN,US,9,1684
OUTLANDER 450,2021-02-15,9,8,MN,US,17,1687
OUTLANDER 1000,2021-02-22,15,11,MN,US,26,1581
OUTLANDER 850,2021-02-22,10,11,MN,US,21,1705
OUTLANDER 450,2021-02-22,6,5,MN,US,11,1698
OUTLANDER 1000,2021-03-01,9,12,MN,US,21,1602
OUTLANDER 850,2021-03-01,9,5,MN,US,14,1719
OUTLANDER 450,2021-03-01,6,14,MN,US,20,1718
OUTLANDER 1000,2021-03-08,9,10,MN,US,19,1621
OUTLANDER 850,2021-03-08,12,5,MN,US,17,1736
OUTLANDER 450,2021-03-08,7,1,MN,US,8,1726
OUTLANDER 1000,2021-03-15,6,10,MN,US,16,1637
OUTLANDER 850,2021-03-15,10,9,MN,US,19,1755
OUTLANDER 450,2021-03-15,4,13,MN,US,17,1743
OUTLANDER 1000,2021-03-22,0,1,MN,US,1,1638
OUTLANDER 850,2021-03-22,11,11,MN,US,22,1777
OUTLANDER 450,2021-03-22,6,12,MN,US,18,1761
OUTLANDER 1000,2021-03-29,12,6,MN,US,18,1656
OUTLANDER 850,2021-03-29,6,6,MN,US,12,1789
OUTLANDER 450,2021-03-29,1,2,MN,US,3,1764
OUTLANDER 1000,2021-04-05,2,4,MN,US,6,1662
OUTLANDER 850,2021-04-05,4,11,MN,US,15,1804
OUTLANDER 450,2021-04-05,14,12,MN,US,26,1790
OUTLANDER 1000,2021-04-12,13,14,MN,US,27,1689
OUTLANDER 850,2021-04-12,2,6,MN,US,8,1812
OUTLANDER 450,2021-04-12,4,0,MN,US,4,1794
OUTLANDER 1000,2021-04-19,4,1,MN,US,5,1694
OUTLANDER 850,2021-04-19,7,9,MN,US,16,1828
OUTLANDER 450,2021-04-19,11,11,MN,US,22,1816
OUTLANDER 1000,2021-04-26,12,0,MN,US,12,1706
OUTLANDER 850,2021-04-26,12,6,MN,US,18,1846
OUTLANDER 450,2021-04-26,10,9,MN,US,19,1835
OUTLANDER 1000,2021-05-03,8,1,MN,US,9,1715
OUTLANDER 850,2021-05-03,15,10,MN,US,25,1871
OUTLANDER 450,2021-05-03,2,10,MN,US,12,1847
OUTLANDER 1000,2021-05-10,10,8,MN,US,18,1733
OUTLANDER 850,2021-05-10,3,13,MN,US,16,1887
OUTLANDER 450,2021-05-10,3,12,MN,US,15,1862
OUTLANDER 1000,2021-05-17,3,5,MN,US,8,1741
OUTLANDER 850,2021-05-17,5,8,MN,US,13,1900
OUTLANDER 450,2021-05-17,9,5,MN,US,14,1876
OUTLANDER 1000,2021-05-24,0,4,MN,US,4,1745
OUTLANDER 850,2021-05-24,3,2,MN,US,5,1905
OUTLANDER 450,2021-05-24,2,8,MN,US,10,1886
OUTLANDER 1000,2021-05-31,9,7,MN,US,16,1761
OUTLANDER 850,2021-05-31,4,1,MN,US,5,1910
OUTLANDER 450,2021-05-31,14,11,MN,US,25,1911
OUTLANDER 1000,2021-06-07,6,9,MN,US,15,1776
OUTLANDER 850,2021-06-07,8,12,MN,US,20,1930
OUTLANDER 450,2021-06-07,14,9,MN,US,23,1934
OUTLANDER 1000,2021-06-14,0,7,MN,US,7,1783
OUTLANDER 850,2021-06-14,12,13,MN,US,25,1955
OUTLANDER 450,2021-06-14,2,13,MN,US,15,1949
OUTLANDER 1000,2021-06-21,3,14,MN,US,17,1800
OUTLANDER 850,2021-06-21,11,10,MN,US,21,1976
OUTLANDER 450,2021-06-21,9,10,MN,US,19,1968
OUTLANDER 1000,2021-06-28,8,11,MN,US,19,1819
OUTLANDER 850,2021-06-28,0,7,MN,US,7,1983
OUTLANDER 450,2021-06-28,1,12,MN,US,13,1981
OUTLANDER 1000,2021-07-05,2,13,MN,US,15,1834
OUTLANDER 850,2021-07-05,10,8,MN,US,18,2001
OUTLANDER 450,2021-07-05,11,13,MN,US,24,2005
OUTLANDER 1000,2021-07-12,2,7,MN,US,9,1843
OUTLANDER 850,2021-07-12,0,1,MN,US,1,2002
OUTLANDER 450,2021-07-12,12,14,MN,US,26,2031
OUTLANDER 1000,2021-07-19,10,13,MN,US,23,1866
OUTLANDER 850,2021-07-19,8,9,MN,US,17,2019
OUTLANDER 450,2021-07-19,8,11,MN,US,19,2050
OUTLANDER 1000,2021-07-26,8,0,MN,US,8,1874
OUTLANDER 850,2021-07-26,3,4,MN,US,7,2026
OUTLANDER 450,2021-07-26,9,15,MN,US,24,2074
OUTLANDER 1000,2021-08-02,9,12,MN,US,21,1895
OUTLANDER 850,2021-08-02,13,2,MN,US,15,2041
OUTLANDER 450,2021-08-02,9,4,MN,US,13,2087
OUTLANDER 1000,2021-08-09,5,12,MN,US,17,1912
OUTLANDER 850,2021-08-09,11,1,MN,US,12,2053
OUTLANDER 450,2021-08-09,5,4,MN,US,9,2096
OUTLANDER 1000,2021-08-16,2,14,MN,US,16,1928
OUTLANDER 850,2021-08-16,13,2,MN,US,15,2068
OUTLANDER 450,2021-08-16,13,7,MN,US,20,2116
OUTLANDER 1000,2021-08-23,14,8,MN,US,22,1950
OUTLANDER 850,2021-08-23,13,10,MN,US,23,2091
OUTLANDER 450,2021-08-23,10,0,MN,US,10,2126
OUTLANDER 1000,2021-08-30,9,4,MN,US,13,1963
OUTLANDER 850,2021-08-30,3,8,MN,US,11,2102
OUTLANDER 450,2021-08-30,7,1,MN,US,8,2134
OUTLANDER 1000,2021-09-06,3,6,MN,US,9,1972
OUTLANDER 850,2021-09-06,2,7,MN,US,9,2111
OUTLANDER 450,2021-09-06,7,9,MN,US,16,2150
OUTLANDER 1000,2021-09-13,10,4,MN,US,14,1986
OUTLANDER 850,2021-09-13,11,5,MN,US,16,2127
OUTLANDER 450,2021-09-13,1,5,MN,US,6,2156
OUTLANDER 1000,2021-09-20,1,6,MN,US,7,1993
OUTLANDER 850,2021-09-20,5,11,MN,US,16,2143
OUTLANDER 450,2021-09-20,2,9,MN,US,11,2167
OUTLANDER 1000,2021-09-27,5,4,MN,US,9,2002
OUTLANDER 850,2021-09-27,10,10,MN,US,20,2163
OUTLANDER 450,2021-09-27,5,9,MN,US,14,2181
OUTLANDER 1000,2021-10-04,4,12,MN,US,16,2018
OUTLANDER 850,2021-10-04,11,1,MN,US,12,2175
OUTLANDER 450,2021-10-04,7,5,MN,US,12,2193
OUTLANDER 1000,2021-10-11,11,3,MN,US,14,2032
OUTLANDER 850,2021-10-11,6,2,MN,US,8,2183
OUTLANDER 450,2021-10-11,15,15,MN,US,30,2223
OUTLANDER 1000,2021-10-18,4,1,MN,US,5,2037
OUTLANDER 850,2021-10-18,5,2,MN,US,7,2190
OUTLANDER 450,2021-10-18,8,5,MN,US,13,2236
OUTLANDER 1000,2021-10-25,8,2,MN,US,10,2047
OUTLANDER 850,2021-10-25,7,4,MN,US,11,2201
OUTLANDER 450,2021-10-25,10,13,MN,US,23,2259
OUTLANDER 1000,2021-11-01,12,14,MN,US,26,2073
OUTLANDER 850,2021-11-01,5,11,MN,US,16,2217
OUTLANDER 450,2021-11-01,1,2,MN,US,3,2262
OUTLANDER 1000,2021-11-08,7,14,MN,US,21,2094
OUTLANDER 850,2021-11-08,12,5,MN,US,17,2234
OUTLANDER 450,2021-11-08,0,1,MN,US,1,2263
OUTLANDER 1000,2021-11-15,5,5,MN,US,10,2104
OUTLANDER 850,2021-11-15,5,2,MN,US,7,2241
OUTLANDER 450,2021-11-15,4,2,MN,US,6,2269
OUTLANDER 1000,2021-11-22,9,11,MN,US,20,2124
OUTLANDER 850,2021-11-22,9,15,MN,US,24,2265
OUTLANDER 450,2021-11-22,11,6,MN,US,17,2286
OUTLANDER 1000,2021-11-29,3,10,MN,US,13,2137
OUTLANDER 850,2021-11-29,3,1,MN,US,4,2269
OUTLANDER 450,2021-11-29,2,8,MN,US,10,2296
OUTLANDER 1000,2021-12-06,1,3,MN,US,4,2141
OUTLANDER 850,2021-12-06,4,0,MN,US,4,2273
OUTLANDER 450,2021-12-06,3,10,MN,US,13,2309
OUTLANDER 1000,2021-12-13,15,14,MN,US,29,2170
OUTLANDER 850,2021-12-13,7,10,MN,US,17,2290
OUTLANDER 450,2021-12-13,4,6,MN,US,10,2319
OUTLANDER 1000,2021-12-20,2,5,MN,US,7,2177
OUTLANDER 850,2021-12-20,2,8,MN,US,10,2300
OUTLANDER 450,2021-12-20,9,5,MN,US,14,2333
OUTLANDER 1000,2021-12-27,12,1,MN,US,13,2190
OUTLANDER 850,2021-12-27,1,7,MN,US,8,2308
OUTLANDER 450,2021-12-27,6,2,MN,US,8,2341
OUTLANDER 1000,2019-01-07,14,9,MS,US,23,23
OUTLANDER 850,2019-01-07,5,6,MS,US,11,11
OUTLANDER 450,2019-01-07,15,2,MS,US,17,17
OUTLANDER 1000,2019-01-14,8,1,MS,US,9,32
OUTLANDER 850,2019-01-14,11,7,MS,US,18,29
OUTLANDER 450,2019-01-14,5,12,MS,US,17,34
OUTLANDER 1000,2019-01-21,14,2,MS,US,16,48
OUTLANDER 850,2019-01-21,5,4,MS,US,9,38
OUTLANDER 450,2019-01-21,13,9,MS,US,22,56
OUTLANDER 1000,2019-01-28,14,11,MS,US,25,73
OUTLANDER 850,2019-01-28,9,8,MS,US,17,55
OUTLANDER 450,2019-01-28,10,12,MS,US,22,78
OUTLANDER 1000,2019-02-04,7,12,MS,US,19,92
OUTLANDER 850,2019-02-04,13,6,MS,US,19,74
OUTLANDER 450,2019-02-04,7,14,MS,US,21,99
OUTLANDER 1000,2019-02-11,9,5,MS,US,14,106
OUTLANDER 850,2019-02-11,9,14,MS,US,23,97
OUTLANDER 450,2019-02-11,14,12,MS,US,26,125
OUTLANDER 1000,2019-02-18,11,10,MS,US,21,127
OUTLANDER 850,2019-02-18,3,12,MS,US,15,112
OUTLANDER 450,2019-02-18,13,6,MS,US,19,144
OUTLANDER 1000,2019-02-25,5,2,MS,US,7,134
OUTLANDER 850,2019-02-25,10,13,MS,US,23,135
OUTLANDER 450,2019-02-25,7,13,MS,US,20,164
OUTLANDER 1000,2019-03-04,4,12,MS,US,16,150
OUTLANDER 850,2019-03-04,1,8,MS,US,9,144
OUTLANDER 450,2019-03-04,5,5,MS,US,10,174
OUTLANDER 1000,2019-03-11,8,1,MS,US,9,159
OUTLANDER 850,2019-03-11,12,14,MS,US,26,170
OUTLANDER 450,2019-03-11,10,9,MS,US,19,193
OUTLANDER 1000,2019-03-18,6,1,MS,US,7,166
OUTLANDER 850,2019-03-18,6,3,MS,US,9,179
OUTLANDER 450,2019-03-18,0,7,MS,US,7,200
OUTLANDER 1000,2019-03-25,14,12,MS,US,26,192
OUTLANDER 850,2019-03-25,7,4,MS,US,11,190
OUTLANDER 450,2019-03-25,1,1,MS,US,2,202
OUTLANDER 1000,2019-04-01,15,7,MS,US,22,214
OUTLANDER 850,2019-04-01,9,2,MS,US,11,201
OUTLANDER 450,2019-04-01,0,12,MS,US,12,214
OUTLANDER 1000,2019-04-08,2,10,MS,US,12,226
OUTLANDER 850,2019-04-08,12,15,MS,US,27,228
OUTLANDER 450,2019-04-08,10,3,MS,US,13,227
OUTLANDER 1000,2019-04-15,11,12,MS,US,23,249
OUTLANDER 850,2019-04-15,10,1,MS,US,11,239
OUTLANDER 450,2019-04-15,8,1,MS,US,9,236
OUTLANDER 1000,2019-04-22,8,2,MS,US,10,259
OUTLANDER 850,2019-04-22,1,1,MS,US,2,241
OUTLANDER 450,2019-04-22,13,6,MS,US,19,255
OUTLANDER 1000,2019-04-29,4,5,MS,US,9,268
OUTLANDER 850,2019-04-29,10,15,MS,US,25,266
OUTLANDER 450,2019-04-29,6,5,MS,US,11,266
OUTLANDER 1000,2019-05-06,1,4,MS,US,5,273
OUTLANDER 850,2019-05-06,3,3,MS,US,6,272
OUTLANDER 450,2019-05-06,14,10,MS,US,24,290
OUTLANDER 1000,2019-05-13,5,15,MS,US,20,293
OUTLANDER 850,2019-05-13,1,0,MS,US,1,273
OUTLANDER 450,2019-05-13,8,6,MS,US,14,304
OUTLANDER 1000,2019-05-20,12,5,MS,US,17,310
OUTLANDER 850,2019-05-20,6,6,MS,US,12,285
OUTLANDER 450,2019-05-20,2,2,MS,US,4,308
OUTLANDER 1000,2019-05-27,9,7,MS,US,16,326
OUTLANDER 850,2019-05-27,2,12,MS,US,14,299
OUTLANDER 450,2019-05-27,14,6,MS,US,20,328
OUTLANDER 1000,2019-06-03,14,5,MS,US,19,345
OUTLANDER 850,2019-06-03,14,8,MS,US,22,321
OUTLANDER 450,2019-06-03,11,5,MS,US,16,344
OUTLANDER 1000,2019-06-10,14,4,MS,US,18,363
OUTLANDER 850,2019-06-10,9,14,MS,US,23,344
OUTLANDER 450,2019-06-10,8,3,MS,US,11,355
OUTLANDER 1000,2019-06-17,13,14,MS,US,27,390
OUTLANDER 850,2019-06-17,13,6,MS,US,19,363
OUTLANDER 450,2019-06-17,1,2,MS,US,3,358
OUTLANDER 1000,2019-06-24,11,9,MS,US,20,410
OUTLANDER 850,2019-06-24,0,12,MS,US,12,375
OUTLANDER 450,2019-06-24,5,11,MS,US,16,374
OUTLANDER 1000,2019-07-01,14,14,MS,US,28,438
OUTLANDER 850,2019-07-01,15,11,MS,US,26,401
OUTLANDER 450,2019-07-01,4,5,MS,US,9,383
OUTLANDER 1000,2019-07-08,12,10,MS,US,22,460
OUTLANDER 850,2019-07-08,0,1,MS,US,1,402
OUTLANDER 450,2019-07-08,2,1,MS,US,3,386
OUTLANDER 1000,2019-07-15,10,14,MS,US,24,484
OUTLANDER 850,2019-07-15,5,11,MS,US,16,418
OUTLANDER 450,2019-07-15,2,3,MS,US,5,391
OUTLANDER 1000,2019-07-22,3,15,MS,US,18,502
OUTLANDER 850,2019-07-22,13,5,MS,US,18,436
OUTLANDER 450,2019-07-22,1,4,MS,US,5,396
OUTLANDER 1000,2019-07-29,11,3,MS,US,14,516
OUTLANDER 850,2019-07-29,9,12,MS,US,21,457
OUTLANDER 450,2019-07-29,4,4,MS,US,8,404
OUTLANDER 1000,2019-08-05,0,4,MS,US,4,520
OUTLANDER 850,2019-08-05,1,3,MS,US,4,461
OUTLANDER 450,2019-08-05,14,5,MS,US,19,423
OUTLANDER 1000,2019-08-12,9,0,MS,US,9,529
OUTLANDER 850,2019-08-12,15,2,MS,US,17,478
OUTLANDER 450,2019-08-12,9,6,MS,US,15,438
OUTLANDER 1000,2019-08-19,14,9,MS,US,23,552
OUTLANDER 850,2019-08-19,14,13,MS,US,27,505
OUTLANDER 450,2019-08-19,8,4,MS,US,12,450
OUTLANDER 1000,2019-08-26,6,2,MS,US,8,560
OUTLANDER 850,2019-08-26,13,3,MS,US,16,521
OUTLANDER 450,2019-08-26,5,1,MS,US,6,456
OUTLANDER 1000,2019-09-02,15,10,MS,US,25,585
OUTLANDER 850,2019-09-02,11,1,MS,US,12,533
OUTLANDER 450,2019-09-02,6,11,MS,US,17,473
OUTLANDER 1000,2019-09-09,10,8,MS,US,18,603
OUTLANDER 850,2019-09-09,2,14,MS,US,16,549
OUTLANDER 450,2019-09-09,10,0,MS,US,10,483
OUTLANDER 1000,2019-09-16,3,14,MS,US,17,620
OUTLANDER 850,2019-09-16,5,2,MS,US,7,556
OUTLANDER 450,2019-09-16,6,14,MS,US,20,503
OUTLANDER 1000,2019-09-23,10,7,MS,US,17,637
OUTLANDER 850,2019-09-23,13,8,MS,US,21,577
OUTLANDER 450,2019-09-23,14,9,MS,US,23,526
OUTLANDER 1000,2019-09-30,3,7,MS,US,10,647
OUTLANDER 850,2019-09-30,14,0,MS,US,14,591
OUTLANDER 450,2019-09-30,7,7,MS,US,14,540
OUTLANDER 1000,2019-10-07,3,4,MS,US,7,654
OUTLANDER 850,2019-10-07,11,11,MS,US,22,613
OUTLANDER 450,2019-10-07,9,2,MS,US,11,551
OUTLANDER 1000,2019-10-14,14,13,MS,US,27,681
OUTLANDER 850,2019-10-14,9,7,MS,US,16,629
OUTLANDER 450,2019-10-14,5,6,MS,US,11,562
OUTLANDER 1000,2019-10-21,7,9,MS,US,16,697
OUTLANDER 850,2019-10-21,8,11,MS,US,19,648
OUTLANDER 450,2019-10-21,13,7,MS,US,20,582
OUTLANDER 1000,2019-10-28,5,10,MS,US,15,712
OUTLANDER 850,2019-10-28,5,12,MS,US,17,665
OUTLANDER 450,2019-10-28,8,0,MS,US,8,590
OUTLANDER 1000,2019-11-04,8,8,MS,US,16,728
OUTLANDER 850,2019-11-04,3,3,MS,US,6,671
OUTLANDER 450,2019-11-04,6,8,MS,US,14,604
OUTLANDER 1000,2019-11-11,14,12,MS,US,26,754
OUTLANDER 850,2019-11-11,8,11,MS,US,19,690
OUTLANDER 450,2019-11-11,1,10,MS,US,11,615
OUTLANDER 1000,2019-11-18,6,11,MS,US,17,771
OUTLANDER 850,2019-11-18,7,8,MS,US,15,705
OUTLANDER 450,2019-11-18,9,10,MS,US,19,634
OUTLANDER 1000,2019-11-25,13,10,MS,US,23,794
OUTLANDER 850,2019-11-25,7,6,MS,US,13,718
OUTLANDER 450,2019-11-25,14,4,MS,US,18,652
OUTLANDER 1000,2019-12-02,5,10,MS,US,15,809
OUTLANDER 850,2019-12-02,9,10,MS,US,19,737
OUTLANDER 450,2019-12-02,6,12,MS,US,18,670
OUTLANDER 1000,2019-12-09,14,14,MS,US,28,837
OUTLANDER 850,2019-12-09,14,1,MS,US,15,752
OUTLANDER 450,2019-12-09,1,1,MS,US,2,672
OUTLANDER 1000,2019-12-16,7,10,MS,US,17,854
OUTLANDER 850,2019-12-16,2,5,MS,US,7,759
OUTLANDER 450,2019-12-16,2,12,MS,US,14,686
OUTLANDER 1000,2019-12-23,4,8,MS,US,12,866
OUTLANDER 850,2019-12-23,5,13,MS,US,18,777
OUTLANDER 450,2019-12-23,11,6,MS,US,17,703
OUTLANDER 1000,2019-12-30,7,2,MS,US,9,875
OUTLANDER 850,2019-12-30,9,14,MS,US,23,800
OUTLANDER 450,2019-12-30,7,13,MS,US,20,723
OUTLANDER 1000,2020-01-06,6,10,MS,US,16,891
OUTLANDER 850,2020-01-06,7,10,MS,US,17,817
OUTLANDER 450,2020-01-06,5,12,MS,US,17,740
OUTLANDER 1000,2020-01-13,11,14,MS,US,25,916
OUTLANDER 850,2020-01-13,5,12,MS,US,17,834
OUTLANDER 450,2020-01-13,13,13,MS,US,26,766
OUTLANDER 1000,2020-01-20,10,15,MS,US,25,941
OUTLANDER 850,2020-01-20,11,2,MS,US,13,847
OUTLANDER 450,2020-01-20,10,11,MS,US,21,787
OUTLANDER 1000,2020-01-27,13,13,MS,US,26,967
OUTLANDER 850,2020-01-27,10,5,MS,US,15,862
OUTLANDER 450,2020-01-27,5,10,MS,US,15,802
OUTLANDER 1000,2020-02-03,3,0,MS,US,3,970
OUTLANDER 850,2020-02-03,2,13,MS,US,15,877
OUTLANDER 450,2020-02-03,1,8,MS,US,9,811
OUTLANDER 1000,2020-02-10,11,2,MS,US,13,983
OUTLANDER 850,2020-02-10,11,10,MS,US,21,898
OUTLANDER 450,2020-02-10,3,9,MS,US,12,823
OUTLANDER 1000,2020-02-17,5,15,MS,US,20,1003
OUTLANDER 850,2020-02-17,11,9,MS,US,20,918
OUTLANDER 450,2020-02-17,4,6,MS,US,10,833
OUTLANDER 1000,2020-02-24,14,13,MS,US,27,1030
OUTLANDER 850,2020-02-24,9,3,MS,US,12,930
OUTLANDER 450,2020-02-24,5,6,MS,US,11,844
OUTLANDER 1000,2020-03-02,11,8,MS,US,19,1049
OUTLANDER 850,2020-03-02,8,2,MS,US,10,940
OUTLANDER 450,2020-03-02,1,11,MS,US,12,856
OUTLANDER 1000,2020-03-09,13,9,MS,US,22,1071
OUTLANDER 850,2020-03-09,3,6,MS,US,9,949
OUTLANDER 450,2020-03-09,5,13,MS,US,18,874
OUTLANDER 1000,2020-03-16,6,8,MS,US,14,1085
OUTLANDER 850,2020-03-16,2,7,MS,US,9,958
OUTLANDER 450,2020-03-16,0,7,MS,US,7,881
OUTLANDER 1000,2020-03-23,15,5,MS,US,20,1105
OUTLANDER 850,2020-03-23,12,2,MS,US,14,972
OUTLANDER 450,2020-03-23,1,2,MS,US,3,884
OUTLANDER 1000,2020-03-30,1,1,MS,US,2,1107
OUTLANDER 850,2020-03-30,15,3,MS,US,18,990
OUTLANDER 450,2020-03-30,6,6,MS,US,12,896
OUTLANDER 1000,2020-04-06,5,4,MS,US,9,1116
OUTLANDER 850,2020-04-06,8,15,MS,US,23,1013
OUTLANDER 450,2020-04-06,3,5,MS,US,8,904
OUTLANDER 1000,2020-04-13,7,3,MS,US,10,1126
OUTLANDER 850,2020-04-13,9,7,MS,US,16,1029
OUTLANDER 450,2020-04-13,5,6,MS,US,11,915
OUTLANDER 1000,2020-04-20,10,3,MS,US,13,1139
OUTLANDER 850,2020-04-20,13,11,MS,US,24,1053
OUTLANDER 450,2020-04-20,8,13,MS,US,21,936
OUTLANDER 1000,2020-04-27,5,9,MS,US,14,1153
OUTLANDER 850,2020-04-27,5,12,MS,US,17,1070
OUTLANDER 450,2020-04-27,9,7,MS,US,16,952
OUTLANDER 1000,2020-05-04,1,8,MS,US,9,1162
OUTLANDER 850,2020-05-04,2,5,MS,US,7,1077
OUTLANDER 450,2020-05-04,14,5,MS,US,19,971
OUTLANDER 1000,2020-05-11,11,1,MS,US,12,1174
OUTLANDER 850,2020-05-11,13,7,MS,US,20,1097
OUTLANDER 450,2020-05-11,2,15,MS,US,17,988
OUTLANDER 1000,2020-05-18,11,13,MS,US,24,1198
OUTLANDER 850,2020-05-18,6,8,MS,US,14,1111
OUTLANDER 450,2020-05-18,9,6,MS,US,15,1003
OUTLANDER 1000,2020-05-25,3,4,MS,US,7,1205
OUTLANDER 850,2020-05-25,8,7,MS,US,15,1126
OUTLANDER 450,2020-05-25,12,5,MS,US,17,1020
OUTLANDER 1000,2020-06-01,4,7,MS,US,11,1216
OUTLANDER 850,2020-06-01,1,0,MS,US,1,1127
OUTLANDER 450,2020-06-01,10,7,MS,US,17,1037
OUTLANDER 1000,2020-06-08,8,0,MS,US,8,1224
OUTLANDER 850,2020-06-08,8,13,MS,US,21,1148
OUTLANDER 450,2020-06-08,5,9,MS,US,14,1051
OUTLANDER 1000,2020-06-15,1,12,MS,US,13,1237
OUTLANDER 850,2020-06-15,10,2,MS,US,12,1160
OUTLANDER 450,2020-06-15,9,10,MS,US,19,1070
OUTLANDER 1000,2020-06-22,4,10,MS,US,14,1251
OUTLANDER 850,2020-06-22,11,15,MS,US,26,1186
OUTLANDER 450,2020-06-22,13,0,MS,US,13,1083
OUTLANDER 1000,2020-06-29,13,6,MS,US,19,1270
OUTLANDER 850,2020-06-29,4,13,MS,US,17,1203
OUTLANDER 450,2020-06-29,9,2,MS,US,11,1094
OUTLANDER 1000,2020-07-06,13,10,MS,US,23,1293
OUTLANDER 850,2020-07-06,15,14,MS,US,29,1232
OUTLANDER 450,2020-07-06,4,1,MS,US,5,1099
OUTLANDER 1000,2020-07-13,7,7,MS,US,14,1307
OUTLANDER 850,2020-07-13,6,2,MS,US,8,1240
OUTLANDER 450,2020-07-13,13,12,MS,US,25,1124
OUTLANDER 1000,2020-07-20,3,11,MS,US,14,1321
OUTLANDER 850,2020-07-20,10,5,MS,US,15,1255
OUTLANDER 450,2020-07-20,5,4,MS,US,9,1133
OUTLANDER 1000,2020-07-27,15,3,MS,US,18,1339
OUTLANDER 850,2020-07-27,13,10,MS,US,23,1278
OUTLANDER 450,2020-07-27,13,11,MS,US,24,1157
OUTLANDER 1000,2020-08-03,14,11,MS,US,25,1364
OUTLANDER 850,2020-08-03,7,8,MS,US,15,1293
OUTLANDER 450,2020-08-03,11,1,MS,US,12,1169
OUTLANDER 1000,2020-08-10,12,3,MS,US,15,1379
OUTLANDER 850,2020-08-10,7,6,MS,US,13,1306
OUTLANDER 450,2020-08-10,3,15,MS,US,18,1187
OUTLANDER 1000,2020-08-17,7,3,MS,US,10,1389
OUTLANDER 850,2020-08-17,5,15,MS,US,20,1326
OUTLANDER 450,2020-08-17,7,6,MS,US,13,1200
OUTLANDER 1000,2020-08-24,6,2,MS,US,8,1397
OUTLANDER 850,2020-08-24,9,10,MS,US,19,1345
OUTLANDER 450,2020-08-24,4,14,MS,US,18,1218
OUTLANDER 1000,2020-08-31,2,5,MS,US,7,1404
OUTLANDER 850,2020-08-31,7,14,MS,US,21,1366
OUTLANDER 450,2020-08-31,11,10,MS,US,21,1239
OUTLANDER 1000,2020-09-07,7,14,MS,US,21,1425
OUTLANDER 850,2020-09-07,8,3,MS,US,11,1377
OUTLANDER 450,2020-09-07,6,14,MS,US,20,1259
OUTLANDER 1000,2020-09-14,1,1,MS,US,2,1427
OUTLANDER 850,2020-09-14,14,2,MS,US,16,1393
OUTLANDER 450,2020-09-14,9,5,MS,US,14,1273
OUTLANDER 1000,2020-09-21,13,10,MS,US,23,1450
OUTLANDER 850,2020-09-21,5,14,MS,US,19,1412
OUTLANDER 450,2020-09-21,10,4,MS,US,14,1287
OUTLANDER 1000,2020-09-28,4,10,MS,US,14,1464
OUTLANDER 850,2020-09-28,8,11,MS,US,19,1431
OUTLANDER 450,2020-09-28,6,7,MS,US,13,1300
OUTLANDER 1000,2020-10-05,9,1,MS,US,10,1474
OUTLANDER 850,2020-10-05,8,10,MS,US,18,1449
OUTLANDER 450,2020-10-05,6,15,MS,US,21,1321
OUTLANDER 1000,2020-10-12,3,6,MS,US,9,1483
OUTLANDER 850,2020-10-12,14,10,MS,US,24,1473
OUTLANDER 450,2020-10-12,13,7,MS,US,20,1341
OUTLANDER 1000,2020-10-19,1,6,MS,US,7,1490
OUTLANDER 850,2020-10-19,6,13,MS,US,19,1492
OUTLANDER 450,2020-10-19,3,8,MS,US,11,1352
OUTLANDER 1000,2020-10-26,13,15,MS,US,28,1518
OUTLANDER 850,2020-10-26,5,12,MS,US,17,1509
OUTLANDER 450,2020-10-26,3,1,MS,US,4,1356
OUTLANDER 1000,2020-11-02,8,4,MS,US,12,1530
OUTLANDER 850,2020-11-02,12,7,MS,US,19,1528
OUTLANDER 450,2020-11-02,11,15,MS,US,26,1382
OUTLANDER 1000,2020-11-09,7,6,MS,US,13,1543
OUTLANDER 850,2020-11-09,6,3,MS,US,9,1537
OUTLANDER 450,2020-11-09,5,15,MS,US,20,1402
OUTLANDER 1000,2020-11-16,11,2,MS,US,13,1556
OUTLANDER 850,2020-11-16,0,9,MS,US,9,1546
OUTLANDER 450,2020-11-16,3,12,MS,US,15,1417
OUTLANDER 1000,2020-11-23,7,9,MS,US,16,1572
OUTLANDER 850,2020-11-23,8,1,MS,US,9,1555
OUTLANDER 450,2020-11-23,11,6,MS,US,17,1434
OUTLANDER 1000,2020-11-30,13,7,MS,US,20,1592
OUTLANDER 850,2020-11-30,7,4,MS,US,11,1566
OUTLANDER 450,2020-11-30,8,1,MS,US,9,1443
OUTLANDER 1000,2020-12-07,11,7,MS,US,18,1610
OUTLANDER 850,2020-12-07,15,13,MS,US,28,1594
OUTLANDER 450,2020-12-07,6,10,MS,US,16,1459
OUTLANDER 1000,2020-12-14,11,8,MS,US,19,1629
OUTLANDER 850,2020-12-14,8,14,MS,US,22,1616
OUTLANDER 450,2020-12-14,10,0,MS,US,10,1469
OUTLANDER 1000,2020-12-21,13,7,MS,US,20,1649
OUTLANDER 850,2020-12-21,1,3,MS,US,4,1620
OUTLANDER 450,2020-12-21,15,1,MS,US,16,1485
OUTLANDER 1000,2020-12-28,11,3,MS,US,14,1663
OUTLANDER 850,2020-12-28,8,12,MS,US,20,1640
OUTLANDER 450,2020-12-28,2,10,MS,US,12,1497
OUTLANDER 1000,2021-01-04,2,10,MS,US,12,1675
OUTLANDER 850,2021-01-04,2,10,MS,US,12,1652
OUTLANDER 450,2021-01-04,8,1,MS,US,9,1506
OUTLANDER 1000,2021-01-11,13,1,MS,US,14,1689
OUTLANDER 850,2021-01-11,14,8,MS,US,22,1674
OUTLANDER 450,2021-01-11,12,6,MS,US,18,1524
OUTLANDER 1000,2021-01-18,8,4,MS,US,12,1701
OUTLANDER 850,2021-01-18,9,5,MS,US,14,1688
OUTLANDER 450,2021-01-18,3,1,MS,US,4,1528
OUTLANDER 1000,2021-01-25,8,3,MS,US,11,1712
OUTLANDER 850,2021-01-25,15,8,MS,US,23,1711
OUTLANDER 450,2021-01-25,11,1,MS,US,12,1540
OUTLANDER 1000,2021-02-01,15,2,MS,US,17,1729
OUTLANDER 850,2021-02-01,1,14,MS,US,15,1726
OUTLANDER 450,2021-02-01,4,4,MS,US,8,1548
OUTLANDER 1000,2021-02-08,10,1,MS,US,11,1740
OUTLANDER 850,2021-02-08,8,1,MS,US,9,1735
OUTLANDER 450,2021-02-08,11,14,MS,US,25,1573
OUTLANDER 1000,2021-02-15,8,12,MS,US,20,1760
OUTLANDER 850,2021-02-15,14,14,MS,US,28,1763
OUTLANDER 450,2021-02-15,8,11,MS,US,19,1592
OUTLANDER 1000,2021-02-22,7,11,MS,US,18,1778
OUTLANDER 850,2021-02-22,1,13,MS,US,14,1777
OUTLANDER 450,2021-02-22,8,11,MS,US,19,1611
OUTLANDER 1000,2021-03-01,3,8,MS,US,11,1789
OUTLANDER 850,2021-03-01,2,1,MS,US,3,1780
OUTLANDER 450,2021-03-01,8,6,MS,US,14,1625
OUTLANDER 1000,2021-03-08,10,10,MS,US,20,1809
OUTLANDER 850,2021-03-08,4,9,MS,US,13,1793
OUTLANDER 450,2021-03-08,4,2,MS,US,6,1631
OUTLANDER 1000,2021-03-15,3,5,MS,US,8,1817
OUTLANDER 850,2021-03-15,11,11,MS,US,22,1815
OUTLANDER 450,2021-03-15,15,7,MS,US,22,1653
OUTLANDER 1000,2021-03-22,12,1,MS,US,13,1830
OUTLANDER 850,2021-03-22,6,6,MS,US,12,1827
OUTLANDER 450,2021-03-22,5,13,MS,US,18,1671
OUTLANDER 1000,2021-03-29,2,8,MS,US,10,1840
OUTLANDER 850,2021-03-29,13,6,MS,US,19,1846
OUTLANDER 450,2021-03-29,13,12,MS,US,25,1696
OUTLANDER 1000,2021-04-05,7,8,MS,US,15,1855
OUTLANDER 850,2021-04-05,8,8,MS,US,16,1862
OUTLANDER 450,2021-04-05,6,2,MS,US,8,1704
OUTLANDER 1000,2021-04-12,3,14,MS,US,17,1872
OUTLANDER 850,2021-04-12,4,12,MS,US,16,1878
OUTLANDER 450,2021-04-12,9,9,MS,US,18,1722
OUTLANDER 1000,2021-04-19,0,13,MS,US,13,1885
OUTLANDER 850,2021-04-19,5,4,MS,US,9,1887
OUTLANDER 450,2021-04-19,5,3,MS,US,8,1730
OUTLANDER 1000,2021-04-26,4,4,MS,US,8,1893
OUTLANDER 850,2021-04-26,12,5,MS,US,17,1904
OUTLANDER 450,2021-04-26,10,2,MS,US,12,1742
OUTLANDER 1000,2021-05-03,15,8,MS,US,23,1916
OUTLANDER 850,2021-05-03,13,8,MS,US,21,1925
OUTLANDER 450,2021-05-03,3,4,MS,US,7,1749
OUTLANDER 1000,2021-05-10,5,8,MS,US,13,1929
OUTLANDER 850,2021-05-10,7,5,MS,US,12,1937
OUTLANDER 450,2021-05-10,11,7,MS,US,18,1767
OUTLANDER 1000,2021-05-17,6,2,MS,US,8,1937
OUTLANDER 850,2021-05-17,7,11,MS,US,18,1955
OUTLANDER 450,2021-05-17,5,8,MS,US,13,1780
OUTLANDER 1000,2021-05-24,8,5,MS,US,13,1950
OUTLANDER 850,2021-05-24,5,1,MS,US,6,1961
OUTLANDER 450,2021-05-24,10,15,MS,US,25,1805
OUTLANDER 1000,2021-05-31,4,7,MS,US,11,1961
OUTLANDER 850,2021-05-31,2,10,MS,US,12,1973
OUTLANDER 450,2021-05-31,6,2,MS,US,8,1813
OUTLANDER 1000,2021-06-07,4,11,MS,US,15,1976
OUTLANDER 850,2021-06-07,8,15,MS,US,23,1996
OUTLANDER 450,2021-06-07,14,7,MS,US,21,1834
OUTLANDER 1000,2021-06-14,15,12,MS,US,27,2003
OUTLANDER 850,2021-06-14,7,5,MS,US,12,2008
OUTLANDER 450,2021-06-14,13,8,MS,US,21,1855
OUTLANDER 1000,2021-06-21,5,0,MS,US,5,2008
OUTLANDER 850,2021-06-21,6,14,MS,US,20,2028
OUTLANDER 450,2021-06-21,10,13,MS,US,23,1878
OUTLANDER 1000,2021-06-28,14,5,MS,US,19,2027
OUTLANDER 850,2021-06-28,10,7,MS,US,17,2045
OUTLANDER 450,2021-06-28,9,6,MS,US,15,1893
OUTLANDER 1000,2021-07-05,4,12,MS,US,16,2043
OUTLANDER 850,2021-07-05,9,9,MS,US,18,2063
OUTLANDER 450,2021-07-05,11,12,MS,US,23,1916
OUTLANDER 1000,2021-07-12,1,13,MS,US,14,2057
OUTLANDER 850,2021-07-12,4,10,MS,US,14,2077
OUTLANDER 450,2021-07-12,12,2,MS,US,14,1930
OUTLANDER 1000,2021-07-19,12,3,MS,US,15,2072
OUTLANDER 850,2021-07-19,12,15,MS,US,27,2104
OUTLANDER 450,2021-07-19,13,11,MS,US,24,1954
OUTLANDER 1000,2021-07-26,7,4,MS,US,11,2083
OUTLANDER 850,2021-07-26,8,8,MS,US,16,2120
OUTLANDER 450,2021-07-26,7,4,MS,US,11,1965
OUTLANDER 1000,2021-08-02,8,9,MS,US,17,2100
OUTLANDER 850,2021-08-02,0,9,MS,US,9,2129
OUTLANDER 450,2021-08-02,6,5,MS,US,11,1976
OUTLANDER 1000,2021-08-09,5,1,MS,US,6,2106
OUTLANDER 850,2021-08-09,10,4,MS,US,14,2143
OUTLANDER 450,2021-08-09,8,11,MS,US,19,1995
OUTLANDER 1000,2021-08-16,14,8,MS,US,22,2128
OUTLANDER 850,2021-08-16,6,12,MS,US,18,2161
OUTLANDER 450,2021-08-16,4,4,MS,US,8,2003
OUTLANDER 1000,2021-08-23,5,7,MS,US,12,2140
OUTLANDER 850,2021-08-23,9,15,MS,US,24,2185
OUTLANDER 450,2021-08-23,2,8,MS,US,10,2013
OUTLANDER 1000,2021-08-30,3,12,MS,US,15,2155
OUTLANDER 850,2021-08-30,7,7,MS,US,14,2199
OUTLANDER 450,2021-08-30,6,5,MS,US,11,2024
OUTLANDER 1000,2021-09-06,5,8,MS,US,13,2168
OUTLANDER 850,2021-09-06,1,6,MS,US,7,2206
OUTLANDER 450,2021-09-06,14,10,MS,US,24,2048
OUTLANDER 1000,2021-09-13,4,6,MS,US,10,2178
OUTLANDER 850,2021-09-13,10,0,MS,US,10,2216
OUTLANDER 450,2021-09-13,5,9,MS,US,14,2062
OUTLANDER 1000,2021-09-20,4,4,MS,US,8,2186
OUTLANDER 850,2021-09-20,11,9,MS,US,20,2236
OUTLANDER 450,2021-09-20,14,8,MS,US,22,2084
OUTLANDER 1000,2021-09-27,8,1,MS,US,9,2195
OUTLANDER 850,2021-09-27,1,6,MS,US,7,2243
OUTLANDER 450,2021-09-27,7,1,MS,US,8,2092
OUTLANDER 1000,2021-10-04,13,13,MS,US,26,2221
OUTLANDER 850,2021-10-04,11,1,MS,US,12,2255
OUTLANDER 450,2021-10-04,4,2,MS,US,6,2098
OUTLANDER 1000,2021-10-11,14,6,MS,US,20,2241
OUTLANDER 850,2021-10-11,12,7,MS,US,19,2274
OUTLANDER 450,2021-10-11,12,11,MS,US,23,2121
OUTLANDER 1000,2021-10-18,9,12,MS,US,21,2262
OUTLANDER 850,2021-10-18,14,11,MS,US,25,2299
OUTLANDER 450,2021-10-18,2,6,MS,US,8,2129
OUTLANDER 1000,2021-10-25,13,5,MS,US,18,2280
OUTLANDER 850,2021-10-25,4,14,MS,US,18,2317
OUTLANDER 450,2021-10-25,6,3,MS,US,9,2138
OUTLANDER 1000,2021-11-01,5,8,MS,US,13,2293
OUTLANDER 850,2021-11-01,9,8,MS,US,17,2334
OUTLANDER 450,2021-11-01,12,8,MS,US,20,2158
OUTLANDER 1000,2021-11-08,9,12,MS,US,21,2314
OUTLANDER 850,2021-11-08,5,6,MS,US,11,2345
OUTLANDER 450,2021-11-08,10,2,MS,US,12,2170
OUTLANDER 1000,2021-11-15,11,12,MS,US,23,2337
OUTLANDER 850,2021-11-15,4,13,MS,US,17,2362
OUTLANDER 450,2021-11-15,4,15,MS,US,19,2189
OUTLANDER 1000,2021-11-22,10,6,MS,US,16,2353
OUTLANDER 850,2021-11-22,8,15,MS,US,23,2385
OUTLANDER 450,2021-11-22,1,3,MS,US,4,2193
OUTLANDER 1000,2021-11-29,0,10,MS,US,10,2363
OUTLANDER 850,2021-11-29,6,7,MS,US,13,2398
OUTLANDER 450,2021-11-29,4,2,MS,US,6,2199
OUTLANDER 1000,2021-12-06,12,1,MS,US,13,2376
OUTLANDER 850,2021-12-06,9,11,MS,US,20,2418
OUTLANDER 450,2021-12-06,5,11,MS,US,16,2215
OUTLANDER 1000,2021-12-13,10,6,MS,US,16,2392
OUTLANDER 850,2021-12-13,9,2,MS,US,11,2429
OUTLANDER 450,2021-12-13,4,2,MS,US,6,2221
OUTLANDER 1000,2021-12-20,2,4,MS,US,6,2398
OUTLANDER 850,2021-12-20,2,4,MS,US,6,2435
OUTLANDER 450,2021-12-20,9,8,MS,US,17,2238
OUTLANDER 1000,2021-12-27,5,10,MS,US,15,2413
OUTLANDER 850,2021-12-27,10,6,MS,US,16,2451
OUTLANDER 450,2021-12-27,11,15,MS,US,26,2264
OUTLANDER 1000,2019-01-07,9,6,MO,US,15,15
OUTLANDER 850,2019-01-07,7,7,MO,US,14,14
OUTLANDER 450,2019-01-07,14,12,MO,US,26,26
OUTLANDER 1000,2019-01-14,8,14,MO,US,22,37
OUTLANDER 850,2019-01-14,13,9,MO,US,22,36
OUTLANDER 450,2019-01-14,11,10,MO,US,21,47
OUTLANDER 1000,2019-01-21,3,14,MO,US,17,54
OUTLANDER 850,2019-01-21,14,11,MO,US,25,61
OUTLANDER 450,2019-01-21,1,9,MO,US,10,57
OUTLANDER 1000,2019-01-28,2,10,MO,US,12,66
OUTLANDER 850,2019-01-28,7,4,MO,US,11,72
OUTLANDER 450,2019-01-28,1,8,MO,US,9,66
OUTLANDER 1000,2019-02-04,4,4,MO,US,8,74
OUTLANDER 850,2019-02-04,15,0,MO,US,15,87
OUTLANDER 450,2019-02-04,1,8,MO,US,9,75
OUTLANDER 1000,2019-02-11,8,9,MO,US,17,91
OUTLANDER 850,2019-02-11,5,2,MO,US,7,94
OUTLANDER 450,2019-02-11,6,6,MO,US,12,87
OUTLANDER 1000,2019-02-18,11,8,MO,US,19,110
OUTLANDER 850,2019-02-18,3,7,MO,US,10,104
OUTLANDER 450,2019-02-18,2,14,MO,US,16,103
OUTLANDER 1000,2019-02-25,13,9,MO,US,22,132
OUTLANDER 850,2019-02-25,4,2,MO,US,6,110
OUTLANDER 450,2019-02-25,6,4,MO,US,10,113
OUTLANDER 1000,2019-03-04,0,5,MO,US,5,137
OUTLANDER 850,2019-03-04,2,1,MO,US,3,113
OUTLANDER 450,2019-03-04,7,13,MO,US,20,133
OUTLANDER 1000,2019-03-11,8,2,MO,US,10,147
OUTLANDER 850,2019-03-11,5,5,MO,US,10,123
OUTLANDER 450,2019-03-11,15,8,MO,US,23,156
OUTLANDER 1000,2019-03-18,10,12,MO,US,22,169
OUTLANDER 850,2019-03-18,5,8,MO,US,13,136
OUTLANDER 450,2019-03-18,3,8,MO,US,11,167
OUTLANDER 1000,2019-03-25,3,11,MO,US,14,183
OUTLANDER 850,2019-03-25,3,11,MO,US,14,150
OUTLANDER 450,2019-03-25,5,9,MO,US,14,181
OUTLANDER 1000,2019-04-01,6,7,MO,US,13,196
OUTLANDER 850,2019-04-01,3,9,MO,US,12,162
OUTLANDER 450,2019-04-01,9,3,MO,US,12,193
OUTLANDER 1000,2019-04-08,6,9,MO,US,15,211
OUTLANDER 850,2019-04-08,13,1,MO,US,14,176
OUTLANDER 450,2019-04-08,11,3,MO,US,14,207
OUTLANDER 1000,2019-04-15,7,10,MO,US,17,228
OUTLANDER 850,2019-04-15,1,3,MO,US,4,180
OUTLANDER 450,2019-04-15,12,8,MO,US,20,227
OUTLANDER 1000,2019-04-22,4,14,MO,US,18,246
OUTLANDER 850,2019-04-22,2,13,MO,US,15,195
OUTLANDER 450,2019-04-22,6,5,MO,US,11,238
OUTLANDER 1000,2019-04-29,10,14,MO,US,24,270
OUTLANDER 850,2019-04-29,10,7,MO,US,17,212
OUTLANDER 450,2019-04-29,9,6,MO,US,15,253
OUTLANDER 1000,2019-05-06,6,4,MO,US,10,280
OUTLANDER 850,2019-05-06,14,9,MO,US,23,235
OUTLANDER 450,2019-05-06,1,8,MO,US,9,262
OUTLANDER 1000,2019-05-13,0,13,MO,US,13,293
OUTLANDER 850,2019-05-13,14,5,MO,US,19,254
OUTLANDER 450,2019-05-13,1,3,MO,US,4,266
OUTLANDER 1000,2019-05-20,7,10,MO,US,17,310
OUTLANDER 850,2019-05-20,5,9,MO,US,14,268
OUTLANDER 450,2019-05-20,11,14,MO,US,25,291
OUTLANDER 1000,2019-05-27,1,5,MO,US,6,316
OUTLANDER 850,2019-05-27,12,2,MO,US,14,282
OUTLANDER 450,2019-05-27,8,10,MO,US,18,309
OUTLANDER 1000,2019-06-03,12,2,MO,US,14,330
OUTLANDER 850,2019-06-03,8,8,MO,US,16,298
OUTLANDER 450,2019-06-03,2,6,MO,US,8,317
OUTLANDER 1000,2019-06-10,4,3,MO,US,7,337
OUTLANDER 850,2019-06-10,8,0,MO,US,8,306
OUTLANDER 450,2019-06-10,6,9,MO,US,15,332
OUTLANDER 1000,2019-06-17,14,8,MO,US,22,359
OUTLANDER 850,2019-06-17,13,12,MO,US,25,331
OUTLANDER 450,2019-06-17,5,6,MO,US,11,343
OUTLANDER 1000,2019-06-24,3,5,MO,US,8,367
OUTLANDER 850,2019-06-24,13,10,MO,US,23,354
OUTLANDER 450,2019-06-24,13,10,MO,US,23,366
OUTLANDER 1000,2019-07-01,11,1,MO,US,12,379
OUTLANDER 850,2019-07-01,2,12,MO,US,14,368
OUTLANDER 450,2019-07-01,2,12,MO,US,14,380
OUTLANDER 1000,2019-07-08,5,5,MO,US,10,389
OUTLANDER 850,2019-07-08,14,1,MO,US,15,383
OUTLANDER 450,2019-07-08,9,11,MO,US,20,400
OUTLANDER 1000,2019-07-15,12,5,MO,US,17,406
OUTLANDER 850,2019-07-15,15,11,MO,US,26,409
OUTLANDER 450,2019-07-15,15,1,MO,US,16,416
OUTLANDER 1000,2019-07-22,8,11,MO,US,19,425
OUTLANDER 850,2019-07-22,9,5,MO,US,14,423
OUTLANDER 450,2019-07-22,0,10,MO,US,10,426
OUTLANDER 1000,2019-07-29,14,11,MO,US,25,450
OUTLANDER 850,2019-07-29,14,3,MO,US,17,440
OUTLANDER 450,2019-07-29,11,5,MO,US,16,442
OUTLANDER 1000,2019-08-05,5,7,MO,US,12,462
OUTLANDER 850,2019-08-05,7,10,MO,US,17,457
OUTLANDER 450,2019-08-05,11,12,MO,US,23,465
OUTLANDER 1000,2019-08-12,10,6,MO,US,16,478
OUTLANDER 850,2019-08-12,12,1,MO,US,13,470
OUTLANDER 450,2019-08-12,8,13,MO,US,21,486
OUTLANDER 1000,2019-08-19,2,13,MO,US,15,493
OUTLANDER 850,2019-08-19,10,3,MO,US,13,483
OUTLANDER 450,2019-08-19,11,8,MO,US,19,505
OUTLANDER 1000,2019-08-26,15,7,MO,US,22,515
OUTLANDER 850,2019-08-26,14,4,MO,US,18,501
OUTLANDER 450,2019-08-26,2,5,MO,US,7,512
OUTLANDER 1000,2019-09-02,6,10,MO,US,16,531
OUTLANDER 850,2019-09-02,13,11,MO,US,24,525
OUTLANDER 450,2019-09-02,13,8,MO,US,21,533
OUTLANDER 1000,2019-09-09,11,3,MO,US,14,545
OUTLANDER 850,2019-09-09,11,11,MO,US,22,547
OUTLANDER 450,2019-09-09,14,8,MO,US,22,555
OUTLANDER 1000,2019-09-16,12,6,MO,US,18,563
OUTLANDER 850,2019-09-16,12,8,MO,US,20,567
OUTLANDER 450,2019-09-16,6,6,MO,US,12,567
OUTLANDER 1000,2019-09-23,2,12,MO,US,14,577
OUTLANDER 850,2019-09-23,12,9,MO,US,21,588
OUTLANDER 450,2019-09-23,10,15,MO,US,25,592
OUTLANDER 1000,2019-09-30,12,10,MO,US,22,599
OUTLANDER 850,2019-09-30,3,5,MO,US,8,596
OUTLANDER 450,2019-09-30,2,9,MO,US,11,603
OUTLANDER 1000,2019-10-07,5,7,MO,US,12,611
OUTLANDER 850,2019-10-07,11,12,MO,US,23,619
OUTLANDER 450,2019-10-07,8,6,MO,US,14,617
OUTLANDER 1000,2019-10-14,7,2,MO,US,9,620
OUTLANDER 850,2019-10-14,10,4,MO,US,14,633
OUTLANDER 450,2019-10-14,3,9,MO,US,12,629
OUTLANDER 1000,2019-10-21,13,13,MO,US,26,646
OUTLANDER 850,2019-10-21,9,14,MO,US,23,656
OUTLANDER 450,2019-10-21,6,2,MO,US,8,637
OUTLANDER 1000,2019-10-28,8,7,MO,US,15,661
OUTLANDER 850,2019-10-28,12,13,MO,US,25,681
OUTLANDER 450,2019-10-28,1,7,MO,US,8,645
OUTLANDER 1000,2019-11-04,1,11,MO,US,12,673
OUTLANDER 850,2019-11-04,6,4,MO,US,10,691
OUTLANDER 450,2019-11-04,0,8,MO,US,8,653
OUTLANDER 1000,2019-11-11,15,11,MO,US,26,699
OUTLANDER 850,2019-11-11,4,11,MO,US,15,706
OUTLANDER 450,2019-11-11,15,10,MO,US,25,678
OUTLANDER 1000,2019-11-18,13,2,MO,US,15,714
OUTLANDER 850,2019-11-18,10,13,MO,US,23,729
OUTLANDER 450,2019-11-18,12,14,MO,US,26,704
OUTLANDER 1000,2019-11-25,10,10,MO,US,20,734
OUTLANDER 850,2019-11-25,11,7,MO,US,18,747
OUTLANDER 450,2019-11-25,1,7,MO,US,8,712
OUTLANDER 1000,2019-12-02,5,5,MO,US,10,744
OUTLANDER 850,2019-12-02,3,7,MO,US,10,757
OUTLANDER 450,2019-12-02,7,3,MO,US,10,722
OUTLANDER 1000,2019-12-09,15,3,MO,US,18,762
OUTLANDER 850,2019-12-09,3,8,MO,US,11,768
OUTLANDER 450,2019-12-09,6,6,MO,US,12,734
OUTLANDER 1000,2019-12-16,4,4,MO,US,8,770
OUTLANDER 850,2019-12-16,9,4,MO,US,13,781
OUTLANDER 450,2019-12-16,4,13,MO,US,17,751
OUTLANDER 1000,2019-12-23,6,7,MO,US,13,783
OUTLANDER 850,2019-12-23,9,9,MO,US,18,799
OUTLANDER 450,2019-12-23,14,13,MO,US,27,778
OUTLANDER 1000,2019-12-30,6,1,MO,US,7,790
OUTLANDER 850,2019-12-30,9,4,MO,US,13,812
OUTLANDER 450,2019-12-30,15,10,MO,US,25,803
OUTLANDER 1000,2020-01-06,2,7,MO,US,9,799
OUTLANDER 850,2020-01-06,12,9,MO,US,21,833
OUTLANDER 450,2020-01-06,14,6,MO,US,20,823
OUTLANDER 1000,2020-01-13,4,6,MO,US,10,809
OUTLANDER 850,2020-01-13,13,7,MO,US,20,853
OUTLANDER 450,2020-01-13,13,4,MO,US,17,840
OUTLANDER 1000,2020-01-20,0,4,MO,US,4,813
OUTLANDER 850,2020-01-20,5,5,MO,US,10,863
OUTLANDER 450,2020-01-20,9,8,MO,US,17,857
OUTLANDER 1000,2020-01-27,13,7,MO,US,20,833
OUTLANDER 850,2020-01-27,2,15,MO,US,17,880
OUTLANDER 450,2020-01-27,3,13,MO,US,16,873
OUTLANDER 1000,2020-02-03,11,11,MO,US,22,855
OUTLANDER 850,2020-02-03,1,5,MO,US,6,886
OUTLANDER 450,2020-02-03,14,1,MO,US,15,888
OUTLANDER 1000,2020-02-10,5,12,MO,US,17,872
OUTLANDER 850,2020-02-10,1,9,MO,US,10,896
OUTLANDER 450,2020-02-10,6,13,MO,US,19,907
OUTLANDER 1000,2020-02-17,6,4,MO,US,10,882
OUTLANDER 850,2020-02-17,11,14,MO,US,25,921
OUTLANDER 450,2020-02-17,15,12,MO,US,27,934
OUTLANDER 1000,2020-02-24,1,13,MO,US,14,896
OUTLANDER 850,2020-02-24,10,12,MO,US,22,943
OUTLANDER 450,2020-02-24,2,12,MO,US,14,948
OUTLANDER 1000,2020-03-02,11,8,MO,US,19,915
OUTLANDER 850,2020-03-02,12,10,MO,US,22,965
OUTLANDER 450,2020-03-02,2,3,MO,US,5,953
OUTLANDER 1000,2020-03-09,8,15,MO,US,23,938
OUTLANDER 850,2020-03-09,2,14,MO,US,16,981
OUTLANDER 450,2020-03-09,2,3,MO,US,5,958
OUTLANDER 1000,2020-03-16,13,9,MO,US,22,960
OUTLANDER 850,2020-03-16,7,6,MO,US,13,994
OUTLANDER 450,2020-03-16,1,6,MO,US,7,965
OUTLANDER 1000,2020-03-23,4,14,MO,US,18,978
OUTLANDER 850,2020-03-23,6,1,MO,US,7,1001
OUTLANDER 450,2020-03-23,2,3,MO,US,5,970
OUTLANDER 1000,2020-03-30,12,12,MO,US,24,1002
OUTLANDER 850,2020-03-30,0,12,MO,US,12,1013
OUTLANDER 450,2020-03-30,11,5,MO,US,16,986
OUTLANDER 1000,2020-04-06,14,3,MO,US,17,1019
OUTLANDER 850,2020-04-06,0,13,MO,US,13,1026
OUTLANDER 450,2020-04-06,12,14,MO,US,26,1012
OUTLANDER 1000,2020-04-13,9,8,MO,US,17,1036
OUTLANDER 850,2020-04-13,14,5,MO,US,19,1045
OUTLANDER 450,2020-04-13,5,1,MO,US,6,1018
OUTLANDER 1000,2020-04-20,10,4,MO,US,14,1050
OUTLANDER 850,2020-04-20,0,13,MO,US,13,1058
OUTLANDER 450,2020-04-20,13,5,MO,US,18,1036
OUTLANDER 1000,2020-04-27,10,14,MO,US,24,1074
OUTLANDER 850,2020-04-27,1,3,MO,US,4,1062
OUTLANDER 450,2020-04-27,12,8,MO,US,20,1056
OUTLANDER 1000,2020-05-04,11,1,MO,US,12,1086
OUTLANDER 850,2020-05-04,7,7,MO,US,14,1076
OUTLANDER 450,2020-05-04,6,10,MO,US,16,1072
OUTLANDER 1000,2020-05-11,12,15,MO,US,27,1113
OUTLANDER 850,2020-05-11,1,13,MO,US,14,1090
OUTLANDER 450,2020-05-11,9,1,MO,US,10,1082
OUTLANDER 1000,2020-05-18,6,9,MO,US,15,1128
OUTLANDER 850,2020-05-18,3,14,MO,US,17,1107
OUTLANDER 450,2020-05-18,10,8,MO,US,18,1100
OUTLANDER 1000,2020-05-25,10,9,MO,US,19,1147
OUTLANDER 850,2020-05-25,14,3,MO,US,17,1124
OUTLANDER 450,2020-05-25,12,3,MO,US,15,1115
OUTLANDER 1000,2020-06-01,8,4,MO,US,12,1159
OUTLANDER 850,2020-06-01,2,13,MO,US,15,1139
OUTLANDER 450,2020-06-01,2,3,MO,US,5,1120
OUTLANDER 1000,2020-06-08,2,8,MO,US,10,1169
OUTLANDER 850,2020-06-08,8,0,MO,US,8,1147
OUTLANDER 450,2020-06-08,1,4,MO,US,5,1125
OUTLANDER 1000,2020-06-15,14,2,MO,US,16,1185
OUTLANDER 850,2020-06-15,3,5,MO,US,8,1155
OUTLANDER 450,2020-06-15,15,3,MO,US,18,1143
OUTLANDER 1000,2020-06-22,1,4,MO,US,5,1190
OUTLANDER 850,2020-06-22,7,5,MO,US,12,1167
OUTLANDER 450,2020-06-22,7,7,MO,US,14,1157
OUTLANDER 1000,2020-06-29,11,6,MO,US,17,1207
OUTLANDER 850,2020-06-29,14,14,MO,US,28,1195
OUTLANDER 450,2020-06-29,11,7,MO,US,18,1175
OUTLANDER 1000,2020-07-06,5,13,MO,US,18,1225
OUTLANDER 850,2020-07-06,2,13,MO,US,15,1210
OUTLANDER 450,2020-07-06,3,0,MO,US,3,1178
OUTLANDER 1000,2020-07-13,5,3,MO,US,8,1233
OUTLANDER 850,2020-07-13,7,0,MO,US,7,1217
OUTLANDER 450,2020-07-13,1,13,MO,US,14,1192
OUTLANDER 1000,2020-07-20,8,3,MO,US,11,1244
OUTLANDER 850,2020-07-20,5,9,MO,US,14,1231
OUTLANDER 450,2020-07-20,4,12,MO,US,16,1208
OUTLANDER 1000,2020-07-27,4,7,MO,US,11,1255
OUTLANDER 850,2020-07-27,14,2,MO,US,16,1247
OUTLANDER 450,2020-07-27,14,14,MO,US,28,1236
OUTLANDER 1000,2020-08-03,3,8,MO,US,11,1266
OUTLANDER 850,2020-08-03,11,4,MO,US,15,1262
OUTLANDER 450,2020-08-03,11,4,MO,US,15,1251
OUTLANDER 1000,2020-08-10,5,1,MO,US,6,1272
OUTLANDER 850,2020-08-10,1,15,MO,US,16,1278
OUTLANDER 450,2020-08-10,5,15,MO,US,20,1271
OUTLANDER 1000,2020-08-17,14,13,MO,US,27,1299
OUTLANDER 850,2020-08-17,3,15,MO,US,18,1296
OUTLANDER 450,2020-08-17,3,8,MO,US,11,1282
OUTLANDER 1000,2020-08-24,6,4,MO,US,10,1309
OUTLANDER 850,2020-08-24,6,13,MO,US,19,1315
OUTLANDER 450,2020-08-24,3,10,MO,US,13,1295
OUTLANDER 1000,2020-08-31,8,4,MO,US,12,1321
OUTLANDER 850,2020-08-31,15,8,MO,US,23,1338
OUTLANDER 450,2020-08-31,14,7,MO,US,21,1316
OUTLANDER 1000,2020-09-07,5,13,MO,US,18,1339
OUTLANDER 850,2020-09-07,14,15,MO,US,29,1367
OUTLANDER 450,2020-09-07,12,1,MO,US,13,1329
OUTLANDER 1000,2020-09-14,4,15,MO,US,19,1358
OUTLANDER 850,2020-09-14,7,6,MO,US,13,1380
OUTLANDER 450,2020-09-14,1,14,MO,US,15,1344
OUTLANDER 1000,2020-09-21,11,10,MO,US,21,1379
OUTLANDER 850,2020-09-21,11,1,MO,US,12,1392
OUTLANDER 450,2020-09-21,4,10,MO,US,14,1358
OUTLANDER 1000,2020-09-28,3,2,MO,US,5,1384
OUTLANDER 850,2020-09-28,12,0,MO,US,12,1404
OUTLANDER 450,2020-09-28,3,8,MO,US,11,1369
OUTLANDER 1000,2020-10-05,10,8,MO,US,18,1402
OUTLANDER 850,2020-10-05,14,12,MO,US,26,1430
OUTLANDER 450,2020-10-05,0,2,MO,US,2,1371
OUTLANDER 1000,2020-10-12,1,11,MO,US,12,1414
OUTLANDER 850,2020-10-12,13,10,MO,US,23,1453
OUTLANDER 450,2020-10-12,9,1,MO,US,10,1381
OUTLANDER 1000,2020-10-19,1,13,MO,US,14,1428
OUTLANDER 850,2020-10-19,3,14,MO,US,17,1470
OUTLANDER 450,2020-10-19,3,6,MO,US,9,1390
OUTLANDER 1000,2020-10-26,15,5,MO,US,20,1448
OUTLANDER 850,2020-10-26,10,14,MO,US,24,1494
OUTLANDER 450,2020-10-26,14,5,MO,US,19,1409
OUTLANDER 1000,2020-11-02,1,4,MO,US,5,1453
OUTLANDER 850,2020-11-02,11,2,MO,US,13,1507
OUTLANDER 450,2020-11-02,4,13,MO,US,17,1426
OUTLANDER 1000,2020-11-09,2,8,MO,US,10,1463
OUTLANDER 850,2020-11-09,15,3,MO,US,18,1525
OUTLANDER 450,2020-11-09,11,11,MO,US,22,1448
OUTLANDER 1000,2020-11-16,9,13,MO,US,22,1485
OUTLANDER 850,2020-11-16,8,15,MO,US,23,1548
OUTLANDER 450,2020-11-16,5,14,MO,US,19,1467
OUTLANDER 1000,2020-11-23,15,8,MO,US,23,1508
OUTLANDER 850,2020-11-23,7,5,MO,US,12,1560
OUTLANDER 450,2020-11-23,9,0,MO,US,9,1476
OUTLANDER 1000,2020-11-30,9,8,MO,US,17,1525
OUTLANDER 850,2020-11-30,5,3,MO,US,8,1568
OUTLANDER 450,2020-11-30,3,7,MO,US,10,1486
OUTLANDER 1000,2020-12-07,4,12,MO,US,16,1541
OUTLANDER 850,2020-12-07,4,2,MO,US,6,1574
OUTLANDER 450,2020-12-07,3,0,MO,US,3,1489
OUTLANDER 1000,2020-12-14,11,5,MO,US,16,1557
OUTLANDER 850,2020-12-14,4,14,MO,US,18,1592
OUTLANDER 450,2020-12-14,1,14,MO,US,15,1504
OUTLANDER 1000,2020-12-21,3,11,MO,US,14,1571
OUTLANDER 850,2020-12-21,8,2,MO,US,10,1602
OUTLANDER 450,2020-12-21,1,13,MO,US,14,1518
OUTLANDER 1000,2020-12-28,10,8,MO,US,18,1589
OUTLANDER 850,2020-12-28,6,5,MO,US,11,1613
OUTLANDER 450,2020-12-28,12,11,MO,US,23,1541
OUTLANDER 1000,2021-01-04,3,8,MO,US,11,1600
OUTLANDER 850,2021-01-04,11,0,MO,US,11,1624
OUTLANDER 450,2021-01-04,1,6,MO,US,7,1548
OUTLANDER 1000,2021-01-11,4,11,MO,US,15,1615
OUTLANDER 850,2021-01-11,14,8,MO,US,22,1646
OUTLANDER 450,2021-01-11,12,7,MO,US,19,1567
OUTLANDER 1000,2021-01-18,1,2,MO,US,3,1618
OUTLANDER 850,2021-01-18,9,9,MO,US,18,1664
OUTLANDER 450,2021-01-18,1,5,MO,US,6,1573
OUTLANDER 1000,2021-01-25,14,8,MO,US,22,1640
OUTLANDER 850,2021-01-25,6,13,MO,US,19,1683
OUTLANDER 450,2021-01-25,13,4,MO,US,17,1590
OUTLANDER 1000,2021-02-01,1,11,MO,US,12,1652
OUTLANDER 850,2021-02-01,10,10,MO,US,20,1703
OUTLANDER 450,2021-02-01,11,8,MO,US,19,1609
OUTLANDER 1000,2021-02-08,7,12,MO,US,19,1671
OUTLANDER 850,2021-02-08,13,3,MO,US,16,1719
OUTLANDER 450,2021-02-08,6,10,MO,US,16,1625
OUTLANDER 1000,2021-02-15,15,1,MO,US,16,1687
OUTLANDER 850,2021-02-15,8,12,MO,US,20,1739
OUTLANDER 450,2021-02-15,1,3,MO,US,4,1629
OUTLANDER 1000,2021-02-22,5,14,MO,US,19,1706
OUTLANDER 850,2021-02-22,5,10,MO,US,15,1754
OUTLANDER 450,2021-02-22,1,14,MO,US,15,1644
OUTLANDER 1000,2021-03-01,2,3,MO,US,5,1711
OUTLANDER 850,2021-03-01,9,13,MO,US,22,1776
OUTLANDER 450,2021-03-01,11,9,MO,US,20,1664
OUTLANDER 1000,2021-03-08,5,12,MO,US,17,1728
OUTLANDER 850,2021-03-08,15,4,MO,US,19,1795
OUTLANDER 450,2021-03-08,12,13,MO,US,25,1689
OUTLANDER 1000,2021-03-15,8,7,MO,US,15,1743
OUTLANDER 850,2021-03-15,12,3,MO,US,15,1810
OUTLANDER 450,2021-03-15,12,9,MO,US,21,1710
OUTLANDER 1000,2021-03-22,10,13,MO,US,23,1766
OUTLANDER 850,2021-03-22,12,4,MO,US,16,1826
OUTLANDER 450,2021-03-22,5,11,MO,US,16,1726
OUTLANDER 1000,2021-03-29,11,13,MO,US,24,1790
OUTLANDER 850,2021-03-29,8,11,MO,US,19,1845
OUTLANDER 450,2021-03-29,5,3,MO,US,8,1734
OUTLANDER 1000,2021-04-05,15,6,MO,US,21,1811
OUTLANDER 850,2021-04-05,1,12,MO,US,13,1858
OUTLANDER 450,2021-04-05,6,4,MO,US,10,1744
OUTLANDER 1000,2021-04-12,15,4,MO,US,19,1830
OUTLANDER 850,2021-04-12,12,1,MO,US,13,1871
OUTLANDER 450,2021-04-12,4,11,MO,US,15,1759
OUTLANDER 1000,2021-04-19,3,14,MO,US,17,1847
OUTLANDER 850,2021-04-19,10,9,MO,US,19,1890
OUTLANDER 450,2021-04-19,15,9,MO,US,24,1783
OUTLANDER 1000,2021-04-26,8,10,MO,US,18,1865
OUTLANDER 850,2021-04-26,4,11,MO,US,15,1905
OUTLANDER 450,2021-04-26,7,12,MO,US,19,1802
OUTLANDER 1000,2021-05-03,4,11,MO,US,15,1880
OUTLANDER 850,2021-05-03,12,8,MO,US,20,1925
OUTLANDER 450,2021-05-03,2,14,MO,US,16,1818
OUTLANDER 1000,2021-05-10,10,5,MO,US,15,1895
OUTLANDER 850,2021-05-10,12,14,MO,US,26,1951
OUTLANDER 450,2021-05-10,3,4,MO,US,7,1825
OUTLANDER 1000,2021-05-17,1,10,MO,US,11,1906
OUTLANDER 850,2021-05-17,13,14,MO,US,27,1978
OUTLANDER 450,2021-05-17,11,15,MO,US,26,1851
OUTLANDER 1000,2021-05-24,10,1,MO,US,11,1917
OUTLANDER 850,2021-05-24,7,13,MO,US,20,1998
OUTLANDER 450,2021-05-24,2,2,MO,US,4,1855
OUTLANDER 1000,2021-05-31,11,7,MO,US,18,1935
OUTLANDER 850,2021-05-31,5,10,MO,US,15,2013
OUTLANDER 450,2021-05-31,9,1,MO,US,10,1865
OUTLANDER 1000,2021-06-07,5,10,MO,US,15,1950
OUTLANDER 850,2021-06-07,3,1,MO,US,4,2017
OUTLANDER 450,2021-06-07,13,10,MO,US,23,1888
OUTLANDER 1000,2021-06-14,8,10,MO,US,18,1968
OUTLANDER 850,2021-06-14,14,5,MO,US,19,2036
OUTLANDER 450,2021-06-14,2,13,MO,US,15,1903
OUTLANDER 1000,2021-06-21,3,8,MO,US,11,1979
OUTLANDER 850,2021-06-21,13,13,MO,US,26,2062
OUTLANDER 450,2021-06-21,3,3,MO,US,6,1909
OUTLANDER 1000,2021-06-28,11,1,MO,US,12,1991
OUTLANDER 850,2021-06-28,8,0,MO,US,8,2070
OUTLANDER 450,2021-06-28,14,6,MO,US,20,1929
OUTLANDER 1000,2021-07-05,5,12,MO,US,17,2008
OUTLANDER 850,2021-07-05,7,9,MO,US,16,2086
OUTLANDER 450,2021-07-05,9,6,MO,US,15,1944
OUTLANDER 1000,2021-07-12,14,3,MO,US,17,2025
OUTLANDER 850,2021-07-12,1,2,MO,US,3,2089
OUTLANDER 450,2021-07-12,5,8,MO,US,13,1957
OUTLANDER 1000,2021-07-19,10,15,MO,US,25,2050
OUTLANDER 850,2021-07-19,11,13,MO,US,24,2113
OUTLANDER 450,2021-07-19,14,13,MO,US,27,1984
OUTLANDER 1000,2021-07-26,13,2,MO,US,15,2065
OUTLANDER 850,2021-07-26,2,7,MO,US,9,2122
OUTLANDER 450,2021-07-26,13,11,MO,US,24,2008
OUTLANDER 1000,2021-08-02,15,15,MO,US,30,2095
OUTLANDER 850,2021-08-02,4,1,MO,US,5,2127
OUTLANDER 450,2021-08-02,7,6,MO,US,13,2021
OUTLANDER 1000,2021-08-09,7,1,MO,US,8,2103
OUTLANDER 850,2021-08-09,12,14,MO,US,26,2153
OUTLANDER 450,2021-08-09,2,13,MO,US,15,2036
OUTLANDER 1000,2021-08-16,14,5,MO,US,19,2122
OUTLANDER 850,2021-08-16,11,13,MO,US,24,2177
OUTLANDER 450,2021-08-16,10,4,MO,US,14,2050
OUTLANDER 1000,2021-08-23,8,6,MO,US,14,2136
OUTLANDER 850,2021-08-23,1,11,MO,US,12,2189
OUTLANDER 450,2021-08-23,4,10,MO,US,14,2064
OUTLANDER 1000,2021-08-30,8,12,MO,US,20,2156
OUTLANDER 850,2021-08-30,11,8,MO,US,19,2208
OUTLANDER 450,2021-08-30,11,4,MO,US,15,2079
OUTLANDER 1000,2021-09-06,5,12,MO,US,17,2173
OUTLANDER 850,2021-09-06,8,8,MO,US,16,2224
OUTLANDER 450,2021-09-06,14,6,MO,US,20,2099
OUTLANDER 1000,2021-09-13,1,2,MO,US,3,2176
OUTLANDER 850,2021-09-13,15,3,MO,US,18,2242
OUTLANDER 450,2021-09-13,14,10,MO,US,24,2123
OUTLANDER 1000,2021-09-20,5,4,MO,US,9,2185
OUTLANDER 850,2021-09-20,7,12,MO,US,19,2261
OUTLANDER 450,2021-09-20,6,4,MO,US,10,2133
OUTLANDER 1000,2021-09-27,10,9,MO,US,19,2204
OUTLANDER 850,2021-09-27,3,6,MO,US,9,2270
OUTLANDER 450,2021-09-27,11,14,MO,US,25,2158
OUTLANDER 1000,2021-10-04,15,2,MO,US,17,2221
OUTLANDER 850,2021-10-04,6,14,MO,US,20,2290
OUTLANDER 450,2021-10-04,2,10,MO,US,12,2170
OUTLANDER 1000,2021-10-11,12,2,MO,US,14,2235
OUTLANDER 850,2021-10-11,3,4,MO,US,7,2297
OUTLANDER 450,2021-10-11,5,10,MO,US,15,2185
OUTLANDER 1000,2021-10-18,8,8,MO,US,16,2251
OUTLANDER 850,2021-10-18,1,5,MO,US,6,2303
OUTLANDER 450,2021-10-18,14,2,MO,US,16,2201
OUTLANDER 1000,2021-10-25,13,6,MO,US,19,2270
OUTLANDER 850,2021-10-25,2,15,MO,US,17,2320
OUTLANDER 450,2021-10-25,11,6,MO,US,17,2218
OUTLANDER 1000,2021-11-01,11,8,MO,US,19,2289
OUTLANDER 850,2021-11-01,5,6,MO,US,11,2331
OUTLANDER 450,2021-11-01,2,4,MO,US,6,2224
OUTLANDER 1000,2021-11-08,3,12,MO,US,15,2304
OUTLANDER 850,2021-11-08,2,4,MO,US,6,2337
OUTLANDER 450,2021-11-08,6,3,MO,US,9,2233
OUTLANDER 1000,2021-11-15,9,12,MO,US,21,2325
OUTLANDER 850,2021-11-15,13,2,MO,US,15,2352
OUTLANDER 450,2021-11-15,13,8,MO,US,21,2254
OUTLANDER 1000,2021-11-22,7,15,MO,US,22,2347
OUTLANDER 850,2021-11-22,14,12,MO,US,26,2378
OUTLANDER 450,2021-11-22,6,14,MO,US,20,2274
OUTLANDER 1000,2021-11-29,3,12,MO,US,15,2362
OUTLANDER 850,2021-11-29,14,11,MO,US,25,2403
OUTLANDER 450,2021-11-29,0,6,MO,US,6,2280
OUTLANDER 1000,2021-12-06,2,4,MO,US,6,2368
OUTLANDER 850,2021-12-06,7,5,MO,US,12,2415
OUTLANDER 450,2021-12-06,8,12,MO,US,20,2300
OUTLANDER 1000,2021-12-13,14,13,MO,US,27,2395
OUTLANDER 850,2021-12-13,7,10,MO,US,17,2432
OUTLANDER 450,2021-12-13,13,2,MO,US,15,2315
OUTLANDER 1000,2021-12-20,7,11,MO,US,18,2413
OUTLANDER 850,2021-12-20,8,12,MO,US,20,2452
OUTLANDER 450,2021-12-20,8,0,MO,US,8,2323
OUTLANDER 1000,2021-12-27,6,2,MO,US,8,2421
OUTLANDER 850,2021-12-27,12,6,MO,US,18,2470
OUTLANDER 450,2021-12-27,11,9,MO,US,20,2343
OUTLANDER 1000,2019-01-07,5,10,MT,US,15,15
OUTLANDER 850,2019-01-07,2,7,MT,US,9,9
OUTLANDER 450,2019-01-07,13,11,MT,US,24,24
OUTLANDER 1000,2019-01-14,13,3,MT,US,16,31
OUTLANDER 850,2019-01-14,5,6,MT,US,11,20
OUTLANDER 450,2019-01-14,10,10,MT,US,20,44
OUTLANDER 1000,2019-01-21,10,7,MT,US,17,48
OUTLANDER 850,2019-01-21,11,3,MT,US,14,34
OUTLANDER 450,2019-01-21,3,6,MT,US,9,53
OUTLANDER 1000,2019-01-28,2,5,MT,US,7,55
OUTLANDER 850,2019-01-28,9,11,MT,US,20,54
OUTLANDER 450,2019-01-28,1,4,MT,US,5,58
OUTLANDER 1000,2019-02-04,13,6,MT,US,19,74
OUTLANDER 850,2019-02-04,3,9,MT,US,12,66
OUTLANDER 450,2019-02-04,10,5,MT,US,15,73
OUTLANDER 1000,2019-02-11,8,14,MT,US,22,96
OUTLANDER 850,2019-02-11,15,14,MT,US,29,95
OUTLANDER 450,2019-02-11,10,4,MT,US,14,87
OUTLANDER 1000,2019-02-18,3,6,MT,US,9,105
OUTLANDER 850,2019-02-18,4,4,MT,US,8,103
OUTLANDER 450,2019-02-18,9,2,MT,US,11,98
OUTLANDER 1000,2019-02-25,10,2,MT,US,12,117
OUTLANDER 850,2019-02-25,13,12,MT,US,25,128
OUTLANDER 450,2019-02-25,10,12,MT,US,22,120
OUTLANDER 1000,2019-03-04,12,1,MT,US,13,130
OUTLANDER 850,2019-03-04,2,2,MT,US,4,132
OUTLANDER 450,2019-03-04,6,12,MT,US,18,138
OUTLANDER 1000,2019-03-11,13,1,MT,US,14,144
OUTLANDER 850,2019-03-11,3,2,MT,US,5,137
OUTLANDER 450,2019-03-11,8,3,MT,US,11,149
OUTLANDER 1000,2019-03-18,3,7,MT,US,10,154
OUTLANDER 850,2019-03-18,8,7,MT,US,15,152
OUTLANDER 450,2019-03-18,1,6,MT,US,7,156
OUTLANDER 1000,2019-03-25,10,12,MT,US,22,176
OUTLANDER 850,2019-03-25,6,6,MT,US,12,164
OUTLANDER 450,2019-03-25,3,4,MT,US,7,163
OUTLANDER 1000,2019-04-01,13,2,MT,US,15,191
OUTLANDER 850,2019-04-01,12,8,MT,US,20,184
OUTLANDER 450,2019-04-01,0,13,MT,US,13,176
OUTLANDER 1000,2019-04-08,11,15,MT,US,26,217
OUTLANDER 850,2019-04-08,7,6,MT,US,13,197
OUTLANDER 450,2019-04-08,7,0,MT,US,7,183
OUTLANDER 1000,2019-04-15,12,12,MT,US,24,241
OUTLANDER 850,2019-04-15,7,2,MT,US,9,206
OUTLANDER 450,2019-04-15,14,4,MT,US,18,201
OUTLANDER 1000,2019-04-22,7,3,MT,US,10,251
OUTLANDER 850,2019-04-22,7,8,MT,US,15,221
OUTLANDER 450,2019-04-22,1,9,MT,US,10,211
OUTLANDER 1000,2019-04-29,8,0,MT,US,8,259
OUTLANDER 850,2019-04-29,12,12,MT,US,24,245
OUTLANDER 450,2019-04-29,9,9,MT,US,18,229
OUTLANDER 1000,2019-05-06,10,2,MT,US,12,271
OUTLANDER 850,2019-05-06,12,10,MT,US,22,267
OUTLANDER 450,2019-05-06,4,6,MT,US,10,239
OUTLANDER 1000,2019-05-13,9,1,MT,US,10,281
OUTLANDER 850,2019-05-13,10,2,MT,US,12,279
OUTLANDER 450,2019-05-13,15,6,MT,US,21,260
OUTLANDER 1000,2019-05-20,10,4,MT,US,14,295
OUTLANDER 850,2019-05-20,7,4,MT,US,11,290
OUTLANDER 450,2019-05-20,14,5,MT,US,19,279
OUTLANDER 1000,2019-05-27,14,9,MT,US,23,318
OUTLANDER 850,2019-05-27,14,5,MT,US,19,309
OUTLANDER 450,2019-05-27,7,9,MT,US,16,295
OUTLANDER 1000,2019-06-03,7,8,MT,US,15,333
OUTLANDER 850,2019-06-03,10,12,MT,US,22,331
OUTLANDER 450,2019-06-03,6,12,MT,US,18,313
OUTLANDER 1000,2019-06-10,9,5,MT,US,14,347
OUTLANDER 850,2019-06-10,12,5,MT,US,17,348
OUTLANDER 450,2019-06-10,3,9,MT,US,12,325
OUTLANDER 1000,2019-06-17,6,6,MT,US,12,359
OUTLANDER 850,2019-06-17,8,10,MT,US,18,366
OUTLANDER 450,2019-06-17,9,3,MT,US,12,337
OUTLANDER 1000,2019-06-24,1,11,MT,US,12,371
OUTLANDER 850,2019-06-24,4,10,MT,US,14,380
OUTLANDER 450,2019-06-24,13,0,MT,US,13,350
OUTLANDER 1000,2019-07-01,7,12,MT,US,19,390
OUTLANDER 850,2019-07-01,5,14,MT,US,19,399
OUTLANDER 450,2019-07-01,12,10,MT,US,22,372
OUTLANDER 1000,2019-07-08,14,13,MT,US,27,417
OUTLANDER 850,2019-07-08,6,1,MT,US,7,406
OUTLANDER 450,2019-07-08,9,3,MT,US,12,384
OUTLANDER 1000,2019-07-15,9,2,MT,US,11,428
OUTLANDER 850,2019-07-15,15,1,MT,US,16,422
OUTLANDER 450,2019-07-15,10,9,MT,US,19,403
OUTLANDER 1000,2019-07-22,0,0,MT,US,0,428
OUTLANDER 850,2019-07-22,15,5,MT,US,20,442
OUTLANDER 450,2019-07-22,10,14,MT,US,24,427
OUTLANDER 1000,2019-07-29,10,6,MT,US,16,444
OUTLANDER 850,2019-07-29,5,8,MT,US,13,455
OUTLANDER 450,2019-07-29,15,2,MT,US,17,444
OUTLANDER 1000,2019-08-05,9,6,MT,US,15,459
OUTLANDER 850,2019-08-05,10,0,MT,US,10,465
OUTLANDER 450,2019-08-05,13,13,MT,US,26,470
OUTLANDER 1000,2019-08-12,8,11,MT,US,19,478
OUTLANDER 850,2019-08-12,7,2,MT,US,9,474
OUTLANDER 450,2019-08-12,2,9,MT,US,11,481
OUTLANDER 1000,2019-08-19,5,2,MT,US,7,485
OUTLANDER 850,2019-08-19,9,6,MT,US,15,489
OUTLANDER 450,2019-08-19,4,15,MT,US,19,500
OUTLANDER 1000,2019-08-26,5,12,MT,US,17,502
OUTLANDER 850,2019-08-26,5,13,MT,US,18,507
OUTLANDER 450,2019-08-26,9,10,MT,US,19,519
OUTLANDER 1000,2019-09-02,5,13,MT,US,18,520
OUTLANDER 850,2019-09-02,14,12,MT,US,26,533
OUTLANDER 450,2019-09-02,8,7,MT,US,15,534
OUTLANDER 1000,2019-09-09,3,11,MT,US,14,534
OUTLANDER 850,2019-09-09,12,8,MT,US,20,553
OUTLANDER 450,2019-09-09,0,6,MT,US,6,540
OUTLANDER 1000,2019-09-16,3,4,MT,US,7,541
OUTLANDER 850,2019-09-16,4,7,MT,US,11,564
OUTLANDER 450,2019-09-16,5,15,MT,US,20,560
OUTLANDER 1000,2019-09-23,14,5,MT,US,19,560
OUTLANDER 850,2019-09-23,0,12,MT,US,12,576
OUTLANDER 450,2019-09-23,12,10,MT,US,22,582
OUTLANDER 1000,2019-09-30,6,14,MT,US,20,580
OUTLANDER 850,2019-09-30,5,7,MT,US,12,588
OUTLANDER 450,2019-09-30,7,14,MT,US,21,603
OUTLANDER 1000,2019-10-07,14,10,MT,US,24,604
OUTLANDER 850,2019-10-07,12,2,MT,US,14,602
OUTLANDER 450,2019-10-07,12,13,MT,US,25,628
OUTLANDER 1000,2019-10-14,13,9,MT,US,22,626
OUTLANDER 850,2019-10-14,10,3,MT,US,13,615
OUTLANDER 450,2019-10-14,6,5,MT,US,11,639
OUTLANDER 1000,2019-10-21,10,9,MT,US,19,645
OUTLANDER 850,2019-10-21,4,4,MT,US,8,623
OUTLANDER 450,2019-10-21,6,11,MT,US,17,656
OUTLANDER 1000,2019-10-28,9,9,MT,US,18,663
OUTLANDER 850,2019-10-28,15,12,MT,US,27,650
OUTLANDER 450,2019-10-28,5,13,MT,US,18,674
OUTLANDER 1000,2019-11-04,5,15,MT,US,20,683
OUTLANDER 850,2019-11-04,5,11,MT,US,16,666
OUTLANDER 450,2019-11-04,12,4,MT,US,16,690
OUTLANDER 1000,2019-11-11,3,2,MT,US,5,688
OUTLANDER 850,2019-11-11,6,14,MT,US,20,686
OUTLANDER 450,2019-11-11,5,4,MT,US,9,699
OUTLANDER 1000,2019-11-18,13,15,MT,US,28,716
OUTLANDER 850,2019-11-18,4,6,MT,US,10,696
OUTLANDER 450,2019-11-18,13,9,MT,US,22,721
OUTLANDER 1000,2019-11-25,7,6,MT,US,13,729
OUTLANDER 850,2019-11-25,9,13,MT,US,22,718
OUTLANDER 450,2019-11-25,14,0,MT,US,14,735
OUTLANDER 1000,2019-12-02,10,6,MT,US,16,745
OUTLANDER 850,2019-12-02,9,8,MT,US,17,735
OUTLANDER 450,2019-12-02,5,9,MT,US,14,749
OUTLANDER 1000,2019-12-09,1,15,MT,US,16,761
OUTLANDER 850,2019-12-09,12,12,MT,US,24,759
OUTLANDER 450,2019-12-09,8,1,MT,US,9,758
OUTLANDER 1000,2019-12-16,5,6,MT,US,11,772
OUTLANDER 850,2019-12-16,11,9,MT,US,20,779
OUTLANDER 450,2019-12-16,4,4,MT,US,8,766
OUTLANDER 1000,2019-12-23,6,5,MT,US,11,783
OUTLANDER 850,2019-12-23,2,3,MT,US,5,784
OUTLANDER 450,2019-12-23,13,6,MT,US,19,785
OUTLANDER 1000,2019-12-30,3,0,MT,US,3,786
OUTLANDER 850,2019-12-30,4,11,MT,US,15,799
OUTLANDER 450,2019-12-30,10,4,MT,US,14,799
OUTLANDER 1000,2020-01-06,11,11,MT,US,22,808
OUTLANDER 850,2020-01-06,2,4,MT,US,6,805
OUTLANDER 450,2020-01-06,10,12,MT,US,22,821
OUTLANDER 1000,2020-01-13,10,8,MT,US,18,826
OUTLANDER 850,2020-01-13,14,7,MT,US,21,826
OUTLANDER 450,2020-01-13,10,12,MT,US,22,843
OUTLANDER 1000,2020-01-20,14,14,MT,US,28,854
OUTLANDER 850,2020-01-20,11,9,MT,US,20,846
OUTLANDER 450,2020-01-20,8,7,MT,US,15,858
OUTLANDER 1000,2020-01-27,9,12,MT,US,21,875
OUTLANDER 850,2020-01-27,11,1,MT,US,12,858
OUTLANDER 450,2020-01-27,9,5,MT,US,14,872
OUTLANDER 1000,2020-02-03,14,14,MT,US,28,903
OUTLANDER 850,2020-02-03,7,9,MT,US,16,874
OUTLANDER 450,2020-02-03,2,6,MT,US,8,880
OUTLANDER 1000,2020-02-10,12,5,MT,US,17,920
OUTLANDER 850,2020-02-10,1,4,MT,US,5,879
OUTLANDER 450,2020-02-10,3,8,MT,US,11,891
OUTLANDER 1000,2020-02-17,8,5,MT,US,13,933
OUTLANDER 850,2020-02-17,3,2,MT,US,5,884
OUTLANDER 450,2020-02-17,7,15,MT,US,22,913
OUTLANDER 1000,2020-02-24,3,13,MT,US,16,949
OUTLANDER 850,2020-02-24,7,6,MT,US,13,897
OUTLANDER 450,2020-02-24,12,6,MT,US,18,931
OUTLANDER 1000,2020-03-02,7,14,MT,US,21,970
OUTLANDER 850,2020-03-02,13,8,MT,US,21,918
OUTLANDER 450,2020-03-02,11,4,MT,US,15,946
OUTLANDER 1000,2020-03-09,6,1,MT,US,7,977
OUTLANDER 850,2020-03-09,9,12,MT,US,21,939
OUTLANDER 450,2020-03-09,8,2,MT,US,10,956
OUTLANDER 1000,2020-03-16,11,8,MT,US,19,996
OUTLANDER 850,2020-03-16,14,14,MT,US,28,967
OUTLANDER 450,2020-03-16,9,4,MT,US,13,969
OUTLANDER 1000,2020-03-23,6,14,MT,US,20,1016
OUTLANDER 850,2020-03-23,8,6,MT,US,14,981
OUTLANDER 450,2020-03-23,10,11,MT,US,21,990
OUTLANDER 1000,2020-03-30,4,14,MT,US,18,1034
OUTLANDER 850,2020-03-30,8,11,MT,US,19,1000
OUTLANDER 450,2020-03-30,1,3,MT,US,4,994
OUTLANDER 1000,2020-04-06,10,3,MT,US,13,1047
OUTLANDER 850,2020-04-06,13,1,MT,US,14,1014
OUTLANDER 450,2020-04-06,12,3,MT,US,15,1009
OUTLANDER 1000,2020-04-13,0,3,MT,US,3,1050
OUTLANDER 850,2020-04-13,2,5,MT,US,7,1021
OUTLANDER 450,2020-04-13,6,13,MT,US,19,1028
OUTLANDER 1000,2020-04-20,3,4,MT,US,7,1057
OUTLANDER 850,2020-04-20,13,13,MT,US,26,1047
OUTLANDER 450,2020-04-20,8,14,MT,US,22,1050
OUTLANDER 1000,2020-04-27,9,10,MT,US,19,1076
OUTLANDER 850,2020-04-27,8,13,MT,US,21,1068
OUTLANDER 450,2020-04-27,4,15,MT,US,19,1069
OUTLANDER 1000,2020-05-04,13,2,MT,US,15,1091
OUTLANDER 850,2020-05-04,4,10,MT,US,14,1082
OUTLANDER 450,2020-05-04,7,5,MT,US,12,1081
OUTLANDER 1000,2020-05-11,11,7,MT,US,18,1109
OUTLANDER 850,2020-05-11,0,8,MT,US,8,1090
OUTLANDER 450,2020-05-11,5,4,MT,US,9,1090
OUTLANDER 1000,2020-05-18,13,9,MT,US,22,1131
OUTLANDER 850,2020-05-18,14,4,MT,US,18,1108
OUTLANDER 450,2020-05-18,11,14,MT,US,25,1115
OUTLANDER 1000,2020-05-25,5,4,MT,US,9,1140
OUTLANDER 850,2020-05-25,13,12,MT,US,25,1133
OUTLANDER 450,2020-05-25,14,12,MT,US,26,1141
OUTLANDER 1000,2020-06-01,3,10,MT,US,13,1153
OUTLANDER 850,2020-06-01,3,4,MT,US,7,1140
OUTLANDER 450,2020-06-01,2,13,MT,US,15,1156
OUTLANDER 1000,2020-06-08,11,13,MT,US,24,1177
OUTLANDER 850,2020-06-08,9,5,MT,US,14,1154
OUTLANDER 450,2020-06-08,11,6,MT,US,17,1173
OUTLANDER 1000,2020-06-15,1,0,MT,US,1,1178
OUTLANDER 850,2020-06-15,0,15,MT,US,15,1169
OUTLANDER 450,2020-06-15,2,0,MT,US,2,1175
OUTLANDER 1000,2020-06-22,11,1,MT,US,12,1190
OUTLANDER 850,2020-06-22,13,5,MT,US,18,1187
OUTLANDER 450,2020-06-22,13,11,MT,US,24,1199
OUTLANDER 1000,2020-06-29,13,7,MT,US,20,1210
OUTLANDER 850,2020-06-29,6,9,MT,US,15,1202
OUTLANDER 450,2020-06-29,5,1,MT,US,6,1205
OUTLANDER 1000,2020-07-06,11,5,MT,US,16,1226
OUTLANDER 850,2020-07-06,14,3,MT,US,17,1219
OUTLANDER 450,2020-07-06,6,6,MT,US,12,1217
OUTLANDER 1000,2020-07-13,13,8,MT,US,21,1247
OUTLANDER 850,2020-07-13,1,12,MT,US,13,1232
OUTLANDER 450,2020-07-13,14,10,MT,US,24,1241
OUTLANDER 1000,2020-07-20,2,12,MT,US,14,1261
OUTLANDER 850,2020-07-20,11,6,MT,US,17,1249
OUTLANDER 450,2020-07-20,14,2,MT,US,16,1257
OUTLANDER 1000,2020-07-27,12,9,MT,US,21,1282
OUTLANDER 850,2020-07-27,8,1,MT,US,9,1258
OUTLANDER 450,2020-07-27,11,3,MT,US,14,1271
OUTLANDER 1000,2020-08-03,6,9,MT,US,15,1297
OUTLANDER 850,2020-08-03,15,6,MT,US,21,1279
OUTLANDER 450,2020-08-03,1,9,MT,US,10,1281
OUTLANDER 1000,2020-08-10,11,6,MT,US,17,1314
OUTLANDER 850,2020-08-10,12,14,MT,US,26,1305
OUTLANDER 450,2020-08-10,4,3,MT,US,7,1288
OUTLANDER 1000,2020-08-17,14,15,MT,US,29,1343
OUTLANDER 850,2020-08-17,2,6,MT,US,8,1313
OUTLANDER 450,2020-08-17,4,13,MT,US,17,1305
OUTLANDER 1000,2020-08-24,2,6,MT,US,8,1351
OUTLANDER 850,2020-08-24,15,11,MT,US,26,1339
OUTLANDER 450,2020-08-24,14,13,MT,US,27,1332
OUTLANDER 1000,2020-08-31,8,6,MT,US,14,1365
OUTLANDER 850,2020-08-31,10,11,MT,US,21,1360
OUTLANDER 450,2020-08-31,12,13,MT,US,25,1357
OUTLANDER 1000,2020-09-07,10,0,MT,US,10,1375
OUTLANDER 850,2020-09-07,9,6,MT,US,15,1375
OUTLANDER 450,2020-09-07,10,1,MT,US,11,1368
OUTLANDER 1000,2020-09-14,9,13,MT,US,22,1397
OUTLANDER 850,2020-09-14,1,11,MT,US,12,1387
OUTLANDER 450,2020-09-14,8,10,MT,US,18,1386
OUTLANDER 1000,2020-09-21,6,14,MT,US,20,1417
OUTLANDER 850,2020-09-21,10,12,MT,US,22,1409
OUTLANDER 450,2020-09-21,13,14,MT,US,27,1413
OUTLANDER 1000,2020-09-28,9,12,MT,US,21,1438
OUTLANDER 850,2020-09-28,13,14,MT,US,27,1436
OUTLANDER 450,2020-09-28,14,4,MT,US,18,1431
OUTLANDER 1000,2020-10-05,3,0,MT,US,3,1441
OUTLANDER 850,2020-10-05,2,3,MT,US,5,1441
OUTLANDER 450,2020-10-05,9,5,MT,US,14,1445
OUTLANDER 1000,2020-10-12,6,2,MT,US,8,1449
OUTLANDER 850,2020-10-12,14,10,MT,US,24,1465
OUTLANDER 450,2020-10-12,7,11,MT,US,18,1463
OUTLANDER 1000,2020-10-19,1,5,MT,US,6,1455
OUTLANDER 850,2020-10-19,12,0,MT,US,12,1477
OUTLANDER 450,2020-10-19,11,9,MT,US,20,1483
OUTLANDER 1000,2020-10-26,12,13,MT,US,25,1480
OUTLANDER 850,2020-10-26,6,2,MT,US,8,1485
OUTLANDER 450,2020-10-26,9,15,MT,US,24,1507
OUTLANDER 1000,2020-11-02,9,13,MT,US,22,1502
OUTLANDER 850,2020-11-02,1,14,MT,US,15,1500
OUTLANDER 450,2020-11-02,7,6,MT,US,13,1520
OUTLANDER 1000,2020-11-09,0,13,MT,US,13,1515
OUTLANDER 850,2020-11-09,8,7,MT,US,15,1515
OUTLANDER 450,2020-11-09,1,11,MT,US,12,1532
OUTLANDER 1000,2020-11-16,12,3,MT,US,15,1530
OUTLANDER 850,2020-11-16,5,5,MT,US,10,1525
OUTLANDER 450,2020-11-16,11,6,MT,US,17,1549
OUTLANDER 1000,2020-11-23,0,2,MT,US,2,1532
OUTLANDER 850,2020-11-23,0,2,MT,US,2,1527
OUTLANDER 450,2020-11-23,13,0,MT,US,13,1562
OUTLANDER 1000,2020-11-30,14,12,MT,US,26,1558
OUTLANDER 850,2020-11-30,0,10,MT,US,10,1537
OUTLANDER 450,2020-11-30,11,1,MT,US,12,1574
OUTLANDER 1000,2020-12-07,11,5,MT,US,16,1574
OUTLANDER 850,2020-12-07,13,9,MT,US,22,1559
OUTLANDER 450,2020-12-07,13,4,MT,US,17,1591
OUTLANDER 1000,2020-12-14,10,11,MT,US,21,1595
OUTLANDER 850,2020-12-14,9,5,MT,US,14,1573
OUTLANDER 450,2020-12-14,9,8,MT,US,17,1608
OUTLANDER 1000,2020-12-21,12,8,MT,US,20,1615
OUTLANDER 850,2020-12-21,9,4,MT,US,13,1586
OUTLANDER 450,2020-12-21,7,1,MT,US,8,1616
OUTLANDER 1000,2020-12-28,2,4,MT,US,6,1621
OUTLANDER 850,2020-12-28,5,11,MT,US,16,1602
OUTLANDER 450,2020-12-28,1,12,MT,US,13,1629
OUTLANDER 1000,2021-01-04,1,10,MT,US,11,1632
OUTLANDER 850,2021-01-04,12,12,MT,US,24,1626
OUTLANDER 450,2021-01-04,11,3,MT,US,14,1643
OUTLANDER 1000,2021-01-11,2,3,MT,US,5,1637
OUTLANDER 850,2021-01-11,4,3,MT,US,7,1633
OUTLANDER 450,2021-01-11,7,14,MT,US,21,1664
OUTLANDER 1000,2021-01-18,4,1,MT,US,5,1642
OUTLANDER 850,2021-01-18,9,2,MT,US,11,1644
OUTLANDER 450,2021-01-18,9,10,MT,US,19,1683
OUTLANDER 1000,2021-01-25,12,13,MT,US,25,1667
OUTLANDER 850,2021-01-25,2,8,MT,US,10,1654
OUTLANDER 450,2021-01-25,5,10,MT,US,15,1698
OUTLANDER 1000,2021-02-01,9,3,MT,US,12,1679
OUTLANDER 850,2021-02-01,13,12,MT,US,25,1679
OUTLANDER 450,2021-02-01,6,9,MT,US,15,1713
OUTLANDER 1000,2021-02-08,1,6,MT,US,7,1686
OUTLANDER 850,2021-02-08,5,1,MT,US,6,1685
OUTLANDER 450,2021-02-08,7,12,MT,US,19,1732
OUTLANDER 1000,2021-02-15,13,14,MT,US,27,1713
OUTLANDER 850,2021-02-15,3,11,MT,US,14,1699
OUTLANDER 450,2021-02-15,0,8,MT,US,8,1740
OUTLANDER 1000,2021-02-22,13,2,MT,US,15,1728
OUTLANDER 850,2021-02-22,2,1,MT,US,3,1702
OUTLANDER 450,2021-02-22,14,0,MT,US,14,1754
OUTLANDER 1000,2021-03-01,8,11,MT,US,19,1747
OUTLANDER 850,2021-03-01,1,12,MT,US,13,1715
OUTLANDER 450,2021-03-01,9,9,MT,US,18,1772
OUTLANDER 1000,2021-03-08,4,8,MT,US,12,1759
OUTLANDER 850,2021-03-08,1,10,MT,US,11,1726
OUTLANDER 450,2021-03-08,14,13,MT,US,27,1799
OUTLANDER 1000,2021-03-15,4,1,MT,US,5,1764
OUTLANDER 850,2021-03-15,4,0,MT,US,4,1730
OUTLANDER 450,2021-03-15,12,4,MT,US,16,1815
OUTLANDER 1000,2021-03-22,15,10,MT,US,25,1789
OUTLANDER 850,2021-03-22,2,0,MT,US,2,1732
OUTLANDER 450,2021-03-22,6,12,MT,US,18,1833
OUTLANDER 1000,2021-03-29,6,6,MT,US,12,1801
OUTLANDER 850,2021-03-29,11,0,MT,US,11,1743
OUTLANDER 450,2021-03-29,4,0,MT,US,4,1837
OUTLANDER 1000,2021-04-05,14,15,MT,US,29,1830
OUTLANDER 850,2021-04-05,8,13,MT,US,21,1764
OUTLANDER 450,2021-04-05,12,3,MT,US,15,1852
OUTLANDER 1000,2021-04-12,14,4,MT,US,18,1848
OUTLANDER 850,2021-04-12,13,4,MT,US,17,1781
OUTLANDER 450,2021-04-12,6,8,MT,US,14,1866
OUTLANDER 1000,2021-04-19,2,3,MT,US,5,1853
OUTLANDER 850,2021-04-19,3,9,MT,US,12,1793
OUTLANDER 450,2021-04-19,12,13,MT,US,25,1891
OUTLANDER 1000,2021-04-26,5,7,MT,US,12,1865
OUTLANDER 850,2021-04-26,4,5,MT,US,9,1802
OUTLANDER 450,2021-04-26,13,10,MT,US,23,1914
OUTLANDER 1000,2021-05-03,7,9,MT,US,16,1881
OUTLANDER 850,2021-05-03,8,2,MT,US,10,1812
OUTLANDER 450,2021-05-03,7,12,MT,US,19,1933
OUTLANDER 1000,2021-05-10,7,12,MT,US,19,1900
OUTLANDER 850,2021-05-10,15,3,MT,US,18,1830
OUTLANDER 450,2021-05-10,12,2,MT,US,14,1947
OUTLANDER 1000,2021-05-17,14,10,MT,US,24,1924
OUTLANDER 850,2021-05-17,7,1,MT,US,8,1838
OUTLANDER 450,2021-05-17,9,0,MT,US,9,1956
OUTLANDER 1000,2021-05-24,10,1,MT,US,11,1935
OUTLANDER 850,2021-05-24,8,6,MT,US,14,1852
OUTLANDER 450,2021-05-24,12,7,MT,US,19,1975
OUTLANDER 1000,2021-05-31,2,0,MT,US,2,1937
OUTLANDER 850,2021-05-31,11,12,MT,US,23,1875
OUTLANDER 450,2021-05-31,9,3,MT,US,12,1987
OUTLANDER 1000,2021-06-07,12,2,MT,US,14,1951
OUTLANDER 850,2021-06-07,1,9,MT,US,10,1885
OUTLANDER 450,2021-06-07,3,15,MT,US,18,2005
OUTLANDER 1000,2021-06-14,8,10,MT,US,18,1969
OUTLANDER 850,2021-06-14,2,6,MT,US,8,1893
OUTLANDER 450,2021-06-14,14,5,MT,US,19,2024
OUTLANDER 1000,2021-06-21,6,14,MT,US,20,1989
OUTLANDER 850,2021-06-21,3,9,MT,US,12,1905
OUTLANDER 450,2021-06-21,13,2,MT,US,15,2039
OUTLANDER 1000,2021-06-28,9,11,MT,US,20,2009
OUTLANDER 850,2021-06-28,14,3,MT,US,17,1922
OUTLANDER 450,2021-06-28,5,8,MT,US,13,2052
OUTLANDER 1000,2021-07-05,4,14,MT,US,18,2027
OUTLANDER 850,2021-07-05,8,14,MT,US,22,1944
OUTLANDER 450,2021-07-05,4,1,MT,US,5,2057
OUTLANDER 1000,2021-07-12,1,9,MT,US,10,2037
OUTLANDER 850,2021-07-12,4,10,MT,US,14,1958
OUTLANDER 450,2021-07-12,8,2,MT,US,10,2067
OUTLANDER 1000,2021-07-19,9,12,MT,US,21,2058
OUTLANDER 850,2021-07-19,10,0,MT,US,10,1968
OUTLANDER 450,2021-07-19,4,10,MT,US,14,2081
OUTLANDER 1000,2021-07-26,8,11,MT,US,19,2077
OUTLANDER 850,2021-07-26,2,12,MT,US,14,1982
OUTLANDER 450,2021-07-26,8,0,MT,US,8,2089
OUTLANDER 1000,2021-08-02,4,3,MT,US,7,2084
OUTLANDER 850,2021-08-02,4,8,MT,US,12,1994
OUTLANDER 450,2021-08-02,12,4,MT,US,16,2105
OUTLANDER 1000,2021-08-09,2,2,MT,US,4,2088
OUTLANDER 850,2021-08-09,3,9,MT,US,12,2006
OUTLANDER 450,2021-08-09,6,12,MT,US,18,2123
OUTLANDER 1000,2021-08-16,11,8,MT,US,19,2107
OUTLANDER 850,2021-08-16,0,11,MT,US,11,2017
OUTLANDER 450,2021-08-16,13,8,MT,US,21,2144
OUTLANDER 1000,2021-08-23,7,7,MT,US,14,2121
OUTLANDER 850,2021-08-23,13,7,MT,US,20,2037
OUTLANDER 450,2021-08-23,13,3,MT,US,16,2160
OUTLANDER 1000,2021-08-30,2,14,MT,US,16,2137
OUTLANDER 850,2021-08-30,13,7,MT,US,20,2057
OUTLANDER 450,2021-08-30,1,12,MT,US,13,2173
OUTLANDER 1000,2021-09-06,0,12,MT,US,12,2149
OUTLANDER 850,2021-09-06,9,3,MT,US,12,2069
OUTLANDER 450,2021-09-06,10,4,MT,US,14,2187
OUTLANDER 1000,2021-09-13,14,1,MT,US,15,2164
OUTLANDER 850,2021-09-13,12,9,MT,US,21,2090
OUTLANDER 450,2021-09-13,3,2,MT,US,5,2192
OUTLANDER 1000,2021-09-20,8,10,MT,US,18,2182
OUTLANDER 850,2021-09-20,8,11,MT,US,19,2109
OUTLANDER 450,2021-09-20,5,4,MT,US,9,2201
OUTLANDER 1000,2021-09-27,3,10,MT,US,13,2195
OUTLANDER 850,2021-09-27,3,13,MT,US,16,2125
OUTLANDER 450,2021-09-27,1,2,MT,US,3,2204
OUTLANDER 1000,2021-10-04,4,8,MT,US,12,2207
OUTLANDER 850,2021-10-04,1,5,MT,US,6,2131
OUTLANDER 450,2021-10-04,5,14,MT,US,19,2223
OUTLANDER 1000,2021-10-11,7,3,MT,US,10,2217
OUTLANDER 850,2021-10-11,14,0,MT,US,14,2145
OUTLANDER 450,2021-10-11,11,7,MT,US,18,2241
OUTLANDER 1000,2021-10-18,4,11,MT,US,15,2232
OUTLANDER 850,2021-10-18,7,4,MT,US,11,2156
OUTLANDER 450,2021-10-18,13,13,MT,US,26,2267
OUTLANDER 1000,2021-10-25,4,14,MT,US,18,2250
OUTLANDER 850,2021-10-25,8,12,MT,US,20,2176
OUTLANDER 450,2021-10-25,15,9,MT,US,24,2291
OUTLANDER 1000,2021-11-01,8,1,MT,US,9,2259
OUTLANDER 850,2021-11-01,10,10,MT,US,20,2196
OUTLANDER 450,2021-11-01,8,14,MT,US,22,2313
OUTLANDER 1000,2021-11-08,7,12,MT,US,19,2278
OUTLANDER 850,2021-11-08,5,5,MT,US,10,2206
OUTLANDER 450,2021-11-08,12,1,MT,US,13,2326
OUTLANDER 1000,2021-11-15,3,1,MT,US,4,2282
OUTLANDER 850,2021-11-15,13,10,MT,US,23,2229
OUTLANDER 450,2021-11-15,7,3,MT,US,10,2336
OUTLANDER 1000,2021-11-22,9,3,MT,US,12,2294
OUTLANDER 850,2021-11-22,12,11,MT,US,23,2252
OUTLANDER 450,2021-11-22,10,1,MT,US,11,2347
OUTLANDER 1000,2021-11-29,4,11,MT,US,15,2309
OUTLANDER 850,2021-11-29,6,7,MT,US,13,2265
OUTLANDER 450,2021-11-29,3,9,MT,US,12,2359
OUTLANDER 1000,2021-12-06,10,13,MT,US,23,2332
OUTLANDER 850,2021-12-06,6,9,MT,US,15,2280
OUTLANDER 450,2021-12-06,8,5,MT,US,13,2372
OUTLANDER 1000,2021-12-13,10,6,MT,US,16,2348
OUTLANDER 850,2021-12-13,1,1,MT,US,2,2282
OUTLANDER 450,2021-12-13,12,2,MT,US,14,2386
OUTLANDER 1000,2021-12-20,8,11,MT,US,19,2367
OUTLANDER 850,2021-12-20,4,9,MT,US,13,2295
OUTLANDER 450,2021-12-20,13,12,MT,US,25,2411
OUTLANDER 1000,2021-12-27,7,5,MT,US,12,2379
OUTLANDER 850,2021-12-27,8,12,MT,US,20,2315
OUTLANDER 450,2021-12-27,13,3,MT,US,16,2427
OUTLANDER 1000,2019-01-07,1,9,NE,US,10,10
OUTLANDER 850,2019-01-07,13,8,NE,US,21,21
OUTLANDER 450,2019-01-07,7,13,NE,US,20,20
OUTLANDER 1000,2019-01-14,10,3,NE,US,13,23
OUTLANDER 850,2019-01-14,9,12,NE,US,21,42
OUTLANDER 450,2019-01-14,2,8,NE,US,10,30
OUTLANDER 1000,2019-01-21,1,8,NE,US,9,32
OUTLANDER 850,2019-01-21,0,15,NE,US,15,57
OUTLANDER 450,2019-01-21,7,7,NE,US,14,44
OUTLANDER 1000,2019-01-28,9,2,NE,US,11,43
OUTLANDER 850,2019-01-28,7,0,NE,US,7,64
OUTLANDER 450,2019-01-28,10,0,NE,US,10,54
OUTLANDER 1000,2019-02-04,8,4,NE,US,12,55
OUTLANDER 850,2019-02-04,0,7,NE,US,7,71
OUTLANDER 450,2019-02-04,15,14,NE,US,29,83
OUTLANDER 1000,2019-02-11,9,6,NE,US,15,70
OUTLANDER 850,2019-02-11,12,13,NE,US,25,96
OUTLANDER 450,2019-02-11,10,15,NE,US,25,108
OUTLANDER 1000,2019-02-18,14,4,NE,US,18,88
OUTLANDER 850,2019-02-18,4,12,NE,US,16,112
OUTLANDER 450,2019-02-18,9,2,NE,US,11,119
OUTLANDER 1000,2019-02-25,3,4,NE,US,7,95
OUTLANDER 850,2019-02-25,10,0,NE,US,10,122
OUTLANDER 450,2019-02-25,4,5,NE,US,9,128
OUTLANDER 1000,2019-03-04,7,14,NE,US,21,116
OUTLANDER 850,2019-03-04,7,14,NE,US,21,143
OUTLANDER 450,2019-03-04,8,1,NE,US,9,137
OUTLANDER 1000,2019-03-11,14,14,NE,US,28,144
OUTLANDER 850,2019-03-11,13,9,NE,US,22,165
OUTLANDER 450,2019-03-11,5,15,NE,US,20,157
OUTLANDER 1000,2019-03-18,11,9,NE,US,20,164
OUTLANDER 850,2019-03-18,9,2,NE,US,11,176
OUTLANDER 450,2019-03-18,4,9,NE,US,13,170
OUTLANDER 1000,2019-03-25,8,0,NE,US,8,172
OUTLANDER 850,2019-03-25,5,3,NE,US,8,184
OUTLANDER 450,2019-03-25,1,6,NE,US,7,177
OUTLANDER 1000,2019-04-01,13,3,NE,US,16,188
OUTLANDER 850,2019-04-01,12,8,NE,US,20,204
OUTLANDER 450,2019-04-01,13,4,NE,US,17,194
OUTLANDER 1000,2019-04-08,7,13,NE,US,20,208
OUTLANDER 850,2019-04-08,1,15,NE,US,16,220
OUTLANDER 450,2019-04-08,3,4,NE,US,7,201
OUTLANDER 1000,2019-04-15,0,6,NE,US,6,214
OUTLANDER 850,2019-04-15,10,13,NE,US,23,243
OUTLANDER 450,2019-04-15,9,1,NE,US,10,211
OUTLANDER 1000,2019-04-22,8,3,NE,US,11,225
OUTLANDER 850,2019-04-22,12,9,NE,US,21,264
OUTLANDER 450,2019-04-22,8,2,NE,US,10,221
OUTLANDER 1000,2019-04-29,5,13,NE,US,18,243
OUTLANDER 850,2019-04-29,8,13,NE,US,21,285
OUTLANDER 450,2019-04-29,14,4,NE,US,18,239
OUTLANDER 1000,2019-05-06,11,3,NE,US,14,257
OUTLANDER 850,2019-05-06,7,6,NE,US,13,298
OUTLANDER 450,2019-05-06,6,1,NE,US,7,246
OUTLANDER 1000,2019-05-13,1,4,NE,US,5,262
OUTLANDER 850,2019-05-13,5,8,NE,US,13,311
OUTLANDER 450,2019-05-13,2,10,NE,US,12,258
OUTLANDER 1000,2019-05-20,4,15,NE,US,19,281
OUTLANDER 850,2019-05-20,0,6,NE,US,6,317
OUTLANDER 450,2019-05-20,9,5,NE,US,14,272
OUTLANDER 1000,2019-05-27,5,7,NE,US,12,293
OUTLANDER 850,2019-05-27,10,6,NE,US,16,333
OUTLANDER 450,2019-05-27,5,8,NE,US,13,285
OUTLANDER 1000,2019-06-03,9,0,NE,US,9,302
OUTLANDER 850,2019-06-03,10,8,NE,US,18,351
OUTLANDER 450,2019-06-03,14,11,NE,US,25,310
OUTLANDER 1000,2019-06-10,6,4,NE,US,10,312
OUTLANDER 850,2019-06-10,3,1,NE,US,4,355
OUTLANDER 450,2019-06-10,13,13,NE,US,26,336
OUTLANDER 1000,2019-06-17,0,3,NE,US,3,315
OUTLANDER 850,2019-06-17,0,4,NE,US,4,359
OUTLANDER 450,2019-06-17,1,3,NE,US,4,340
OUTLANDER 1000,2019-06-24,7,12,NE,US,19,334
OUTLANDER 850,2019-06-24,8,11,NE,US,19,378
OUTLANDER 450,2019-06-24,5,5,NE,US,10,350
OUTLANDER 1000,2019-07-01,15,0,NE,US,15,349
OUTLANDER 850,2019-07-01,14,9,NE,US,23,401
OUTLANDER 450,2019-07-01,9,12,NE,US,21,371
OUTLANDER 1000,2019-07-08,10,0,NE,US,10,359
OUTLANDER 850,2019-07-08,8,1,NE,US,9,410
OUTLANDER 450,2019-07-08,3,3,NE,US,6,377
OUTLANDER 1000,2019-07-15,13,0,NE,US,13,372
OUTLANDER 850,2019-07-15,0,8,NE,US,8,418
OUTLANDER 450,2019-07-15,8,10,NE,US,18,395
OUTLANDER 1000,2019-07-22,10,4,NE,US,14,386
OUTLANDER 850,2019-07-22,4,6,NE,US,10,428
OUTLANDER 450,2019-07-22,1,3,NE,US,4,399
OUTLANDER 1000,2019-07-29,2,5,NE,US,7,393
OUTLANDER 850,2019-07-29,0,10,NE,US,10,438
OUTLANDER 450,2019-07-29,11,7,NE,US,18,417
OUTLANDER 1000,2019-08-05,4,13,NE,US,17,410
OUTLANDER 850,2019-08-05,4,14,NE,US,18,456
OUTLANDER 450,2019-08-05,8,5,NE,US,13,430
OUTLANDER 1000,2019-08-12,11,11,NE,US,22,432
OUTLANDER 850,2019-08-12,1,13,NE,US,14,470
OUTLANDER 450,2019-08-12,1,9,NE,US,10,440
OUTLANDER 1000,2019-08-19,10,2,NE,US,12,444
OUTLANDER 850,2019-08-19,3,7,NE,US,10,480
OUTLANDER 450,2019-08-19,4,3,NE,US,7,447
OUTLANDER 1000,2019-08-26,11,15,NE,US,26,470
OUTLANDER 850,2019-08-26,8,8,NE,US,16,496
OUTLANDER 450,2019-08-26,10,8,NE,US,18,465
OUTLANDER 1000,2019-09-02,8,12,NE,US,20,490
OUTLANDER 850,2019-09-02,7,11,NE,US,18,514
OUTLANDER 450,2019-09-02,11,15,NE,US,26,491
OUTLANDER 1000,2019-09-09,6,3,NE,US,9,499
OUTLANDER 850,2019-09-09,5,6,NE,US,11,525
OUTLANDER 450,2019-09-09,6,2,NE,US,8,499
OUTLANDER 1000,2019-09-16,11,6,NE,US,17,516
OUTLANDER 850,2019-09-16,2,15,NE,US,17,542
OUTLANDER 450,2019-09-16,8,8,NE,US,16,515
OUTLANDER 1000,2019-09-23,7,14,NE,US,21,537
OUTLANDER 850,2019-09-23,8,14,NE,US,22,564
OUTLANDER 450,2019-09-23,5,1,NE,US,6,521
OUTLANDER 1000,2019-09-30,3,6,NE,US,9,546
OUTLANDER 850,2019-09-30,3,7,NE,US,10,574
OUTLANDER 450,2019-09-30,3,6,NE,US,9,530
OUTLANDER 1000,2019-10-07,2,10,NE,US,12,558
OUTLANDER 850,2019-10-07,14,12,NE,US,26,600
OUTLANDER 450,2019-10-07,8,8,NE,US,16,546
OUTLANDER 1000,2019-10-14,11,11,NE,US,22,580
OUTLANDER 850,2019-10-14,7,4,NE,US,11,611
OUTLANDER 450,2019-10-14,11,4,NE,US,15,561
OUTLANDER 1000,2019-10-21,3,4,NE,US,7,587
OUTLANDER 850,2019-10-21,5,8,NE,US,13,624
OUTLANDER 450,2019-10-21,14,9,NE,US,23,584
OUTLANDER 1000,2019-10-28,13,10,NE,US,23,610
OUTLANDER 850,2019-10-28,1,3,NE,US,4,628
OUTLANDER 450,2019-10-28,4,6,NE,US,10,594
OUTLANDER 1000,2019-11-04,1,8,NE,US,9,619
OUTLANDER 850,2019-11-04,0,10,NE,US,10,638
OUTLANDER 450,2019-11-04,15,10,NE,US,25,619
OUTLANDER 1000,2019-11-11,8,8,NE,US,16,635
OUTLANDER 850,2019-11-11,11,14,NE,US,25,663
OUTLANDER 450,2019-11-11,9,14,NE,US,23,642
OUTLANDER 1000,2019-11-18,14,4,NE,US,18,653
OUTLANDER 850,2019-11-18,6,1,NE,US,7,670
OUTLANDER 450,2019-11-18,3,8,NE,US,11,653
OUTLANDER 1000,2019-11-25,11,0,NE,US,11,664
OUTLANDER 850,2019-11-25,14,3,NE,US,17,687
OUTLANDER 450,2019-11-25,7,8,NE,US,15,668
OUTLANDER 1000,2019-12-02,3,2,NE,US,5,669
OUTLANDER 850,2019-12-02,6,2,NE,US,8,695
OUTLANDER 450,2019-12-02,7,2,NE,US,9,677
OUTLANDER 1000,2019-12-09,7,2,NE,US,9,678
OUTLANDER 850,2019-12-09,8,4,NE,US,12,707
OUTLANDER 450,2019-12-09,8,1,NE,US,9,686
OUTLANDER 1000,2019-12-16,11,7,NE,US,18,696
OUTLANDER 850,2019-12-16,5,8,NE,US,13,720
OUTLANDER 450,2019-12-16,8,7,NE,US,15,701
OUTLANDER 1000,2019-12-23,15,2,NE,US,17,713
OUTLANDER 850,2019-12-23,3,4,NE,US,7,727
OUTLANDER 450,2019-12-23,6,8,NE,US,14,715
OUTLANDER 1000,2019-12-30,5,14,NE,US,19,732
OUTLANDER 850,2019-12-30,11,12,NE,US,23,750
OUTLANDER 450,2019-12-30,9,10,NE,US,19,734
OUTLANDER 1000,2020-01-06,3,13,NE,US,16,748
OUTLANDER 850,2020-01-06,13,15,NE,US,28,778
OUTLANDER 450,2020-01-06,0,8,NE,US,8,742
OUTLANDER 1000,2020-01-13,4,2,NE,US,6,754
OUTLANDER 850,2020-01-13,13,1,NE,US,14,792
OUTLANDER 450,2020-01-13,4,13,NE,US,17,759
OUTLANDER 1000,2020-01-20,13,12,NE,US,25,779
OUTLANDER 850,2020-01-20,10,5,NE,US,15,807
OUTLANDER 450,2020-01-20,4,11,NE,US,15,774
OUTLANDER 1000,2020-01-27,1,2,NE,US,3,782
OUTLANDER 850,2020-01-27,9,1,NE,US,10,817
OUTLANDER 450,2020-01-27,6,0,NE,US,6,780
OUTLANDER 1000,2020-02-03,7,1,NE,US,8,790
OUTLANDER 850,2020-02-03,4,11,NE,US,15,832
OUTLANDER 450,2020-02-03,10,12,NE,US,22,802
OUTLANDER 1000,2020-02-10,5,14,NE,US,19,809
OUTLANDER 850,2020-02-10,6,5,NE,US,11,843
OUTLANDER 450,2020-02-10,10,3,NE,US,13,815
OUTLANDER 1000,2020-02-17,5,10,NE,US,15,824
OUTLANDER 850,2020-02-17,14,12,NE,US,26,869
OUTLANDER 450,2020-02-17,3,2,NE,US,5,820
OUTLANDER 1000,2020-02-24,0,12,NE,US,12,836
OUTLANDER 850,2020-02-24,14,3,NE,US,17,886
OUTLANDER 450,2020-02-24,4,10,NE,US,14,834
OUTLANDER 1000,2020-03-02,13,14,NE,US,27,863
OUTLANDER 850,2020-03-02,4,4,NE,US,8,894
OUTLANDER 450,2020-03-02,12,2,NE,US,14,848
OUTLANDER 1000,2020-03-09,8,10,NE,US,18,881
OUTLANDER 850,2020-03-09,15,4,NE,US,19,913
OUTLANDER 450,2020-03-09,9,0,NE,US,9,857
OUTLANDER 1000,2020-03-16,11,14,NE,US,25,906
OUTLANDER 850,2020-03-16,14,11,NE,US,25,938
OUTLANDER 450,2020-03-16,12,8,NE,US,20,877
OUTLANDER 1000,2020-03-23,1,0,NE,US,1,907
OUTLANDER 850,2020-03-23,4,15,NE,US,19,957
OUTLANDER 450,2020-03-23,0,2,NE,US,2,879
OUTLANDER 1000,2020-03-30,8,10,NE,US,18,925
OUTLANDER 850,2020-03-30,1,8,NE,US,9,966
OUTLANDER 450,2020-03-30,1,10,NE,US,11,890
OUTLANDER 1000,2020-04-06,10,9,NE,US,19,944
OUTLANDER 850,2020-04-06,8,8,NE,US,16,982
OUTLANDER 450,2020-04-06,7,8,NE,US,15,905
OUTLANDER 1000,2020-04-13,5,13,NE,US,18,962
OUTLANDER 850,2020-04-13,2,8,NE,US,10,992
OUTLANDER 450,2020-04-13,6,11,NE,US,17,922
OUTLANDER 1000,2020-04-20,1,9,NE,US,10,972
OUTLANDER 850,2020-04-20,8,2,NE,US,10,1002
OUTLANDER 450,2020-04-20,6,6,NE,US,12,934
OUTLANDER 1000,2020-04-27,8,7,NE,US,15,987
OUTLANDER 850,2020-04-27,2,6,NE,US,8,1010
OUTLANDER 450,2020-04-27,6,1,NE,US,7,941
OUTLANDER 1000,2020-05-04,0,4,NE,US,4,991
OUTLANDER 850,2020-05-04,5,10,NE,US,15,1025
OUTLANDER 450,2020-05-04,4,15,NE,US,19,960
OUTLANDER 1000,2020-05-11,14,3,NE,US,17,1008
OUTLANDER 850,2020-05-11,14,5,NE,US,19,1044
OUTLANDER 450,2020-05-11,3,4,NE,US,7,967
OUTLANDER 1000,2020-05-18,0,12,NE,US,12,1020
OUTLANDER 850,2020-05-18,8,7,NE,US,15,1059
OUTLANDER 450,2020-05-18,6,14,NE,US,20,987
OUTLANDER 1000,2020-05-25,8,2,NE,US,10,1030
OUTLANDER 850,2020-05-25,4,13,NE,US,17,1076
OUTLANDER 450,2020-05-25,7,9,NE,US,16,1003
OUTLANDER 1000,2020-06-01,12,7,NE,US,19,1049
OUTLANDER 850,2020-06-01,5,1,NE,US,6,1082
OUTLANDER 450,2020-06-01,1,6,NE,US,7,1010
OUTLANDER 1000,2020-06-08,1,10,NE,US,11,1060
OUTLANDER 850,2020-06-08,7,8,NE,US,15,1097
OUTLANDER 450,2020-06-08,12,1,NE,US,13,1023
OUTLANDER 1000,2020-06-15,3,12,NE,US,15,1075
OUTLANDER 850,2020-06-15,7,3,NE,US,10,1107
OUTLANDER 450,2020-06-15,9,6,NE,US,15,1038
OUTLANDER 1000,2020-06-22,8,8,NE,US,16,1091
OUTLANDER 850,2020-06-22,14,4,NE,US,18,1125
OUTLANDER 450,2020-06-22,6,12,NE,US,18,1056
OUTLANDER 1000,2020-06-29,6,9,NE,US,15,1106
OUTLANDER 850,2020-06-29,9,13,NE,US,22,1147
OUTLANDER 450,2020-06-29,9,3,NE,US,12,1068
OUTLANDER 1000,2020-07-06,10,3,NE,US,13,1119
OUTLANDER 850,2020-07-06,12,7,NE,US,19,1166
OUTLANDER 450,2020-07-06,4,6,NE,US,10,1078
OUTLANDER 1000,2020-07-13,4,5,NE,US,9,1128
OUTLANDER 850,2020-07-13,12,5,NE,US,17,1183
OUTLANDER 450,2020-07-13,8,9,NE,US,17,1095
OUTLANDER 1000,2020-07-20,8,2,NE,US,10,1138
OUTLANDER 850,2020-07-20,12,1,NE,US,13,1196
OUTLANDER 450,2020-07-20,8,8,NE,US,16,1111
OUTLANDER 1000,2020-07-27,15,3,NE,US,18,1156
OUTLANDER 850,2020-07-27,7,4,NE,US,11,1207
OUTLANDER 450,2020-07-27,9,4,NE,US,13,1124
OUTLANDER 1000,2020-08-03,9,11,NE,US,20,1176
OUTLANDER 850,2020-08-03,1,3,NE,US,4,1211
OUTLANDER 450,2020-08-03,12,1,NE,US,13,1137
OUTLANDER 1000,2020-08-10,6,12,NE,US,18,1194
OUTLANDER 850,2020-08-10,11,5,NE,US,16,1227
OUTLANDER 450,2020-08-10,9,4,NE,US,13,1150
OUTLANDER 1000,2020-08-17,0,11,NE,US,11,1205
OUTLANDER 850,2020-08-17,11,7,NE,US,18,1245
OUTLANDER 450,2020-08-17,5,3,NE,US,8,1158
OUTLANDER 1000,2020-08-24,12,1,NE,US,13,1218
OUTLANDER 850,2020-08-24,10,1,NE,US,11,1256
OUTLANDER 450,2020-08-24,7,13,NE,US,20,1178
OUTLANDER 1000,2020-08-31,2,4,NE,US,6,1224
OUTLANDER 850,2020-08-31,4,14,NE,US,18,1274
OUTLANDER 450,2020-08-31,1,14,NE,US,15,1193
OUTLANDER 1000,2020-09-07,9,12,NE,US,21,1245
OUTLANDER 850,2020-09-07,15,9,NE,US,24,1298
OUTLANDER 450,2020-09-07,14,6,NE,US,20,1213
OUTLANDER 1000,2020-09-14,1,5,NE,US,6,1251
OUTLANDER 850,2020-09-14,5,13,NE,US,18,1316
OUTLANDER 450,2020-09-14,10,2,NE,US,12,1225
OUTLANDER 1000,2020-09-21,2,12,NE,US,14,1265
OUTLANDER 850,2020-09-21,3,6,NE,US,9,1325
OUTLANDER 450,2020-09-21,2,3,NE,US,5,1230
OUTLANDER 1000,2020-09-28,2,9,NE,US,11,1276
OUTLANDER 850,2020-09-28,4,3,NE,US,7,1332
OUTLANDER 450,2020-09-28,13,15,NE,US,28,1258
OUTLANDER 1000,2020-10-05,15,4,NE,US,19,1295
OUTLANDER 850,2020-10-05,14,6,NE,US,20,1352
OUTLANDER 450,2020-10-05,3,8,NE,US,11,1269
OUTLANDER 1000,2020-10-12,13,9,NE,US,22,1317
OUTLANDER 850,2020-10-12,12,5,NE,US,17,1369
OUTLANDER 450,2020-10-12,13,8,NE,US,21,1290
OUTLANDER 1000,2020-10-19,5,7,NE,US,12,1329
OUTLANDER 850,2020-10-19,9,10,NE,US,19,1388
OUTLANDER 450,2020-10-19,5,12,NE,US,17,1307
OUTLANDER 1000,2020-10-26,10,8,NE,US,18,1347
OUTLANDER 850,2020-10-26,8,2,NE,US,10,1398
OUTLANDER 450,2020-10-26,4,10,NE,US,14,1321
OUTLANDER 1000,2020-11-02,13,11,NE,US,24,1371
OUTLANDER 850,2020-11-02,9,9,NE,US,18,1416
OUTLANDER 450,2020-11-02,2,10,NE,US,12,1333
OUTLANDER 1000,2020-11-09,11,2,NE,US,13,1384
OUTLANDER 850,2020-11-09,3,15,NE,US,18,1434
OUTLANDER 450,2020-11-09,10,2,NE,US,12,1345
OUTLANDER 1000,2020-11-16,14,12,NE,US,26,1410
OUTLANDER 850,2020-11-16,8,3,NE,US,11,1445
OUTLANDER 450,2020-11-16,3,10,NE,US,13,1358
OUTLANDER 1000,2020-11-23,8,1,NE,US,9,1419
OUTLANDER 850,2020-11-23,3,13,NE,US,16,1461
OUTLANDER 450,2020-11-23,12,6,NE,US,18,1376
OUTLANDER 1000,2020-11-30,3,1,NE,US,4,1423
OUTLANDER 850,2020-11-30,13,11,NE,US,24,1485
OUTLANDER 450,2020-11-30,14,4,NE,US,18,1394
OUTLANDER 1000,2020-12-07,0,15,NE,US,15,1438
OUTLANDER 850,2020-12-07,8,6,NE,US,14,1499
OUTLANDER 450,2020-12-07,0,1,NE,US,1,1395
OUTLANDER 1000,2020-12-14,8,8,NE,US,16,1454
OUTLANDER 850,2020-12-14,15,4,NE,US,19,1518
OUTLANDER 450,2020-12-14,11,0,NE,US,11,1406
OUTLANDER 1000,2020-12-21,6,3,NE,US,9,1463
OUTLANDER 850,2020-12-21,7,2,NE,US,9,1527
OUTLANDER 450,2020-12-21,7,15,NE,US,22,1428
OUTLANDER 1000,2020-12-28,11,4,NE,US,15,1478
OUTLANDER 850,2020-12-28,0,8,NE,US,8,1535
OUTLANDER 450,2020-12-28,12,13,NE,US,25,1453
OUTLANDER 1000,2021-01-04,6,8,NE,US,14,1492
OUTLANDER 850,2021-01-04,5,7,NE,US,12,1547
OUTLANDER 450,2021-01-04,9,9,NE,US,18,1471
OUTLANDER 1000,2021-01-11,13,10,NE,US,23,1515
OUTLANDER 850,2021-01-11,10,3,NE,US,13,1560
OUTLANDER 450,2021-01-11,8,11,NE,US,19,1490
OUTLANDER 1000,2021-01-18,11,14,NE,US,25,1540
OUTLANDER 850,2021-01-18,8,11,NE,US,19,1579
OUTLANDER 450,2021-01-18,15,3,NE,US,18,1508
OUTLANDER 1000,2021-01-25,11,9,NE,US,20,1560
OUTLANDER 850,2021-01-25,1,11,NE,US,12,1591
OUTLANDER 450,2021-01-25,13,3,NE,US,16,1524
OUTLANDER 1000,2021-02-01,3,4,NE,US,7,1567
OUTLANDER 850,2021-02-01,8,2,NE,US,10,1601
OUTLANDER 450,2021-02-01,6,7,NE,US,13,1537
OUTLANDER 1000,2021-02-08,4,2,NE,US,6,1573
OUTLANDER 850,2021-02-08,12,12,NE,US,24,1625
OUTLANDER 450,2021-02-08,4,2,NE,US,6,1543
OUTLANDER 1000,2021-02-15,15,6,NE,US,21,1594
OUTLANDER 850,2021-02-15,3,0,NE,US,3,1628
OUTLANDER 450,2021-02-15,12,5,NE,US,17,1560
OUTLANDER 1000,2021-02-22,13,13,NE,US,26,1620
OUTLANDER 850,2021-02-22,3,10,NE,US,13,1641
OUTLANDER 450,2021-02-22,5,11,NE,US,16,1576
OUTLANDER 1000,2021-03-01,1,3,NE,US,4,1624
OUTLANDER 850,2021-03-01,0,12,NE,US,12,1653
OUTLANDER 450,2021-03-01,14,2,NE,US,16,1592
OUTLANDER 1000,2021-03-08,7,0,NE,US,7,1631
OUTLANDER 850,2021-03-08,5,4,NE,US,9,1662
OUTLANDER 450,2021-03-08,6,9,NE,US,15,1607
OUTLANDER 1000,2021-03-15,5,10,NE,US,15,1646
OUTLANDER 850,2021-03-15,15,0,NE,US,15,1677
OUTLANDER 450,2021-03-15,9,7,NE,US,16,1623
OUTLANDER 1000,2021-03-22,11,13,NE,US,24,1670
OUTLANDER 850,2021-03-22,0,6,NE,US,6,1683
OUTLANDER 450,2021-03-22,6,2,NE,US,8,1631
OUTLANDER 1000,2021-03-29,10,4,NE,US,14,1684
OUTLANDER 850,2021-03-29,3,4,NE,US,7,1690
OUTLANDER 450,2021-03-29,2,0,NE,US,2,1633
OUTLANDER 1000,2021-04-05,8,5,NE,US,13,1697
OUTLANDER 850,2021-04-05,3,14,NE,US,17,1707
OUTLANDER 450,2021-04-05,4,8,NE,US,12,1645
OUTLANDER 1000,2021-04-12,5,0,NE,US,5,1702
OUTLANDER 850,2021-04-12,11,6,NE,US,17,1724
OUTLANDER 450,2021-04-12,2,9,NE,US,11,1656
OUTLANDER 1000,2021-04-19,7,13,NE,US,20,1722
OUTLANDER 850,2021-04-19,7,14,NE,US,21,1745
OUTLANDER 450,2021-04-19,11,4,NE,US,15,1671
OUTLANDER 1000,2021-04-26,8,1,NE,US,9,1731
OUTLANDER 850,2021-04-26,3,7,NE,US,10,1755
OUTLANDER 450,2021-04-26,2,5,NE,US,7,1678
OUTLANDER 1000,2021-05-03,7,3,NE,US,10,1741
OUTLANDER 850,2021-05-03,4,7,NE,US,11,1766
OUTLANDER 450,2021-05-03,8,10,NE,US,18,1696
OUTLANDER 1000,2021-05-10,12,8,NE,US,20,1761
OUTLANDER 850,2021-05-10,3,4,NE,US,7,1773
OUTLANDER 450,2021-05-10,11,14,NE,US,25,1721
OUTLANDER 1000,2021-05-17,4,14,NE,US,18,1779
OUTLANDER 850,2021-05-17,3,12,NE,US,15,1788
OUTLANDER 450,2021-05-17,7,4,NE,US,11,1732
OUTLANDER 1000,2021-05-24,1,4,NE,US,5,1784
OUTLANDER 850,2021-05-24,10,0,NE,US,10,1798
OUTLANDER 450,2021-05-24,4,14,NE,US,18,1750
OUTLANDER 1000,2021-05-31,13,8,NE,US,21,1805
OUTLANDER 850,2021-05-31,10,4,NE,US,14,1812
OUTLANDER 450,2021-05-31,8,15,NE,US,23,1773
OUTLANDER 1000,2021-06-07,2,6,NE,US,8,1813
OUTLANDER 850,2021-06-07,7,11,NE,US,18,1830
OUTLANDER 450,2021-06-07,1,1,NE,US,2,1775
OUTLANDER 1000,2021-06-14,1,6,NE,US,7,1820
OUTLANDER 850,2021-06-14,6,9,NE,US,15,1845
OUTLANDER 450,2021-06-14,7,1,NE,US,8,1783
OUTLANDER 1000,2021-06-21,6,0,NE,US,6,1826
OUTLANDER 850,2021-06-21,7,9,NE,US,16,1861
OUTLANDER 450,2021-06-21,11,5,NE,US,16,1799
OUTLANDER 1000,2021-06-28,3,0,NE,US,3,1829
OUTLANDER 850,2021-06-28,5,11,NE,US,16,1877
OUTLANDER 450,2021-06-28,15,10,NE,US,25,1824
OUTLANDER 1000,2021-07-05,2,10,NE,US,12,1841
OUTLANDER 850,2021-07-05,7,9,NE,US,16,1893
OUTLANDER 450,2021-07-05,11,9,NE,US,20,1844
OUTLANDER 1000,2021-07-12,12,12,NE,US,24,1865
OUTLANDER 850,2021-07-12,3,13,NE,US,16,1909
OUTLANDER 450,2021-07-12,14,9,NE,US,23,1867
OUTLANDER 1000,2021-07-19,2,4,NE,US,6,1871
OUTLANDER 850,2021-07-19,12,3,NE,US,15,1924
OUTLANDER 450,2021-07-19,1,3,NE,US,4,1871
OUTLANDER 1000,2021-07-26,9,3,NE,US,12,1883
OUTLANDER 850,2021-07-26,10,7,NE,US,17,1941
OUTLANDER 450,2021-07-26,2,12,NE,US,14,1885
OUTLANDER 1000,2021-08-02,7,4,NE,US,11,1894
OUTLANDER 850,2021-08-02,9,5,NE,US,14,1955
OUTLANDER 450,2021-08-02,12,6,NE,US,18,1903
OUTLANDER 1000,2021-08-09,8,12,NE,US,20,1914
OUTLANDER 850,2021-08-09,14,4,NE,US,18,1973
OUTLANDER 450,2021-08-09,14,9,NE,US,23,1926
OUTLANDER 1000,2021-08-16,10,8,NE,US,18,1932
OUTLANDER 850,2021-08-16,13,7,NE,US,20,1993
OUTLANDER 450,2021-08-16,12,12,NE,US,24,1950
OUTLANDER 1000,2021-08-23,0,5,NE,US,5,1937
OUTLANDER 850,2021-08-23,10,15,NE,US,25,2018
OUTLANDER 450,2021-08-23,5,0,NE,US,5,1955
OUTLANDER 1000,2021-08-30,14,7,NE,US,21,1958
OUTLANDER 850,2021-08-30,4,8,NE,US,12,2030
OUTLANDER 450,2021-08-30,6,5,NE,US,11,1966
OUTLANDER 1000,2021-09-06,12,7,NE,US,19,1977
OUTLANDER 850,2021-09-06,2,14,NE,US,16,2046
OUTLANDER 450,2021-09-06,12,2,NE,US,14,1980
OUTLANDER 1000,2021-09-13,6,8,NE,US,14,1991
OUTLANDER 850,2021-09-13,2,10,NE,US,12,2058
OUTLANDER 450,2021-09-13,11,3,NE,US,14,1994
OUTLANDER 1000,2021-09-20,11,13,NE,US,24,2015
OUTLANDER 850,2021-09-20,6,9,NE,US,15,2073
OUTLANDER 450,2021-09-20,15,10,NE,US,25,2019
OUTLANDER 1000,2021-09-27,6,14,NE,US,20,2035
OUTLANDER 850,2021-09-27,6,9,NE,US,15,2088
OUTLANDER 450,2021-09-27,13,8,NE,US,21,2040
OUTLANDER 1000,2021-10-04,9,5,NE,US,14,2049
OUTLANDER 850,2021-10-04,10,11,NE,US,21,2109
OUTLANDER 450,2021-10-04,2,3,NE,US,5,2045
OUTLANDER 1000,2021-10-11,0,15,NE,US,15,2064
OUTLANDER 850,2021-10-11,2,9,NE,US,11,2120
OUTLANDER 450,2021-10-11,8,8,NE,US,16,2061
OUTLANDER 1000,2021-10-18,5,4,NE,US,9,2073
OUTLANDER 850,2021-10-18,0,11,NE,US,11,2131
OUTLANDER 450,2021-10-18,1,6,NE,US,7,2068
OUTLANDER 1000,2021-10-25,15,7,NE,US,22,2095
OUTLANDER 850,2021-10-25,7,14,NE,US,21,2152
OUTLANDER 450,2021-10-25,0,11,NE,US,11,2079
OUTLANDER 1000,2021-11-01,12,10,NE,US,22,2117
OUTLANDER 850,2021-11-01,14,14,NE,US,28,2180
OUTLANDER 450,2021-11-01,12,5,NE,US,17,2096
OUTLANDER 1000,2021-11-08,6,6,NE,US,12,2129
OUTLANDER 850,2021-11-08,5,2,NE,US,7,2187
OUTLANDER 450,2021-11-08,6,13,NE,US,19,2115
OUTLANDER 1000,2021-11-15,8,6,NE,US,14,2143
OUTLANDER 850,2021-11-15,2,12,NE,US,14,2201
OUTLANDER 450,2021-11-15,4,5,NE,US,9,2124
OUTLANDER 1000,2021-11-22,3,12,NE,US,15,2158
OUTLANDER 850,2021-11-22,12,5,NE,US,17,2218
OUTLANDER 450,2021-11-22,13,8,NE,US,21,2145
OUTLANDER 1000,2021-11-29,2,14,NE,US,16,2174
OUTLANDER 850,2021-11-29,8,6,NE,US,14,2232
OUTLANDER 450,2021-11-29,9,7,NE,US,16,2161
OUTLANDER 1000,2021-12-06,14,3,NE,US,17,2191
OUTLANDER 850,2021-12-06,9,8,NE,US,17,2249
OUTLANDER 450,2021-12-06,12,14,NE,US,26,2187
OUTLANDER 1000,2021-12-13,14,9,NE,US,23,2214
OUTLANDER 850,2021-12-13,13,6,NE,US,19,2268
OUTLANDER 450,2021-12-13,10,1,NE,US,11,2198
OUTLANDER 1000,2021-12-20,10,5,NE,US,15,2229
OUTLANDER 850,2021-12-20,6,5,NE,US,11,2279
OUTLANDER 450,2021-12-20,12,7,NE,US,19,2217
OUTLANDER 1000,2021-12-27,2,2,NE,US,4,2233
OUTLANDER 850,2021-12-27,2,13,NE,US,15,2294
OUTLANDER 450,2021-12-27,10,2,NE,US,12,2229
OUTLANDER 1000,2019-01-07,12,3,NV,US,15,15
OUTLANDER 850,2019-01-07,0,6,NV,US,6,6
OUTLANDER 450,2019-01-07,12,15,NV,US,27,27
OUTLANDER 1000,2019-01-14,14,15,NV,US,29,44
OUTLANDER 850,2019-01-14,14,10,NV,US,24,30
OUTLANDER 450,2019-01-14,13,4,NV,US,17,44
OUTLANDER 1000,2019-01-21,14,4,NV,US,18,62
OUTLANDER 850,2019-01-21,2,1,NV,US,3,33
OUTLANDER 450,2019-01-21,8,0,NV,US,8,52
OUTLANDER 1000,2019-01-28,11,11,NV,US,22,84
OUTLANDER 850,2019-01-28,0,11,NV,US,11,44
OUTLANDER 450,2019-01-28,4,7,NV,US,11,63
OUTLANDER 1000,2019-02-04,9,2,NV,US,11,95
OUTLANDER 850,2019-02-04,14,7,NV,US,21,65
OUTLANDER 450,2019-02-04,4,6,NV,US,10,73
OUTLANDER 1000,2019-02-11,15,12,NV,US,27,122
OUTLANDER 850,2019-02-11,3,0,NV,US,3,68
OUTLANDER 450,2019-02-11,7,4,NV,US,11,84
OUTLANDER 1000,2019-02-18,9,3,NV,US,12,134
OUTLANDER 850,2019-02-18,10,7,NV,US,17,85
OUTLANDER 450,2019-02-18,15,5,NV,US,20,104
OUTLANDER 1000,2019-02-25,3,13,NV,US,16,150
OUTLANDER 850,2019-02-25,3,0,NV,US,3,88
OUTLANDER 450,2019-02-25,4,14,NV,US,18,122
OUTLANDER 1000,2019-03-04,15,11,NV,US,26,176
OUTLANDER 850,2019-03-04,14,2,NV,US,16,104
OUTLANDER 450,2019-03-04,8,13,NV,US,21,143
OUTLANDER 1000,2019-03-11,8,2,NV,US,10,186
OUTLANDER 850,2019-03-11,1,11,NV,US,12,116
OUTLANDER 450,2019-03-11,8,14,NV,US,22,165
OUTLANDER 1000,2019-03-18,3,3,NV,US,6,192
OUTLANDER 850,2019-03-18,15,7,NV,US,22,138
OUTLANDER 450,2019-03-18,9,4,NV,US,13,178
OUTLANDER 1000,2019-03-25,4,2,NV,US,6,198
OUTLANDER 850,2019-03-25,12,3,NV,US,15,153
OUTLANDER 450,2019-03-25,9,8,NV,US,17,195
OUTLANDER 1000,2019-04-01,4,2,NV,US,6,204
OUTLANDER 850,2019-04-01,8,6,NV,US,14,167
OUTLANDER 450,2019-04-01,11,4,NV,US,15,210
OUTLANDER 1000,2019-04-08,12,5,NV,US,17,221
OUTLANDER 850,2019-04-08,8,8,NV,US,16,183
OUTLANDER 450,2019-04-08,13,2,NV,US,15,225
OUTLANDER 1000,2019-04-15,12,12,NV,US,24,245
OUTLANDER 850,2019-04-15,8,14,NV,US,22,205
OUTLANDER 450,2019-04-15,0,2,NV,US,2,227
OUTLANDER 1000,2019-04-22,3,3,NV,US,6,251
OUTLANDER 850,2019-04-22,11,7,NV,US,18,223
OUTLANDER 450,2019-04-22,12,10,NV,US,22,249
OUTLANDER 1000,2019-04-29,9,8,NV,US,17,268
OUTLANDER 850,2019-04-29,12,6,NV,US,18,241
OUTLANDER 450,2019-04-29,13,1,NV,US,14,263
OUTLANDER 1000,2019-05-06,1,6,NV,US,7,275
OUTLANDER 850,2019-05-06,10,6,NV,US,16,257
OUTLANDER 450,2019-05-06,3,8,NV,US,11,274
OUTLANDER 1000,2019-05-13,11,10,NV,US,21,296
OUTLANDER 850,2019-05-13,10,8,NV,US,18,275
OUTLANDER 450,2019-05-13,4,3,NV,US,7,281
OUTLANDER 1000,2019-05-20,2,13,NV,US,15,311
OUTLANDER 850,2019-05-20,10,9,NV,US,19,294
OUTLANDER 450,2019-05-20,12,3,NV,US,15,296
OUTLANDER 1000,2019-05-27,12,1,NV,US,13,324
OUTLANDER 850,2019-05-27,9,13,NV,US,22,316
OUTLANDER 450,2019-05-27,1,12,NV,US,13,309
OUTLANDER 1000,2019-06-03,7,2,NV,US,9,333
OUTLANDER 850,2019-06-03,4,10,NV,US,14,330
OUTLANDER 450,2019-06-03,10,10,NV,US,20,329
OUTLANDER 1000,2019-06-10,10,14,NV,US,24,357
OUTLANDER 850,2019-06-10,14,15,NV,US,29,359
OUTLANDER 450,2019-06-10,2,2,NV,US,4,333
OUTLANDER 1000,2019-06-17,6,10,NV,US,16,373
OUTLANDER 850,2019-06-17,1,3,NV,US,4,363
OUTLANDER 450,2019-06-17,8,1,NV,US,9,342
OUTLANDER 1000,2019-06-24,7,15,NV,US,22,395
OUTLANDER 850,2019-06-24,0,4,NV,US,4,367
OUTLANDER 450,2019-06-24,6,5,NV,US,11,353
OUTLANDER 1000,2019-07-01,9,14,NV,US,23,418
OUTLANDER 850,2019-07-01,9,10,NV,US,19,386
OUTLANDER 450,2019-07-01,7,1,NV,US,8,361
OUTLANDER 1000,2019-07-08,13,4,NV,US,17,435
OUTLANDER 850,2019-07-08,6,1,NV,US,7,393
OUTLANDER 450,2019-07-08,1,12,NV,US,13,374
OUTLANDER 1000,2019-07-15,5,8,NV,US,13,448
OUTLANDER 850,2019-07-15,13,8,NV,US,21,414
OUTLANDER 450,2019-07-15,12,7,NV,US,19,393
OUTLANDER 1000,2019-07-22,11,8,NV,US,19,467
OUTLANDER 850,2019-07-22,14,15,NV,US,29,443
OUTLANDER 450,2019-07-22,10,11,NV,US,21,414
OUTLANDER 1000,2019-07-29,4,3,NV,US,7,474
OUTLANDER 850,2019-07-29,6,5,NV,US,11,454
OUTLANDER 450,2019-07-29,3,10,NV,US,13,427
OUTLANDER 1000,2019-08-05,14,3,NV,US,17,491
OUTLANDER 850,2019-08-05,5,12,NV,US,17,471
OUTLANDER 450,2019-08-05,13,7,NV,US,20,447
OUTLANDER 1000,2019-08-12,4,13,NV,US,17,508
OUTLANDER 850,2019-08-12,6,3,NV,US,9,480
OUTLANDER 450,2019-08-12,10,13,NV,US,23,470
OUTLANDER 1000,2019-08-19,13,2,NV,US,15,523
OUTLANDER 850,2019-08-19,2,12,NV,US,14,494
OUTLANDER 450,2019-08-19,14,13,NV,US,27,497
OUTLANDER 1000,2019-08-26,9,11,NV,US,20,543
OUTLANDER 850,2019-08-26,2,3,NV,US,5,499
OUTLANDER 450,2019-08-26,2,5,NV,US,7,504
OUTLANDER 1000,2019-09-02,3,5,NV,US,8,551
OUTLANDER 850,2019-09-02,11,5,NV,US,16,515
OUTLANDER 450,2019-09-02,1,8,NV,US,9,513
OUTLANDER 1000,2019-09-09,13,2,NV,US,15,566
OUTLANDER 850,2019-09-09,6,12,NV,US,18,533
OUTLANDER 450,2019-09-09,2,14,NV,US,16,529
OUTLANDER 1000,2019-09-16,13,13,NV,US,26,592
OUTLANDER 850,2019-09-16,4,10,NV,US,14,547
OUTLANDER 450,2019-09-16,1,1,NV,US,2,531
OUTLANDER 1000,2019-09-23,0,10,NV,US,10,602
OUTLANDER 850,2019-09-23,0,1,NV,US,1,548
OUTLANDER 450,2019-09-23,9,7,NV,US,16,547
OUTLANDER 1000,2019-09-30,5,2,NV,US,7,609
OUTLANDER 850,2019-09-30,5,10,NV,US,15,563
OUTLANDER 450,2019-09-30,7,8,NV,US,15,562
OUTLANDER 1000,2019-10-07,5,11,NV,US,16,625
OUTLANDER 850,2019-10-07,4,1,NV,US,5,568
OUTLANDER 450,2019-10-07,14,14,NV,US,28,590
OUTLANDER 1000,2019-10-14,12,9,NV,US,21,646
OUTLANDER 850,2019-10-14,8,9,NV,US,17,585
OUTLANDER 450,2019-10-14,10,9,NV,US,19,609
OUTLANDER 1000,2019-10-21,7,7,NV,US,14,660
OUTLANDER 850,2019-10-21,3,9,NV,US,12,597
OUTLANDER 450,2019-10-21,8,9,NV,US,17,626
OUTLANDER 1000,2019-10-28,1,11,NV,US,12,672
OUTLANDER 850,2019-10-28,15,14,NV,US,29,626
OUTLANDER 450,2019-10-28,1,3,NV,US,4,630
OUTLANDER 1000,2019-11-04,2,7,NV,US,9,681
OUTLANDER 850,2019-11-04,3,2,NV,US,5,631
OUTLANDER 450,2019-11-04,11,10,NV,US,21,651
OUTLANDER 1000,2019-11-11,13,9,NV,US,22,703
OUTLANDER 850,2019-11-11,14,10,NV,US,24,655
OUTLANDER 450,2019-11-11,9,3,NV,US,12,663
OUTLANDER 1000,2019-11-18,9,2,NV,US,11,714
OUTLANDER 850,2019-11-18,14,3,NV,US,17,672
OUTLANDER 450,2019-11-18,1,14,NV,US,15,678
OUTLANDER 1000,2019-11-25,3,2,NV,US,5,719
OUTLANDER 850,2019-11-25,2,6,NV,US,8,680
OUTLANDER 450,2019-11-25,7,12,NV,US,19,697
OUTLANDER 1000,2019-12-02,4,1,NV,US,5,724
OUTLANDER 850,2019-12-02,10,4,NV,US,14,694
OUTLANDER 450,2019-12-02,14,3,NV,US,17,714
OUTLANDER 1000,2019-12-09,5,0,NV,US,5,729
OUTLANDER 850,2019-12-09,15,15,NV,US,30,724
OUTLANDER 450,2019-12-09,6,6,NV,US,12,726
OUTLANDER 1000,2019-12-16,9,12,NV,US,21,750
OUTLANDER 850,2019-12-16,1,3,NV,US,4,728
OUTLANDER 450,2019-12-16,6,4,NV,US,10,736
OUTLANDER 1000,2019-12-23,14,12,NV,US,26,776
OUTLANDER 850,2019-12-23,6,1,NV,US,7,735
OUTLANDER 450,2019-12-23,3,5,NV,US,8,744
OUTLANDER 1000,2019-12-30,6,12,NV,US,18,794
OUTLANDER 850,2019-12-30,8,9,NV,US,17,752
OUTLANDER 450,2019-12-30,10,5,NV,US,15,759
OUTLANDER 1000,2020-01-06,2,6,NV,US,8,802
OUTLANDER 850,2020-01-06,7,7,NV,US,14,766
OUTLANDER 450,2020-01-06,7,14,NV,US,21,780
OUTLANDER 1000,2020-01-13,6,14,NV,US,20,822
OUTLANDER 850,2020-01-13,5,4,NV,US,9,775
OUTLANDER 450,2020-01-13,14,10,NV,US,24,804
OUTLANDER 1000,2020-01-20,4,7,NV,US,11,833
OUTLANDER 850,2020-01-20,7,3,NV,US,10,785
OUTLANDER 450,2020-01-20,6,3,NV,US,9,813
OUTLANDER 1000,2020-01-27,12,15,NV,US,27,860
OUTLANDER 850,2020-01-27,9,0,NV,US,9,794
OUTLANDER 450,2020-01-27,8,9,NV,US,17,830
OUTLANDER 1000,2020-02-03,5,7,NV,US,12,872
OUTLANDER 850,2020-02-03,6,2,NV,US,8,802
OUTLANDER 450,2020-02-03,15,9,NV,US,24,854
OUTLANDER 1000,2020-02-10,14,4,NV,US,18,890
OUTLANDER 850,2020-02-10,10,6,NV,US,16,818
OUTLANDER 450,2020-02-10,13,5,NV,US,18,872
OUTLANDER 1000,2020-02-17,1,2,NV,US,3,893
OUTLANDER 850,2020-02-17,10,5,NV,US,15,833
OUTLANDER 450,2020-02-17,2,6,NV,US,8,880
OUTLANDER 1000,2020-02-24,13,8,NV,US,21,914
OUTLANDER 850,2020-02-24,12,7,NV,US,19,852
OUTLANDER 450,2020-02-24,2,11,NV,US,13,893
OUTLANDER 1000,2020-03-02,15,8,NV,US,23,937
OUTLANDER 850,2020-03-02,15,4,NV,US,19,871
OUTLANDER 450,2020-03-02,6,11,NV,US,17,910
OUTLANDER 1000,2020-03-09,14,14,NV,US,28,965
OUTLANDER 850,2020-03-09,2,10,NV,US,12,883
OUTLANDER 450,2020-03-09,10,8,NV,US,18,928
OUTLANDER 1000,2020-03-16,5,5,NV,US,10,975
OUTLANDER 850,2020-03-16,14,4,NV,US,18,901
OUTLANDER 450,2020-03-16,7,2,NV,US,9,937
OUTLANDER 1000,2020-03-23,12,1,NV,US,13,988
OUTLANDER 850,2020-03-23,7,14,NV,US,21,922
OUTLANDER 450,2020-03-23,6,0,NV,US,6,943
OUTLANDER 1000,2020-03-30,4,5,NV,US,9,997
OUTLANDER 850,2020-03-30,7,5,NV,US,12,934
OUTLANDER 450,2020-03-30,4,9,NV,US,13,956
OUTLANDER 1000,2020-04-06,15,5,NV,US,20,1017
OUTLANDER 850,2020-04-06,10,13,NV,US,23,957
OUTLANDER 450,2020-04-06,1,9,NV,US,10,966
OUTLANDER 1000,2020-04-13,14,2,NV,US,16,1033
OUTLANDER 850,2020-04-13,13,12,NV,US,25,982
OUTLANDER 450,2020-04-13,12,2,NV,US,14,980
OUTLANDER 1000,2020-04-20,5,14,NV,US,19,1052
OUTLANDER 850,2020-04-20,14,8,NV,US,22,1004
OUTLANDER 450,2020-04-20,1,6,NV,US,7,987
OUTLANDER 1000,2020-04-27,12,12,NV,US,24,1076
OUTLANDER 850,2020-04-27,6,6,NV,US,12,1016
OUTLANDER 450,2020-04-27,13,3,NV,US,16,1003
OUTLANDER 1000,2020-05-04,9,13,NV,US,22,1098
OUTLANDER 850,2020-05-04,8,9,NV,US,17,1033
OUTLANDER 450,2020-05-04,6,9,NV,US,15,1018
OUTLANDER 1000,2020-05-11,9,5,NV,US,14,1112
OUTLANDER 850,2020-05-11,8,0,NV,US,8,1041
OUTLANDER 450,2020-05-11,10,7,NV,US,17,1035
OUTLANDER 1000,2020-05-18,3,12,NV,US,15,1127
OUTLANDER 850,2020-05-18,8,9,NV,US,17,1058
OUTLANDER 450,2020-05-18,4,1,NV,US,5,1040
OUTLANDER 1000,2020-05-25,3,13,NV,US,16,1143
OUTLANDER 850,2020-05-25,15,0,NV,US,15,1073
OUTLANDER 450,2020-05-25,10,5,NV,US,15,1055
OUTLANDER 1000,2020-06-01,9,12,NV,US,21,1164
OUTLANDER 850,2020-06-01,7,2,NV,US,9,1082
OUTLANDER 450,2020-06-01,15,12,NV,US,27,1082
OUTLANDER 1000,2020-06-08,11,14,NV,US,25,1189
OUTLANDER 850,2020-06-08,6,13,NV,US,19,1101
OUTLANDER 450,2020-06-08,14,7,NV,US,21,1103
OUTLANDER 1000,2020-06-15,0,4,NV,US,4,1193
OUTLANDER 850,2020-06-15,8,6,NV,US,14,1115
OUTLANDER 450,2020-06-15,3,15,NV,US,18,1121
OUTLANDER 1000,2020-06-22,2,11,NV,US,13,1206
OUTLANDER 850,2020-06-22,6,11,NV,US,17,1132
OUTLANDER 450,2020-06-22,3,12,NV,US,15,1136
OUTLANDER 1000,2020-06-29,8,12,NV,US,20,1226
OUTLANDER 850,2020-06-29,4,14,NV,US,18,1150
OUTLANDER 450,2020-06-29,7,12,NV,US,19,1155
OUTLANDER 1000,2020-07-06,10,1,NV,US,11,1237
OUTLANDER 850,2020-07-06,6,1,NV,US,7,1157
OUTLANDER 450,2020-07-06,1,7,NV,US,8,1163
OUTLANDER 1000,2020-07-13,11,4,NV,US,15,1252
OUTLANDER 850,2020-07-13,0,2,NV,US,2,1159
OUTLANDER 450,2020-07-13,5,10,NV,US,15,1178
OUTLANDER 1000,2020-07-20,1,10,NV,US,11,1263
OUTLANDER 850,2020-07-20,13,11,NV,US,24,1183
OUTLANDER 450,2020-07-20,8,14,NV,US,22,1200
OUTLANDER 1000,2020-07-27,3,6,NV,US,9,1272
OUTLANDER 850,2020-07-27,4,4,NV,US,8,1191
OUTLANDER 450,2020-07-27,7,11,NV,US,18,1218
OUTLANDER 1000,2020-08-03,3,9,NV,US,12,1284
OUTLANDER 850,2020-08-03,3,6,NV,US,9,1200
OUTLANDER 450,2020-08-03,6,13,NV,US,19,1237
OUTLANDER 1000,2020-08-10,4,14,NV,US,18,1302
OUTLANDER 850,2020-08-10,13,7,NV,US,20,1220
OUTLANDER 450,2020-08-10,2,2,NV,US,4,1241
OUTLANDER 1000,2020-08-17,2,3,NV,US,5,1307
OUTLANDER 850,2020-08-17,12,0,NV,US,12,1232
OUTLANDER 450,2020-08-17,4,13,NV,US,17,1258
OUTLANDER 1000,2020-08-24,12,0,NV,US,12,1319
OUTLANDER 850,2020-08-24,1,11,NV,US,12,1244
OUTLANDER 450,2020-08-24,8,9,NV,US,17,1275
OUTLANDER 1000,2020-08-31,2,7,NV,US,9,1328
OUTLANDER 850,2020-08-31,6,11,NV,US,17,1261
OUTLANDER 450,2020-08-31,15,14,NV,US,29,1304
OUTLANDER 1000,2020-09-07,5,1,NV,US,6,1334
OUTLANDER 850,2020-09-07,1,4,NV,US,5,1266
OUTLANDER 450,2020-09-07,4,13,NV,US,17,1321
OUTLANDER 1000,2020-09-14,1,14,NV,US,15,1349
OUTLANDER 850,2020-09-14,13,13,NV,US,26,1292
OUTLANDER 450,2020-09-14,4,5,NV,US,9,1330
OUTLANDER 1000,2020-09-21,2,11,NV,US,13,1362
OUTLANDER 850,2020-09-21,4,4,NV,US,8,1300
OUTLANDER 450,2020-09-21,9,14,NV,US,23,1353
OUTLANDER 1000,2020-09-28,8,5,NV,US,13,1375
OUTLANDER 850,2020-09-28,1,9,NV,US,10,1310
OUTLANDER 450,2020-09-28,1,10,NV,US,11,1364
OUTLANDER 1000,2020-10-05,4,5,NV,US,9,1384
OUTLANDER 850,2020-10-05,10,9,NV,US,19,1329
OUTLANDER 450,2020-10-05,1,14,NV,US,15,1379
OUTLANDER 1000,2020-10-12,11,6,NV,US,17,1401
OUTLANDER 850,2020-10-12,14,11,NV,US,25,1354
OUTLANDER 450,2020-10-12,10,14,NV,US,24,1403
OUTLANDER 1000,2020-10-19,5,2,NV,US,7,1408
OUTLANDER 850,2020-10-19,0,15,NV,US,15,1369
OUTLANDER 450,2020-10-19,10,11,NV,US,21,1424
OUTLANDER 1000,2020-10-26,1,2,NV,US,3,1411
OUTLANDER 850,2020-10-26,14,15,NV,US,29,1398
OUTLANDER 450,2020-10-26,12,12,NV,US,24,1448
OUTLANDER 1000,2020-11-02,15,9,NV,US,24,1435
OUTLANDER 850,2020-11-02,13,6,NV,US,19,1417
OUTLANDER 450,2020-11-02,9,10,NV,US,19,1467
OUTLANDER 1000,2020-11-09,8,3,NV,US,11,1446
OUTLANDER 850,2020-11-09,2,8,NV,US,10,1427
OUTLANDER 450,2020-11-09,7,0,NV,US,7,1474
OUTLANDER 1000,2020-11-16,5,2,NV,US,7,1453
OUTLANDER 850,2020-11-16,2,9,NV,US,11,1438
OUTLANDER 450,2020-11-16,13,8,NV,US,21,1495
OUTLANDER 1000,2020-11-23,5,4,NV,US,9,1462
OUTLANDER 850,2020-11-23,4,2,NV,US,6,1444
OUTLANDER 450,2020-11-23,2,5,NV,US,7,1502
OUTLANDER 1000,2020-11-30,15,1,NV,US,16,1478
OUTLANDER 850,2020-11-30,5,13,NV,US,18,1462
OUTLANDER 450,2020-11-30,11,15,NV,US,26,1528
OUTLANDER 1000,2020-12-07,2,9,NV,US,11,1489
OUTLANDER 850,2020-12-07,4,0,NV,US,4,1466
OUTLANDER 450,2020-12-07,3,11,NV,US,14,1542
OUTLANDER 1000,2020-12-14,8,3,NV,US,11,1500
OUTLANDER 850,2020-12-14,4,13,NV,US,17,1483
OUTLANDER 450,2020-12-14,6,2,NV,US,8,1550
OUTLANDER 1000,2020-12-21,7,0,NV,US,7,1507
OUTLANDER 850,2020-12-21,6,3,NV,US,9,1492
OUTLANDER 450,2020-12-21,1,5,NV,US,6,1556
OUTLANDER 1000,2020-12-28,8,10,NV,US,18,1525
OUTLANDER 850,2020-12-28,3,3,NV,US,6,1498
OUTLANDER 450,2020-12-28,1,2,NV,US,3,1559
OUTLANDER 1000,2021-01-04,1,4,NV,US,5,1530
OUTLANDER 850,2021-01-04,13,1,NV,US,14,1512
OUTLANDER 450,2021-01-04,13,14,NV,US,27,1586
OUTLANDER 1000,2021-01-11,5,8,NV,US,13,1543
OUTLANDER 850,2021-01-11,13,1,NV,US,14,1526
OUTLANDER 450,2021-01-11,3,10,NV,US,13,1599
OUTLANDER 1000,2021-01-18,11,14,NV,US,25,1568
OUTLANDER 850,2021-01-18,6,12,NV,US,18,1544
OUTLANDER 450,2021-01-18,5,7,NV,US,12,1611
OUTLANDER 1000,2021-01-25,0,6,NV,US,6,1574
OUTLANDER 850,2021-01-25,2,6,NV,US,8,1552
OUTLANDER 450,2021-01-25,2,5,NV,US,7,1618
OUTLANDER 1000,2021-02-01,2,11,NV,US,13,1587
OUTLANDER 850,2021-02-01,12,10,NV,US,22,1574
OUTLANDER 450,2021-02-01,7,8,NV,US,15,1633
OUTLANDER 1000,2021-02-08,1,0,NV,US,1,1588
OUTLANDER 850,2021-02-08,3,14,NV,US,17,1591
OUTLANDER 450,2021-02-08,10,4,NV,US,14,1647
OUTLANDER 1000,2021-02-15,12,15,NV,US,27,1615
OUTLANDER 850,2021-02-15,1,8,NV,US,9,1600
OUTLANDER 450,2021-02-15,9,11,NV,US,20,1667
OUTLANDER 1000,2021-02-22,6,4,NV,US,10,1625
OUTLANDER 850,2021-02-22,0,1,NV,US,1,1601
OUTLANDER 450,2021-02-22,9,8,NV,US,17,1684
OUTLANDER 1000,2021-03-01,7,0,NV,US,7,1632
OUTLANDER 850,2021-03-01,5,3,NV,US,8,1609
OUTLANDER 450,2021-03-01,9,1,NV,US,10,1694
OUTLANDER 1000,2021-03-08,15,10,NV,US,25,1657
OUTLANDER 850,2021-03-08,8,15,NV,US,23,1632
OUTLANDER 450,2021-03-08,13,7,NV,US,20,1714
OUTLANDER 1000,2021-03-15,0,13,NV,US,13,1670
OUTLANDER 850,2021-03-15,4,14,NV,US,18,1650
OUTLANDER 450,2021-03-15,8,8,NV,US,16,1730
OUTLANDER 1000,2021-03-22,4,3,NV,US,7,1677
OUTLANDER 850,2021-03-22,9,2,NV,US,11,1661
OUTLANDER 450,2021-03-22,14,1,NV,US,15,1745
OUTLANDER 1000,2021-03-29,6,7,NV,US,13,1690
OUTLANDER 850,2021-03-29,9,4,NV,US,13,1674
OUTLANDER 450,2021-03-29,13,13,NV,US,26,1771
OUTLANDER 1000,2021-04-05,3,2,NV,US,5,1695
OUTLANDER 850,2021-04-05,4,5,NV,US,9,1683
OUTLANDER 450,2021-04-05,4,7,NV,US,11,1782
OUTLANDER 1000,2021-04-12,15,5,NV,US,20,1715
OUTLANDER 850,2021-04-12,1,11,NV,US,12,1695
OUTLANDER 450,2021-04-12,13,13,NV,US,26,1808
OUTLANDER 1000,2021-04-19,8,3,NV,US,11,1726
OUTLANDER 850,2021-04-19,11,13,NV,US,24,1719
OUTLANDER 450,2021-04-19,6,5,NV,US,11,1819
OUTLANDER 1000,2021-04-26,7,1,NV,US,8,1734
OUTLANDER 850,2021-04-26,8,6,NV,US,14,1733
OUTLANDER 450,2021-04-26,0,7,NV,US,7,1826
OUTLANDER 1000,2021-05-03,6,4,NV,US,10,1744
OUTLANDER 850,2021-05-03,3,9,NV,US,12,1745
OUTLANDER 450,2021-05-03,15,4,NV,US,19,1845
OUTLANDER 1000,2021-05-10,11,9,NV,US,20,1764
OUTLANDER 850,2021-05-10,9,2,NV,US,11,1756
OUTLANDER 450,2021-05-10,5,12,NV,US,17,1862
OUTLANDER 1000,2021-05-17,10,2,NV,US,12,1776
OUTLANDER 850,2021-05-17,1,10,NV,US,11,1767
OUTLANDER 450,2021-05-17,12,13,NV,US,25,1887
OUTLANDER 1000,2021-05-24,8,11,NV,US,19,1795
OUTLANDER 850,2021-05-24,7,3,NV,US,10,1777
OUTLANDER 450,2021-05-24,5,12,NV,US,17,1904
OUTLANDER 1000,2021-05-31,3,6,NV,US,9,1804
OUTLANDER 850,2021-05-31,12,3,NV,US,15,1792
OUTLANDER 450,2021-05-31,9,1,NV,US,10,1914
OUTLANDER 1000,2021-06-07,9,2,NV,US,11,1815
OUTLANDER 850,2021-06-07,2,6,NV,US,8,1800
OUTLANDER 450,2021-06-07,13,0,NV,US,13,1927
OUTLANDER 1000,2021-06-14,2,6,NV,US,8,1823
OUTLANDER 850,2021-06-14,13,4,NV,US,17,1817
OUTLANDER 450,2021-06-14,5,15,NV,US,20,1947
OUTLANDER 1000,2021-06-21,14,3,NV,US,17,1840
OUTLANDER 850,2021-06-21,10,0,NV,US,10,1827
OUTLANDER 450,2021-06-21,6,13,NV,US,19,1966
OUTLANDER 1000,2021-06-28,11,6,NV,US,17,1857
OUTLANDER 850,2021-06-28,15,1,NV,US,16,1843
OUTLANDER 450,2021-06-28,1,7,NV,US,8,1974
OUTLANDER 1000,2021-07-05,7,0,NV,US,7,1864
OUTLANDER 850,2021-07-05,13,12,NV,US,25,1868
OUTLANDER 450,2021-07-05,7,14,NV,US,21,1995
OUTLANDER 1000,2021-07-12,4,9,NV,US,13,1877
OUTLANDER 850,2021-07-12,10,5,NV,US,15,1883
OUTLANDER 450,2021-07-12,13,15,NV,US,28,2023
OUTLANDER 1000,2021-07-19,4,2,NV,US,6,1883
OUTLANDER 850,2021-07-19,9,2,NV,US,11,1894
OUTLANDER 450,2021-07-19,8,11,NV,US,19,2042
OUTLANDER 1000,2021-07-26,12,4,NV,US,16,1899
OUTLANDER 850,2021-07-26,4,5,NV,US,9,1903
OUTLANDER 450,2021-07-26,2,3,NV,US,5,2047
OUTLANDER 1000,2021-08-02,5,14,NV,US,19,1918
OUTLANDER 850,2021-08-02,4,9,NV,US,13,1916
OUTLANDER 450,2021-08-02,12,7,NV,US,19,2066
OUTLANDER 1000,2021-08-09,7,14,NV,US,21,1939
OUTLANDER 850,2021-08-09,14,1,NV,US,15,1931
OUTLANDER 450,2021-08-09,0,9,NV,US,9,2075
OUTLANDER 1000,2021-08-16,9,1,NV,US,10,1949
OUTLANDER 850,2021-08-16,8,7,NV,US,15,1946
OUTLANDER 450,2021-08-16,4,3,NV,US,7,2082
OUTLANDER 1000,2021-08-23,5,3,NV,US,8,1957
OUTLANDER 850,2021-08-23,10,1,NV,US,11,1957
OUTLANDER 450,2021-08-23,15,6,NV,US,21,2103
OUTLANDER 1000,2021-08-30,2,3,NV,US,5,1962
OUTLANDER 850,2021-08-30,2,13,NV,US,15,1972
OUTLANDER 450,2021-08-30,4,12,NV,US,16,2119
OUTLANDER 1000,2021-09-06,12,7,NV,US,19,1981
OUTLANDER 850,2021-09-06,4,2,NV,US,6,1978
OUTLANDER 450,2021-09-06,3,14,NV,US,17,2136
OUTLANDER 1000,2021-09-13,14,3,NV,US,17,1998
OUTLANDER 850,2021-09-13,2,10,NV,US,12,1990
OUTLANDER 450,2021-09-13,6,5,NV,US,11,2147
OUTLANDER 1000,2021-09-20,9,0,NV,US,9,2007
OUTLANDER 850,2021-09-20,14,5,NV,US,19,2009
OUTLANDER 450,2021-09-20,15,11,NV,US,26,2173
OUTLANDER 1000,2021-09-27,10,9,NV,US,19,2026
OUTLANDER 850,2021-09-27,7,9,NV,US,16,2025
OUTLANDER 450,2021-09-27,8,14,NV,US,22,2195
OUTLANDER 1000,2021-10-04,4,0,NV,US,4,2030
OUTLANDER 850,2021-10-04,2,14,NV,US,16,2041
OUTLANDER 450,2021-10-04,3,14,NV,US,17,2212
OUTLANDER 1000,2021-10-11,9,14,NV,US,23,2053
OUTLANDER 850,2021-10-11,4,0,NV,US,4,2045
OUTLANDER 450,2021-10-11,6,9,NV,US,15,2227
OUTLANDER 1000,2021-10-18,15,2,NV,US,17,2070
OUTLANDER 850,2021-10-18,5,2,NV,US,7,2052
OUTLANDER 450,2021-10-18,10,13,NV,US,23,2250
OUTLANDER 1000,2021-10-25,8,7,NV,US,15,2085
OUTLANDER 850,2021-10-25,3,3,NV,US,6,2058
OUTLANDER 450,2021-10-25,13,2,NV,US,15,2265
OUTLANDER 1000,2021-11-01,7,15,NV,US,22,2107
OUTLANDER 850,2021-11-01,10,12,NV,US,22,2080
OUTLANDER 450,2021-11-01,1,6,NV,US,7,2272
OUTLANDER 1000,2021-11-08,4,8,NV,US,12,2119
OUTLANDER 850,2021-11-08,3,13,NV,US,16,2096
OUTLANDER 450,2021-11-08,12,10,NV,US,22,2294
OUTLANDER 1000,2021-11-15,9,2,NV,US,11,2130
OUTLANDER 850,2021-11-15,8,11,NV,US,19,2115
OUTLANDER 450,2021-11-15,12,5,NV,US,17,2311
OUTLANDER 1000,2021-11-22,12,15,NV,US,27,2157
OUTLANDER 850,2021-11-22,2,13,NV,US,15,2130
OUTLANDER 450,2021-11-22,4,13,NV,US,17,2328
OUTLANDER 1000,2021-11-29,8,9,NV,US,17,2174
OUTLANDER 850,2021-11-29,14,13,NV,US,27,2157
OUTLANDER 450,2021-11-29,6,15,NV,US,21,2349
OUTLANDER 1000,2021-12-06,2,5,NV,US,7,2181
OUTLANDER 850,2021-12-06,4,2,NV,US,6,2163
OUTLANDER 450,2021-12-06,6,9,NV,US,15,2364
OUTLANDER 1000,2021-12-13,1,6,NV,US,7,2188
OUTLANDER 850,2021-12-13,12,1,NV,US,13,2176
OUTLANDER 450,2021-12-13,12,2,NV,US,14,2378
OUTLANDER 1000,2021-12-20,13,8,NV,US,21,2209
OUTLANDER 850,2021-12-20,8,14,NV,US,22,2198
OUTLANDER 450,2021-12-20,6,10,NV,US,16,2394
OUTLANDER 1000,2021-12-27,2,9,NV,US,11,2220
OUTLANDER 850,2021-12-27,7,4,NV,US,11,2209
OUTLANDER 450,2021-12-27,14,7,NV,US,21,2415
OUTLANDER 1000,2019-01-07,7,11,NH,US,18,18
OUTLANDER 850,2019-01-07,8,14,NH,US,22,22
OUTLANDER 450,2019-01-07,4,11,NH,US,15,15
OUTLANDER 1000,2019-01-14,4,6,NH,US,10,28
OUTLANDER 850,2019-01-14,0,15,NH,US,15,37
OUTLANDER 450,2019-01-14,0,3,NH,US,3,18
OUTLANDER 1000,2019-01-21,11,2,NH,US,13,41
OUTLANDER 850,2019-01-21,12,7,NH,US,19,56
OUTLANDER 450,2019-01-21,10,5,NH,US,15,33
OUTLANDER 1000,2019-01-28,8,6,NH,US,14,55
OUTLANDER 850,2019-01-28,11,6,NH,US,17,73
OUTLANDER 450,2019-01-28,5,7,NH,US,12,45
OUTLANDER 1000,2019-02-04,10,5,NH,US,15,70
OUTLANDER 850,2019-02-04,4,9,NH,US,13,86
OUTLANDER 450,2019-02-04,11,9,NH,US,20,65
OUTLANDER 1000,2019-02-11,7,0,NH,US,7,77
OUTLANDER 850,2019-02-11,10,4,NH,US,14,100
OUTLANDER 450,2019-02-11,2,2,NH,US,4,69
OUTLANDER 1000,2019-02-18,4,3,NH,US,7,84
OUTLANDER 850,2019-02-18,11,7,NH,US,18,118
OUTLANDER 450,2019-02-18,11,8,NH,US,19,88
OUTLANDER 1000,2019-02-25,11,8,NH,US,19,103
OUTLANDER 850,2019-02-25,5,2,NH,US,7,125
OUTLANDER 450,2019-02-25,5,10,NH,US,15,103
OUTLANDER 1000,2019-03-04,12,13,NH,US,25,128
OUTLANDER 850,2019-03-04,2,2,NH,US,4,129
OUTLANDER 450,2019-03-04,1,15,NH,US,16,119
OUTLANDER 1000,2019-03-11,5,5,NH,US,10,138
OUTLANDER 850,2019-03-11,5,9,NH,US,14,143
OUTLANDER 450,2019-03-11,8,0,NH,US,8,127
OUTLANDER 1000,2019-03-18,9,4,NH,US,13,151
OUTLANDER 850,2019-03-18,12,8,NH,US,20,163
OUTLANDER 450,2019-03-18,3,4,NH,US,7,134
OUTLANDER 1000,2019-03-25,1,7,NH,US,8,159
OUTLANDER 850,2019-03-25,13,5,NH,US,18,181
OUTLANDER 450,2019-03-25,11,11,NH,US,22,156
OUTLANDER 1000,2019-04-01,8,4,NH,US,12,171
OUTLANDER 850,2019-04-01,12,4,NH,US,16,197
OUTLANDER 450,2019-04-01,6,14,NH,US,20,176
OUTLANDER 1000,2019-04-08,12,13,NH,US,25,196
OUTLANDER 850,2019-04-08,4,3,NH,US,7,204
OUTLANDER 450,2019-04-08,3,11,NH,US,14,190
OUTLANDER 1000,2019-04-15,11,11,NH,US,22,218
OUTLANDER 850,2019-04-15,6,12,NH,US,18,222
OUTLANDER 450,2019-04-15,2,12,NH,US,14,204
OUTLANDER 1000,2019-04-22,8,3,NH,US,11,229
OUTLANDER 850,2019-04-22,0,0,NH,US,0,222
OUTLANDER 450,2019-04-22,13,2,NH,US,15,219
OUTLANDER 1000,2019-04-29,9,12,NH,US,21,250
OUTLANDER 850,2019-04-29,13,7,NH,US,20,242
OUTLANDER 450,2019-04-29,9,7,NH,US,16,235
OUTLANDER 1000,2019-05-06,12,8,NH,US,20,270
OUTLANDER 850,2019-05-06,8,2,NH,US,10,252
OUTLANDER 450,2019-05-06,11,13,NH,US,24,259
OUTLANDER 1000,2019-05-13,2,5,NH,US,7,277
OUTLANDER 850,2019-05-13,14,11,NH,US,25,277
OUTLANDER 450,2019-05-13,0,5,NH,US,5,264
OUTLANDER 1000,2019-05-20,1,8,NH,US,9,286
OUTLANDER 850,2019-05-20,9,1,NH,US,10,287
OUTLANDER 450,2019-05-20,13,5,NH,US,18,282
OUTLANDER 1000,2019-05-27,4,13,NH,US,17,303
OUTLANDER 850,2019-05-27,13,10,NH,US,23,310
OUTLANDER 450,2019-05-27,1,1,NH,US,2,284
OUTLANDER 1000,2019-06-03,1,2,NH,US,3,306
OUTLANDER 850,2019-06-03,2,10,NH,US,12,322
OUTLANDER 450,2019-06-03,6,7,NH,US,13,297
OUTLANDER 1000,2019-06-10,0,14,NH,US,14,320
OUTLANDER 850,2019-06-10,10,7,NH,US,17,339
OUTLANDER 450,2019-06-10,11,4,NH,US,15,312
OUTLANDER 1000,2019-06-17,13,4,NH,US,17,337
OUTLANDER 850,2019-06-17,12,9,NH,US,21,360
OUTLANDER 450,2019-06-17,10,14,NH,US,24,336
OUTLANDER 1000,2019-06-24,5,14,NH,US,19,356
OUTLANDER 850,2019-06-24,13,11,NH,US,24,384
OUTLANDER 450,2019-06-24,12,4,NH,US,16,352
OUTLANDER 1000,2019-07-01,10,6,NH,US,16,372
OUTLANDER 850,2019-07-01,8,7,NH,US,15,399
OUTLANDER 450,2019-07-01,2,3,NH,US,5,357
OUTLANDER 1000,2019-07-08,4,1,NH,US,5,377
OUTLANDER 850,2019-07-08,1,13,NH,US,14,413
OUTLANDER 450,2019-07-08,15,15,NH,US,30,387
OUTLANDER 1000,2019-07-15,14,8,NH,US,22,399
OUTLANDER 850,2019-07-15,13,2,NH,US,15,428
OUTLANDER 450,2019-07-15,2,6,NH,US,8,395
OUTLANDER 1000,2019-07-22,8,11,NH,US,19,418
OUTLANDER 850,2019-07-22,1,11,NH,US,12,440
OUTLANDER 450,2019-07-22,7,10,NH,US,17,412
OUTLANDER 1000,2019-07-29,10,14,NH,US,24,442
OUTLANDER 850,2019-07-29,12,12,NH,US,24,464
OUTLANDER 450,2019-07-29,0,10,NH,US,10,422
OUTLANDER 1000,2019-08-05,12,13,NH,US,25,467
OUTLANDER 850,2019-08-05,4,8,NH,US,12,476
OUTLANDER 450,2019-08-05,3,4,NH,US,7,429
OUTLANDER 1000,2019-08-12,11,11,NH,US,22,489
OUTLANDER 850,2019-08-12,15,10,NH,US,25,501
OUTLANDER 450,2019-08-12,15,10,NH,US,25,454
OUTLANDER 1000,2019-08-19,6,11,NH,US,17,506
OUTLANDER 850,2019-08-19,14,5,NH,US,19,520
OUTLANDER 450,2019-08-19,7,13,NH,US,20,474
OUTLANDER 1000,2019-08-26,3,12,NH,US,15,521
OUTLANDER 850,2019-08-26,14,9,NH,US,23,543
OUTLANDER 450,2019-08-26,4,3,NH,US,7,481
OUTLANDER 1000,2019-09-02,9,8,NH,US,17,538
OUTLANDER 850,2019-09-02,15,3,NH,US,18,561
OUTLANDER 450,2019-09-02,5,9,NH,US,14,495
OUTLANDER 1000,2019-09-09,11,13,NH,US,24,562
OUTLANDER 850,2019-09-09,13,1,NH,US,14,575
OUTLANDER 450,2019-09-09,5,5,NH,US,10,505
OUTLANDER 1000,2019-09-16,5,14,NH,US,19,581
OUTLANDER 850,2019-09-16,0,13,NH,US,13,588
OUTLANDER 450,2019-09-16,4,4,NH,US,8,513
OUTLANDER 1000,2019-09-23,4,9,NH,US,13,594
OUTLANDER 850,2019-09-23,2,7,NH,US,9,597
OUTLANDER 450,2019-09-23,7,13,NH,US,20,533
OUTLANDER 1000,2019-09-30,13,12,NH,US,25,619
OUTLANDER 850,2019-09-30,8,1,NH,US,9,606
OUTLANDER 450,2019-09-30,9,10,NH,US,19,552
OUTLANDER 1000,2019-10-07,13,14,NH,US,27,646
OUTLANDER 850,2019-10-07,7,12,NH,US,19,625
OUTLANDER 450,2019-10-07,8,7,NH,US,15,567
OUTLANDER 1000,2019-10-14,10,13,NH,US,23,669
OUTLANDER 850,2019-10-14,11,13,NH,US,24,649
OUTLANDER 450,2019-10-14,3,12,NH,US,15,582
OUTLANDER 1000,2019-10-21,11,12,NH,US,23,692
OUTLANDER 850,2019-10-21,2,1,NH,US,3,652
OUTLANDER 450,2019-10-21,14,3,NH,US,17,599
OUTLANDER 1000,2019-10-28,9,1,NH,US,10,702
OUTLANDER 850,2019-10-28,7,12,NH,US,19,671
OUTLANDER 450,2019-10-28,2,10,NH,US,12,611
OUTLANDER 1000,2019-11-04,14,1,NH,US,15,717
OUTLANDER 850,2019-11-04,7,0,NH,US,7,678
OUTLANDER 450,2019-11-04,6,2,NH,US,8,619
OUTLANDER 1000,2019-11-11,8,12,NH,US,20,737
OUTLANDER 850,2019-11-11,3,13,NH,US,16,694
OUTLANDER 450,2019-11-11,10,8,NH,US,18,637
OUTLANDER 1000,2019-11-18,12,14,NH,US,26,763
OUTLANDER 850,2019-11-18,8,6,NH,US,14,708
OUTLANDER 450,2019-11-18,9,2,NH,US,11,648
OUTLANDER 1000,2019-11-25,2,12,NH,US,14,777
OUTLANDER 850,2019-11-25,11,10,NH,US,21,729
OUTLANDER 450,2019-11-25,6,14,NH,US,20,668
OUTLANDER 1000,2019-12-02,11,5,NH,US,16,793
OUTLANDER 850,2019-12-02,11,0,NH,US,11,740
OUTLANDER 450,2019-12-02,1,7,NH,US,8,676
OUTLANDER 1000,2019-12-09,13,13,NH,US,26,819
OUTLANDER 850,2019-12-09,13,10,NH,US,23,763
OUTLANDER 450,2019-12-09,8,2,NH,US,10,686
OUTLANDER 1000,2019-12-16,1,14,NH,US,15,834
OUTLANDER 850,2019-12-16,15,5,NH,US,20,783
OUTLANDER 450,2019-12-16,6,10,NH,US,16,702
OUTLANDER 1000,2019-12-23,14,9,NH,US,23,857
OUTLANDER 850,2019-12-23,11,8,NH,US,19,802
OUTLANDER 450,2019-12-23,6,1,NH,US,7,709
OUTLANDER 1000,2019-12-30,4,9,NH,US,13,870
OUTLANDER 850,2019-12-30,12,10,NH,US,22,824
OUTLANDER 450,2019-12-30,6,4,NH,US,10,719
OUTLANDER 1000,2020-01-06,14,2,NH,US,16,886
OUTLANDER 850,2020-01-06,7,5,NH,US,12,836
OUTLANDER 450,2020-01-06,2,7,NH,US,9,728
OUTLANDER 1000,2020-01-13,12,7,NH,US,19,905
OUTLANDER 850,2020-01-13,10,12,NH,US,22,858
OUTLANDER 450,2020-01-13,10,6,NH,US,16,744
OUTLANDER 1000,2020-01-20,4,5,NH,US,9,914
OUTLANDER 850,2020-01-20,2,3,NH,US,5,863
OUTLANDER 450,2020-01-20,8,14,NH,US,22,766
OUTLANDER 1000,2020-01-27,7,15,NH,US,22,936
OUTLANDER 850,2020-01-27,8,11,NH,US,19,882
OUTLANDER 450,2020-01-27,8,6,NH,US,14,780
OUTLANDER 1000,2020-02-03,5,15,NH,US,20,956
OUTLANDER 850,2020-02-03,10,5,NH,US,15,897
OUTLANDER 450,2020-02-03,1,15,NH,US,16,796
OUTLANDER 1000,2020-02-10,5,9,NH,US,14,970
OUTLANDER 850,2020-02-10,12,8,NH,US,20,917
OUTLANDER 450,2020-02-10,1,5,NH,US,6,802
OUTLANDER 1000,2020-02-17,13,14,NH,US,27,997
OUTLANDER 850,2020-02-17,9,12,NH,US,21,938
OUTLANDER 450,2020-02-17,6,15,NH,US,21,823
OUTLANDER 1000,2020-02-24,7,1,NH,US,8,1005
OUTLANDER 850,2020-02-24,7,5,NH,US,12,950
OUTLANDER 450,2020-02-24,6,11,NH,US,17,840
OUTLANDER 1000,2020-03-02,6,7,NH,US,13,1018
OUTLANDER 850,2020-03-02,3,8,NH,US,11,961
OUTLANDER 450,2020-03-02,0,1,NH,US,1,841
OUTLANDER 1000,2020-03-09,1,8,NH,US,9,1027
OUTLANDER 850,2020-03-09,6,10,NH,US,16,977
OUTLANDER 450,2020-03-09,10,1,NH,US,11,852
OUTLANDER 1000,2020-03-16,8,13,NH,US,21,1048
OUTLANDER 850,2020-03-16,3,5,NH,US,8,985
OUTLANDER 450,2020-03-16,11,9,NH,US,20,872
OUTLANDER 1000,2020-03-23,11,12,NH,US,23,1071
OUTLANDER 850,2020-03-23,14,6,NH,US,20,1005
OUTLANDER 450,2020-03-23,2,8,NH,US,10,882
OUTLANDER 1000,2020-03-30,1,10,NH,US,11,1082
OUTLANDER 850,2020-03-30,13,13,NH,US,26,1031
OUTLANDER 450,2020-03-30,6,7,NH,US,13,895
OUTLANDER 1000,2020-04-06,4,6,NH,US,10,1092
OUTLANDER 850,2020-04-06,8,3,NH,US,11,1042
OUTLANDER 450,2020-04-06,7,1,NH,US,8,903
OUTLANDER 1000,2020-04-13,5,8,NH,US,13,1105
OUTLANDER 850,2020-04-13,12,7,NH,US,19,1061
OUTLANDER 450,2020-04-13,13,3,NH,US,16,919
OUTLANDER 1000,2020-04-20,11,15,NH,US,26,1131
OUTLANDER 850,2020-04-20,9,7,NH,US,16,1077
OUTLANDER 450,2020-04-20,9,5,NH,US,14,933
OUTLANDER 1000,2020-04-27,8,3,NH,US,11,1142
OUTLANDER 850,2020-04-27,13,13,NH,US,26,1103
OUTLANDER 450,2020-04-27,0,0,NH,US,0,933
OUTLANDER 1000,2020-05-04,2,5,NH,US,7,1149
OUTLANDER 850,2020-05-04,9,8,NH,US,17,1120
OUTLANDER 450,2020-05-04,6,3,NH,US,9,942
OUTLANDER 1000,2020-05-11,10,8,NH,US,18,1167
OUTLANDER 850,2020-05-11,10,1,NH,US,11,1131
OUTLANDER 450,2020-05-11,7,6,NH,US,13,955
OUTLANDER 1000,2020-05-18,0,5,NH,US,5,1172
OUTLANDER 850,2020-05-18,15,14,NH,US,29,1160
OUTLANDER 450,2020-05-18,9,7,NH,US,16,971
OUTLANDER 1000,2020-05-25,14,8,NH,US,22,1194
OUTLANDER 850,2020-05-25,5,9,NH,US,14,1174
OUTLANDER 450,2020-05-25,10,4,NH,US,14,985
OUTLANDER 1000,2020-06-01,10,0,NH,US,10,1204
OUTLANDER 850,2020-06-01,1,2,NH,US,3,1177
OUTLANDER 450,2020-06-01,5,13,NH,US,18,1003
OUTLANDER 1000,2020-06-08,5,7,NH,US,12,1216
OUTLANDER 850,2020-06-08,10,11,NH,US,21,1198
OUTLANDER 450,2020-06-08,9,2,NH,US,11,1014
OUTLANDER 1000,2020-06-15,6,5,NH,US,11,1227
OUTLANDER 850,2020-06-15,9,9,NH,US,18,1216
OUTLANDER 450,2020-06-15,8,4,NH,US,12,1026
OUTLANDER 1000,2020-06-22,5,5,NH,US,10,1237
OUTLANDER 850,2020-06-22,5,1,NH,US,6,1222
OUTLANDER 450,2020-06-22,12,11,NH,US,23,1049
OUTLANDER 1000,2020-06-29,8,6,NH,US,14,1251
OUTLANDER 850,2020-06-29,1,5,NH,US,6,1228
OUTLANDER 450,2020-06-29,10,7,NH,US,17,1066
OUTLANDER 1000,2020-07-06,14,2,NH,US,16,1267
OUTLANDER 850,2020-07-06,2,9,NH,US,11,1239
OUTLANDER 450,2020-07-06,6,13,NH,US,19,1085
OUTLANDER 1000,2020-07-13,11,5,NH,US,16,1283
OUTLANDER 850,2020-07-13,9,9,NH,US,18,1257
OUTLANDER 450,2020-07-13,6,14,NH,US,20,1105
OUTLANDER 1000,2020-07-20,2,6,NH,US,8,1291
OUTLANDER 850,2020-07-20,10,14,NH,US,24,1281
OUTLANDER 450,2020-07-20,2,5,NH,US,7,1112
OUTLANDER 1000,2020-07-27,12,6,NH,US,18,1309
OUTLANDER 850,2020-07-27,11,7,NH,US,18,1299
OUTLANDER 450,2020-07-27,8,8,NH,US,16,1128
OUTLANDER 1000,2020-08-03,12,9,NH,US,21,1330
OUTLANDER 850,2020-08-03,2,14,NH,US,16,1315
OUTLANDER 450,2020-08-03,5,11,NH,US,16,1144
OUTLANDER 1000,2020-08-10,12,1,NH,US,13,1343
OUTLANDER 850,2020-08-10,11,2,NH,US,13,1328
OUTLANDER 450,2020-08-10,6,7,NH,US,13,1157
OUTLANDER 1000,2020-08-17,0,4,NH,US,4,1347
OUTLANDER 850,2020-08-17,14,4,NH,US,18,1346
OUTLANDER 450,2020-08-17,3,4,NH,US,7,1164
OUTLANDER 1000,2020-08-24,12,10,NH,US,22,1369
OUTLANDER 850,2020-08-24,1,5,NH,US,6,1352
OUTLANDER 450,2020-08-24,4,2,NH,US,6,1170
OUTLANDER 1000,2020-08-31,5,13,NH,US,18,1387
OUTLANDER 850,2020-08-31,7,13,NH,US,20,1372
OUTLANDER 450,2020-08-31,6,7,NH,US,13,1183
OUTLANDER 1000,2020-09-07,11,3,NH,US,14,1401
OUTLANDER 850,2020-09-07,3,9,NH,US,12,1384
OUTLANDER 450,2020-09-07,1,5,NH,US,6,1189
OUTLANDER 1000,2020-09-14,12,6,NH,US,18,1419
OUTLANDER 850,2020-09-14,13,7,NH,US,20,1404
OUTLANDER 450,2020-09-14,11,15,NH,US,26,1215
OUTLANDER 1000,2020-09-21,11,3,NH,US,14,1433
OUTLANDER 850,2020-09-21,0,1,NH,US,1,1405
OUTLANDER 450,2020-09-21,7,7,NH,US,14,1229
OUTLANDER 1000,2020-09-28,10,7,NH,US,17,1450
OUTLANDER 850,2020-09-28,5,7,NH,US,12,1417
OUTLANDER 450,2020-09-28,10,3,NH,US,13,1242
OUTLANDER 1000,2020-10-05,0,12,NH,US,12,1462
OUTLANDER 850,2020-10-05,13,15,NH,US,28,1445
OUTLANDER 450,2020-10-05,12,6,NH,US,18,1260
OUTLANDER 1000,2020-10-12,11,8,NH,US,19,1481
OUTLANDER 850,2020-10-12,4,10,NH,US,14,1459
OUTLANDER 450,2020-10-12,4,11,NH,US,15,1275
OUTLANDER 1000,2020-10-19,7,1,NH,US,8,1489
OUTLANDER 850,2020-10-19,2,15,NH,US,17,1476
OUTLANDER 450,2020-10-19,7,1,NH,US,8,1283
OUTLANDER 1000,2020-10-26,12,1,NH,US,13,1502
OUTLANDER 850,2020-10-26,13,9,NH,US,22,1498
OUTLANDER 450,2020-10-26,6,10,NH,US,16,1299
OUTLANDER 1000,2020-11-02,2,12,NH,US,14,1516
OUTLANDER 850,2020-11-02,9,6,NH,US,15,1513
OUTLANDER 450,2020-11-02,3,4,NH,US,7,1306
OUTLANDER 1000,2020-11-09,4,11,NH,US,15,1531
OUTLANDER 850,2020-11-09,10,12,NH,US,22,1535
OUTLANDER 450,2020-11-09,12,6,NH,US,18,1324
OUTLANDER 1000,2020-11-16,1,8,NH,US,9,1540
OUTLANDER 850,2020-11-16,6,10,NH,US,16,1551
OUTLANDER 450,2020-11-16,5,13,NH,US,18,1342
OUTLANDER 1000,2020-11-23,11,5,NH,US,16,1556
OUTLANDER 850,2020-11-23,8,5,NH,US,13,1564
OUTLANDER 450,2020-11-23,14,1,NH,US,15,1357
OUTLANDER 1000,2020-11-30,10,13,NH,US,23,1579
OUTLANDER 850,2020-11-30,13,6,NH,US,19,1583
OUTLANDER 450,2020-11-30,5,1,NH,US,6,1363
OUTLANDER 1000,2020-12-07,10,9,NH,US,19,1598
OUTLANDER 850,2020-12-07,8,3,NH,US,11,1594
OUTLANDER 450,2020-12-07,12,9,NH,US,21,1384
OUTLANDER 1000,2020-12-14,5,3,NH,US,8,1606
OUTLANDER 850,2020-12-14,6,5,NH,US,11,1605
OUTLANDER 450,2020-12-14,9,4,NH,US,13,1397
OUTLANDER 1000,2020-12-21,1,4,NH,US,5,1611
OUTLANDER 850,2020-12-21,10,9,NH,US,19,1624
OUTLANDER 450,2020-12-21,13,15,NH,US,28,1425
OUTLANDER 1000,2020-12-28,2,9,NH,US,11,1622
OUTLANDER 850,2020-12-28,14,2,NH,US,16,1640
OUTLANDER 450,2020-12-28,12,1,NH,US,13,1438
OUTLANDER 1000,2021-01-04,11,0,NH,US,11,1633
OUTLANDER 850,2021-01-04,4,12,NH,US,16,1656
OUTLANDER 450,2021-01-04,5,10,NH,US,15,1453
OUTLANDER 1000,2021-01-11,5,2,NH,US,7,1640
OUTLANDER 850,2021-01-11,2,11,NH,US,13,1669
OUTLANDER 450,2021-01-11,1,4,NH,US,5,1458
OUTLANDER 1000,2021-01-18,3,13,NH,US,16,1656
OUTLANDER 850,2021-01-18,7,8,NH,US,15,1684
OUTLANDER 450,2021-01-18,4,12,NH,US,16,1474
OUTLANDER 1000,2021-01-25,13,9,NH,US,22,1678
OUTLANDER 850,2021-01-25,14,12,NH,US,26,1710
OUTLANDER 450,2021-01-25,8,6,NH,US,14,1488
OUTLANDER 1000,2021-02-01,2,7,NH,US,9,1687
OUTLANDER 850,2021-02-01,6,15,NH,US,21,1731
OUTLANDER 450,2021-02-01,14,7,NH,US,21,1509
OUTLANDER 1000,2021-02-08,1,6,NH,US,7,1694
OUTLANDER 850,2021-02-08,6,14,NH,US,20,1751
OUTLANDER 450,2021-02-08,3,13,NH,US,16,1525
OUTLANDER 1000,2021-02-15,15,8,NH,US,23,1717
OUTLANDER 850,2021-02-15,2,5,NH,US,7,1758
OUTLANDER 450,2021-02-15,7,14,NH,US,21,1546
OUTLANDER 1000,2021-02-22,1,10,NH,US,11,1728
OUTLANDER 850,2021-02-22,10,11,NH,US,21,1779
OUTLANDER 450,2021-02-22,13,0,NH,US,13,1559
OUTLANDER 1000,2021-03-01,14,15,NH,US,29,1757
OUTLANDER 850,2021-03-01,14,0,NH,US,14,1793
OUTLANDER 450,2021-03-01,12,5,NH,US,17,1576
OUTLANDER 1000,2021-03-08,11,6,NH,US,17,1774
OUTLANDER 850,2021-03-08,2,7,NH,US,9,1802
OUTLANDER 450,2021-03-08,13,8,NH,US,21,1597
OUTLANDER 1000,2021-03-15,6,8,NH,US,14,1788
OUTLANDER 850,2021-03-15,14,11,NH,US,25,1827
OUTLANDER 450,2021-03-15,12,5,NH,US,17,1614
OUTLANDER 1000,2021-03-22,7,0,NH,US,7,1795
OUTLANDER 850,2021-03-22,8,4,NH,US,12,1839
OUTLANDER 450,2021-03-22,5,8,NH,US,13,1627
OUTLANDER 1000,2021-03-29,14,9,NH,US,23,1818
OUTLANDER 850,2021-03-29,8,5,NH,US,13,1852
OUTLANDER 450,2021-03-29,10,1,NH,US,11,1638
OUTLANDER 1000,2021-04-05,12,6,NH,US,18,1836
OUTLANDER 850,2021-04-05,15,4,NH,US,19,1871
OUTLANDER 450,2021-04-05,9,14,NH,US,23,1661
OUTLANDER 1000,2021-04-12,12,11,NH,US,23,1859
OUTLANDER 850,2021-04-12,7,7,NH,US,14,1885
OUTLANDER 450,2021-04-12,9,2,NH,US,11,1672
OUTLANDER 1000,2021-04-19,13,14,NH,US,27,1886
OUTLANDER 850,2021-04-19,5,2,NH,US,7,1892
OUTLANDER 450,2021-04-19,4,0,NH,US,4,1676
OUTLANDER 1000,2021-04-26,9,5,NH,US,14,1900
OUTLANDER 850,2021-04-26,14,8,NH,US,22,1914
OUTLANDER 450,2021-04-26,12,7,NH,US,19,1695
OUTLANDER 1000,2021-05-03,10,5,NH,US,15,1915
OUTLANDER 850,2021-05-03,13,13,NH,US,26,1940
OUTLANDER 450,2021-05-03,1,1,NH,US,2,1697
OUTLANDER 1000,2021-05-10,1,2,NH,US,3,1918
OUTLANDER 850,2021-05-10,6,5,NH,US,11,1951
OUTLANDER 450,2021-05-10,11,5,NH,US,16,1713
OUTLANDER 1000,2021-05-17,14,4,NH,US,18,1936
OUTLANDER 850,2021-05-17,11,6,NH,US,17,1968
OUTLANDER 450,2021-05-17,7,3,NH,US,10,1723
OUTLANDER 1000,2021-05-24,1,13,NH,US,14,1950
OUTLANDER 850,2021-05-24,12,11,NH,US,23,1991
OUTLANDER 450,2021-05-24,1,9,NH,US,10,1733
OUTLANDER 1000,2021-05-31,13,7,NH,US,20,1970
OUTLANDER 850,2021-05-31,0,13,NH,US,13,2004
OUTLANDER 450,2021-05-31,10,13,NH,US,23,1756
OUTLANDER 1000,2021-06-07,11,1,NH,US,12,1982
OUTLANDER 850,2021-06-07,10,1,NH,US,11,2015
OUTLANDER 450,2021-06-07,2,12,NH,US,14,1770
OUTLANDER 1000,2021-06-14,5,11,NH,US,16,1998
OUTLANDER 850,2021-06-14,10,14,NH,US,24,2039
OUTLANDER 450,2021-06-14,13,4,NH,US,17,1787
OUTLANDER 1000,2021-06-21,12,11,NH,US,23,2021
OUTLANDER 850,2021-06-21,1,4,NH,US,5,2044
OUTLANDER 450,2021-06-21,2,15,NH,US,17,1804
OUTLANDER 1000,2021-06-28,11,14,NH,US,25,2046
OUTLANDER 850,2021-06-28,5,7,NH,US,12,2056
OUTLANDER 450,2021-06-28,10,14,NH,US,24,1828
OUTLANDER 1000,2021-07-05,8,4,NH,US,12,2058
OUTLANDER 850,2021-07-05,7,11,NH,US,18,2074
OUTLANDER 450,2021-07-05,4,10,NH,US,14,1842
OUTLANDER 1000,2021-07-12,13,5,NH,US,18,2076
OUTLANDER 850,2021-07-12,8,8,NH,US,16,2090
OUTLANDER 450,2021-07-12,15,5,NH,US,20,1862
OUTLANDER 1000,2021-07-19,13,3,NH,US,16,2092
OUTLANDER 850,2021-07-19,9,9,NH,US,18,2108
OUTLANDER 450,2021-07-19,9,12,NH,US,21,1883
OUTLANDER 1000,2021-07-26,7,10,NH,US,17,2109
OUTLANDER 850,2021-07-26,14,10,NH,US,24,2132
OUTLANDER 450,2021-07-26,14,2,NH,US,16,1899
OUTLANDER 1000,2021-08-02,9,13,NH,US,22,2131
OUTLANDER 850,2021-08-02,7,3,NH,US,10,2142
OUTLANDER 450,2021-08-02,0,11,NH,US,11,1910
OUTLANDER 1000,2021-08-09,4,13,NH,US,17,2148
OUTLANDER 850,2021-08-09,13,14,NH,US,27,2169
OUTLANDER 450,2021-08-09,12,3,NH,US,15,1925
OUTLANDER 1000,2021-08-16,3,14,NH,US,17,2165
OUTLANDER 850,2021-08-16,15,3,NH,US,18,2187
OUTLANDER 450,2021-08-16,1,1,NH,US,2,1927
OUTLANDER 1000,2021-08-23,12,3,NH,US,15,2180
OUTLANDER 850,2021-08-23,5,4,NH,US,9,2196
OUTLANDER 450,2021-08-23,1,11,NH,US,12,1939
OUTLANDER 1000,2021-08-30,12,6,NH,US,18,2198
OUTLANDER 850,2021-08-30,3,11,NH,US,14,2210
OUTLANDER 450,2021-08-30,13,13,NH,US,26,1965
OUTLANDER 1000,2021-09-06,13,14,NH,US,27,2225
OUTLANDER 850,2021-09-06,8,15,NH,US,23,2233
OUTLANDER 450,2021-09-06,2,7,NH,US,9,1974
OUTLANDER 1000,2021-09-13,15,6,NH,US,21,2246
OUTLANDER 850,2021-09-13,11,0,NH,US,11,2244
OUTLANDER 450,2021-09-13,4,0,NH,US,4,1978
OUTLANDER 1000,2021-09-20,11,2,NH,US,13,2259
OUTLANDER 850,2021-09-20,10,4,NH,US,14,2258
OUTLANDER 450,2021-09-20,2,4,NH,US,6,1984
OUTLANDER 1000,2021-09-27,3,6,NH,US,9,2268
OUTLANDER 850,2021-09-27,13,7,NH,US,20,2278
OUTLANDER 450,2021-09-27,4,1,NH,US,5,1989
OUTLANDER 1000,2021-10-04,14,4,NH,US,18,2286
OUTLANDER 850,2021-10-04,12,5,NH,US,17,2295
OUTLANDER 450,2021-10-04,6,9,NH,US,15,2004
OUTLANDER 1000,2021-10-11,4,8,NH,US,12,2298
OUTLANDER 850,2021-10-11,2,2,NH,US,4,2299
OUTLANDER 450,2021-10-11,6,2,NH,US,8,2012
OUTLANDER 1000,2021-10-18,13,1,NH,US,14,2312
OUTLANDER 850,2021-10-18,11,9,NH,US,20,2319
OUTLANDER 450,2021-10-18,4,1,NH,US,5,2017
OUTLANDER 1000,2021-10-25,7,6,NH,US,13,2325
OUTLANDER 850,2021-10-25,7,3,NH,US,10,2329
OUTLANDER 450,2021-10-25,6,2,NH,US,8,2025
OUTLANDER 1000,2021-11-01,7,9,NH,US,16,2341
OUTLANDER 850,2021-11-01,9,5,NH,US,14,2343
OUTLANDER 450,2021-11-01,6,10,NH,US,16,2041
OUTLANDER 1000,2021-11-08,7,6,NH,US,13,2354
OUTLANDER 850,2021-11-08,14,3,NH,US,17,2360
OUTLANDER 450,2021-11-08,1,3,NH,US,4,2045
OUTLANDER 1000,2021-11-15,6,9,NH,US,15,2369
OUTLANDER 850,2021-11-15,10,3,NH,US,13,2373
OUTLANDER 450,2021-11-15,6,8,NH,US,14,2059
OUTLANDER 1000,2021-11-22,12,9,NH,US,21,2390
OUTLANDER 850,2021-11-22,14,7,NH,US,21,2394
OUTLANDER 450,2021-11-22,9,3,NH,US,12,2071
OUTLANDER 1000,2021-11-29,3,0,NH,US,3,2393
OUTLANDER 850,2021-11-29,0,2,NH,US,2,2396
OUTLANDER 450,2021-11-29,1,10,NH,US,11,2082
OUTLANDER 1000,2021-12-06,2,15,NH,US,17,2410
OUTLANDER 850,2021-12-06,10,7,NH,US,17,2413
OUTLANDER 450,2021-12-06,11,3,NH,US,14,2096
OUTLANDER 1000,2021-12-13,4,12,NH,US,16,2426
OUTLANDER 850,2021-12-13,4,2,NH,US,6,2419
OUTLANDER 450,2021-12-13,2,3,NH,US,5,2101
OUTLANDER 1000,2021-12-20,12,2,NH,US,14,2440
OUTLANDER 850,2021-12-20,7,4,NH,US,11,2430
OUTLANDER 450,2021-12-20,13,7,NH,US,20,2121
OUTLANDER 1000,2021-12-27,8,7,NH,US,15,2455
OUTLANDER 850,2021-12-27,5,1,NH,US,6,2436
OUTLANDER 450,2021-12-27,4,11,NH,US,15,2136
OUTLANDER 1000,2019-01-07,7,6,NJ,US,13,13
OUTLANDER 850,2019-01-07,12,11,NJ,US,23,23
OUTLANDER 450,2019-01-07,7,8,NJ,US,15,15
OUTLANDER 1000,2019-01-14,14,7,NJ,US,21,34
OUTLANDER 850,2019-01-14,5,2,NJ,US,7,30
OUTLANDER 450,2019-01-14,14,1,NJ,US,15,30
OUTLANDER 1000,2019-01-21,7,10,NJ,US,17,51
OUTLANDER 850,2019-01-21,7,2,NJ,US,9,39
OUTLANDER 450,2019-01-21,7,12,NJ,US,19,49
OUTLANDER 1000,2019-01-28,12,9,NJ,US,21,72
OUTLANDER 850,2019-01-28,11,7,NJ,US,18,57
OUTLANDER 450,2019-01-28,5,14,NJ,US,19,68
OUTLANDER 1000,2019-02-04,6,7,NJ,US,13,85
OUTLANDER 850,2019-02-04,13,1,NJ,US,14,71
OUTLANDER 450,2019-02-04,13,1,NJ,US,14,82
OUTLANDER 1000,2019-02-11,3,14,NJ,US,17,102
OUTLANDER 850,2019-02-11,7,0,NJ,US,7,78
OUTLANDER 450,2019-02-11,2,3,NJ,US,5,87
OUTLANDER 1000,2019-02-18,10,14,NJ,US,24,126
OUTLANDER 850,2019-02-18,3,5,NJ,US,8,86
OUTLANDER 450,2019-02-18,12,7,NJ,US,19,106
OUTLANDER 1000,2019-02-25,10,11,NJ,US,21,147
OUTLANDER 850,2019-02-25,10,14,NJ,US,24,110
OUTLANDER 450,2019-02-25,3,10,NJ,US,13,119
OUTLANDER 1000,2019-03-04,10,13,NJ,US,23,170
OUTLANDER 850,2019-03-04,6,0,NJ,US,6,116
OUTLANDER 450,2019-03-04,13,2,NJ,US,15,134
OUTLANDER 1000,2019-03-11,8,0,NJ,US,8,178
OUTLANDER 850,2019-03-11,4,4,NJ,US,8,124
OUTLANDER 450,2019-03-11,14,4,NJ,US,18,152
OUTLANDER 1000,2019-03-18,0,10,NJ,US,10,188
OUTLANDER 850,2019-03-18,9,9,NJ,US,18,142
OUTLANDER 450,2019-03-18,12,1,NJ,US,13,165
OUTLANDER 1000,2019-03-25,7,11,NJ,US,18,206
OUTLANDER 850,2019-03-25,5,13,NJ,US,18,160
OUTLANDER 450,2019-03-25,4,12,NJ,US,16,181
OUTLANDER 1000,2019-04-01,1,3,NJ,US,4,210
OUTLANDER 850,2019-04-01,11,4,NJ,US,15,175
OUTLANDER 450,2019-04-01,12,11,NJ,US,23,204
OUTLANDER 1000,2019-04-08,3,9,NJ,US,12,222
OUTLANDER 850,2019-04-08,14,12,NJ,US,26,201
OUTLANDER 450,2019-04-08,10,14,NJ,US,24,228
OUTLANDER 1000,2019-04-15,11,12,NJ,US,23,245
OUTLANDER 850,2019-04-15,10,10,NJ,US,20,221
OUTLANDER 450,2019-04-15,8,13,NJ,US,21,249
OUTLANDER 1000,2019-04-22,2,2,NJ,US,4,249
OUTLANDER 850,2019-04-22,12,9,NJ,US,21,242
OUTLANDER 450,2019-04-22,13,6,NJ,US,19,268
OUTLANDER 1000,2019-04-29,4,12,NJ,US,16,265
OUTLANDER 850,2019-04-29,9,8,NJ,US,17,259
OUTLANDER 450,2019-04-29,11,10,NJ,US,21,289
OUTLANDER 1000,2019-05-06,6,11,NJ,US,17,282
OUTLANDER 850,2019-05-06,8,12,NJ,US,20,279
OUTLANDER 450,2019-05-06,2,2,NJ,US,4,293
OUTLANDER 1000,2019-05-13,11,10,NJ,US,21,303
OUTLANDER 850,2019-05-13,15,6,NJ,US,21,300
OUTLANDER 450,2019-05-13,4,14,NJ,US,18,311
OUTLANDER 1000,2019-05-20,4,9,NJ,US,13,316
OUTLANDER 850,2019-05-20,13,15,NJ,US,28,328
OUTLANDER 450,2019-05-20,13,3,NJ,US,16,327
OUTLANDER 1000,2019-05-27,6,15,NJ,US,21,337
OUTLANDER 850,2019-05-27,2,12,NJ,US,14,342
OUTLANDER 450,2019-05-27,5,4,NJ,US,9,336
OUTLANDER 1000,2019-06-03,13,8,NJ,US,21,358
OUTLANDER 850,2019-06-03,3,11,NJ,US,14,356
OUTLANDER 450,2019-06-03,9,11,NJ,US,20,356
OUTLANDER 1000,2019-06-10,13,10,NJ,US,23,381
OUTLANDER 850,2019-06-10,13,15,NJ,US,28,384
OUTLANDER 450,2019-06-10,1,0,NJ,US,1,357
OUTLANDER 1000,2019-06-17,13,2,NJ,US,15,396
OUTLANDER 850,2019-06-17,2,10,NJ,US,12,396
OUTLANDER 450,2019-06-17,8,7,NJ,US,15,372
OUTLANDER 1000,2019-06-24,8,7,NJ,US,15,411
OUTLANDER 850,2019-06-24,5,0,NJ,US,5,401
OUTLANDER 450,2019-06-24,6,8,NJ,US,14,386
OUTLANDER 1000,2019-07-01,11,7,NJ,US,18,429
OUTLANDER 850,2019-07-01,1,0,NJ,US,1,402
OUTLANDER 450,2019-07-01,10,1,NJ,US,11,397
OUTLANDER 1000,2019-07-08,12,3,NJ,US,15,444
OUTLANDER 850,2019-07-08,4,15,NJ,US,19,421
OUTLANDER 450,2019-07-08,11,12,NJ,US,23,420
OUTLANDER 1000,2019-07-15,4,15,NJ,US,19,463
OUTLANDER 850,2019-07-15,4,13,NJ,US,17,438
OUTLANDER 450,2019-07-15,7,10,NJ,US,17,437
OUTLANDER 1000,2019-07-22,8,7,NJ,US,15,478
OUTLANDER 850,2019-07-22,11,6,NJ,US,17,455
OUTLANDER 450,2019-07-22,11,8,NJ,US,19,456
OUTLANDER 1000,2019-07-29,5,7,NJ,US,12,490
OUTLANDER 850,2019-07-29,7,8,NJ,US,15,470
OUTLANDER 450,2019-07-29,0,5,NJ,US,5,461
OUTLANDER 1000,2019-08-05,6,1,NJ,US,7,497
OUTLANDER 850,2019-08-05,7,5,NJ,US,12,482
OUTLANDER 450,2019-08-05,12,7,NJ,US,19,480
OUTLANDER 1000,2019-08-12,13,12,NJ,US,25,522
OUTLANDER 850,2019-08-12,1,14,NJ,US,15,497
OUTLANDER 450,2019-08-12,5,2,NJ,US,7,487
OUTLANDER 1000,2019-08-19,10,7,NJ,US,17,539
OUTLANDER 850,2019-08-19,14,4,NJ,US,18,515
OUTLANDER 450,2019-08-19,11,0,NJ,US,11,498
OUTLANDER 1000,2019-08-26,12,13,NJ,US,25,564
OUTLANDER 850,2019-08-26,12,9,NJ,US,21,536
OUTLANDER 450,2019-08-26,7,2,NJ,US,9,507
OUTLANDER 1000,2019-09-02,1,4,NJ,US,5,569
OUTLANDER 850,2019-09-02,4,0,NJ,US,4,540
OUTLANDER 450,2019-09-02,8,8,NJ,US,16,523
OUTLANDER 1000,2019-09-09,2,7,NJ,US,9,578
OUTLANDER 850,2019-09-09,7,4,NJ,US,11,551
OUTLANDER 450,2019-09-09,3,11,NJ,US,14,537
OUTLANDER 1000,2019-09-16,2,14,NJ,US,16,594
OUTLANDER 850,2019-09-16,11,8,NJ,US,19,570
OUTLANDER 450,2019-09-16,2,4,NJ,US,6,543
OUTLANDER 1000,2019-09-23,6,9,NJ,US,15,609
OUTLANDER 850,2019-09-23,2,11,NJ,US,13,583
OUTLANDER 450,2019-09-23,7,6,NJ,US,13,556
OUTLANDER 1000,2019-09-30,12,10,NJ,US,22,631
OUTLANDER 850,2019-09-30,11,14,NJ,US,25,608
OUTLANDER 450,2019-09-30,8,9,NJ,US,17,573
OUTLANDER 1000,2019-10-07,11,2,NJ,US,13,644
OUTLANDER 850,2019-10-07,2,5,NJ,US,7,615
OUTLANDER 450,2019-10-07,9,5,NJ,US,14,587
OUTLANDER 1000,2019-10-14,4,3,NJ,US,7,651
OUTLANDER 850,2019-10-14,13,1,NJ,US,14,629
OUTLANDER 450,2019-10-14,15,14,NJ,US,29,616
OUTLANDER 1000,2019-10-21,11,10,NJ,US,21,672
OUTLANDER 850,2019-10-21,4,2,NJ,US,6,635
OUTLANDER 450,2019-10-21,12,7,NJ,US,19,635
OUTLANDER 1000,2019-10-28,11,1,NJ,US,12,684
OUTLANDER 850,2019-10-28,14,8,NJ,US,22,657
OUTLANDER 450,2019-10-28,5,3,NJ,US,8,643
OUTLANDER 1000,2019-11-04,3,4,NJ,US,7,691
OUTLANDER 850,2019-11-04,13,7,NJ,US,20,677
OUTLANDER 450,2019-11-04,15,15,NJ,US,30,673
OUTLANDER 1000,2019-11-11,13,3,NJ,US,16,707
OUTLANDER 850,2019-11-11,8,15,NJ,US,23,700
OUTLANDER 450,2019-11-11,5,11,NJ,US,16,689
OUTLANDER 1000,2019-11-18,5,1,NJ,US,6,713
OUTLANDER 850,2019-11-18,7,12,NJ,US,19,719
OUTLANDER 450,2019-11-18,12,12,NJ,US,24,713
OUTLANDER 1000,2019-11-25,2,5,NJ,US,7,720
OUTLANDER 850,2019-11-25,9,1,NJ,US,10,729
OUTLANDER 450,2019-11-25,2,14,NJ,US,16,729
OUTLANDER 1000,2019-12-02,14,8,NJ,US,22,742
OUTLANDER 850,2019-12-02,1,12,NJ,US,13,742
OUTLANDER 450,2019-12-02,11,9,NJ,US,20,749
OUTLANDER 1000,2019-12-09,15,14,NJ,US,29,771
OUTLANDER 850,2019-12-09,3,12,NJ,US,15,757
OUTLANDER 450,2019-12-09,6,8,NJ,US,14,763
OUTLANDER 1000,2019-12-16,5,9,NJ,US,14,785
OUTLANDER 850,2019-12-16,14,12,NJ,US,26,783
OUTLANDER 450,2019-12-16,1,12,NJ,US,13,776
OUTLANDER 1000,2019-12-23,12,3,NJ,US,15,800
OUTLANDER 850,2019-12-23,15,1,NJ,US,16,799
OUTLANDER 450,2019-12-23,2,6,NJ,US,8,784
OUTLANDER 1000,2019-12-30,13,7,NJ,US,20,820
OUTLANDER 850,2019-12-30,14,6,NJ,US,20,819
OUTLANDER 450,2019-12-30,4,15,NJ,US,19,803
OUTLANDER 1000,2020-01-06,7,12,NJ,US,19,839
OUTLANDER 850,2020-01-06,1,3,NJ,US,4,823
OUTLANDER 450,2020-01-06,12,10,NJ,US,22,825
OUTLANDER 1000,2020-01-13,9,1,NJ,US,10,849
OUTLANDER 850,2020-01-13,14,7,NJ,US,21,844
OUTLANDER 450,2020-01-13,11,10,NJ,US,21,846
OUTLANDER 1000,2020-01-20,6,9,NJ,US,15,864
OUTLANDER 850,2020-01-20,8,3,NJ,US,11,855
OUTLANDER 450,2020-01-20,7,6,NJ,US,13,859
OUTLANDER 1000,2020-01-27,3,11,NJ,US,14,878
OUTLANDER 850,2020-01-27,5,14,NJ,US,19,874
OUTLANDER 450,2020-01-27,4,5,NJ,US,9,868
OUTLANDER 1000,2020-02-03,2,8,NJ,US,10,888
OUTLANDER 850,2020-02-03,4,5,NJ,US,9,883
OUTLANDER 450,2020-02-03,11,2,NJ,US,13,881
OUTLANDER 1000,2020-02-10,5,1,NJ,US,6,894
OUTLANDER 850,2020-02-10,14,5,NJ,US,19,902
OUTLANDER 450,2020-02-10,14,2,NJ,US,16,897
OUTLANDER 1000,2020-02-17,14,1,NJ,US,15,909
OUTLANDER 850,2020-02-17,14,9,NJ,US,23,925
OUTLANDER 450,2020-02-17,15,14,NJ,US,29,926
OUTLANDER 1000,2020-02-24,1,11,NJ,US,12,921
OUTLANDER 850,2020-02-24,0,1,NJ,US,1,926
OUTLANDER 450,2020-02-24,1,8,NJ,US,9,935
OUTLANDER 1000,2020-03-02,5,12,NJ,US,17,938
OUTLANDER 850,2020-03-02,0,4,NJ,US,4,930
OUTLANDER 450,2020-03-02,11,10,NJ,US,21,956
OUTLANDER 1000,2020-03-09,12,3,NJ,US,15,953
OUTLANDER 850,2020-03-09,12,12,NJ,US,24,954
OUTLANDER 450,2020-03-09,10,7,NJ,US,17,973
OUTLANDER 1000,2020-03-16,8,2,NJ,US,10,963
OUTLANDER 850,2020-03-16,2,9,NJ,US,11,965
OUTLANDER 450,2020-03-16,13,9,NJ,US,22,995
OUTLANDER 1000,2020-03-23,9,6,NJ,US,15,978
OUTLANDER 850,2020-03-23,9,3,NJ,US,12,977
OUTLANDER 450,2020-03-23,3,3,NJ,US,6,1001
OUTLANDER 1000,2020-03-30,6,14,NJ,US,20,998
OUTLANDER 850,2020-03-30,9,5,NJ,US,14,991
OUTLANDER 450,2020-03-30,7,5,NJ,US,12,1013
OUTLANDER 1000,2020-04-06,13,11,NJ,US,24,1022
OUTLANDER 850,2020-04-06,4,4,NJ,US,8,999
OUTLANDER 450,2020-04-06,6,8,NJ,US,14,1027
OUTLANDER 1000,2020-04-13,11,9,NJ,US,20,1042
OUTLANDER 850,2020-04-13,1,1,NJ,US,2,1001
OUTLANDER 450,2020-04-13,0,2,NJ,US,2,1029
OUTLANDER 1000,2020-04-20,4,3,NJ,US,7,1049
OUTLANDER 850,2020-04-20,6,11,NJ,US,17,1018
OUTLANDER 450,2020-04-20,3,7,NJ,US,10,1039
OUTLANDER 1000,2020-04-27,6,7,NJ,US,13,1062
OUTLANDER 850,2020-04-27,14,6,NJ,US,20,1038
OUTLANDER 450,2020-04-27,8,11,NJ,US,19,1058
OUTLANDER 1000,2020-05-04,0,7,NJ,US,7,1069
OUTLANDER 850,2020-05-04,2,10,NJ,US,12,1050
OUTLANDER 450,2020-05-04,12,7,NJ,US,19,1077
OUTLANDER 1000,2020-05-11,9,5,NJ,US,14,1083
OUTLANDER 850,2020-05-11,11,8,NJ,US,19,1069
OUTLANDER 450,2020-05-11,3,10,NJ,US,13,1090
OUTLANDER 1000,2020-05-18,8,5,NJ,US,13,1096
OUTLANDER 850,2020-05-18,9,4,NJ,US,13,1082
OUTLANDER 450,2020-05-18,11,7,NJ,US,18,1108
OUTLANDER 1000,2020-05-25,8,8,NJ,US,16,1112
OUTLANDER 850,2020-05-25,4,7,NJ,US,11,1093
OUTLANDER 450,2020-05-25,12,3,NJ,US,15,1123
OUTLANDER 1000,2020-06-01,14,0,NJ,US,14,1126
OUTLANDER 850,2020-06-01,6,8,NJ,US,14,1107
OUTLANDER 450,2020-06-01,1,10,NJ,US,11,1134
OUTLANDER 1000,2020-06-08,7,11,NJ,US,18,1144
OUTLANDER 850,2020-06-08,3,5,NJ,US,8,1115
OUTLANDER 450,2020-06-08,8,6,NJ,US,14,1148
OUTLANDER 1000,2020-06-15,10,7,NJ,US,17,1161
OUTLANDER 850,2020-06-15,4,14,NJ,US,18,1133
OUTLANDER 450,2020-06-15,5,3,NJ,US,8,1156
OUTLANDER 1000,2020-06-22,2,7,NJ,US,9,1170
OUTLANDER 850,2020-06-22,7,3,NJ,US,10,1143
OUTLANDER 450,2020-06-22,12,13,NJ,US,25,1181
OUTLANDER 1000,2020-06-29,10,9,NJ,US,19,1189
OUTLANDER 850,2020-06-29,12,12,NJ,US,24,1167
OUTLANDER 450,2020-06-29,4,9,NJ,US,13,1194
OUTLANDER 1000,2020-07-06,2,9,NJ,US,11,1200
OUTLANDER 850,2020-07-06,1,8,NJ,US,9,1176
OUTLANDER 450,2020-07-06,15,14,NJ,US,29,1223
OUTLANDER 1000,2020-07-13,14,5,NJ,US,19,1219
OUTLANDER 850,2020-07-13,11,2,NJ,US,13,1189
OUTLANDER 450,2020-07-13,10,4,NJ,US,14,1237
OUTLANDER 1000,2020-07-20,7,10,NJ,US,17,1236
OUTLANDER 850,2020-07-20,14,0,NJ,US,14,1203
OUTLANDER 450,2020-07-20,11,0,NJ,US,11,1248
OUTLANDER 1000,2020-07-27,7,6,NJ,US,13,1249
OUTLANDER 850,2020-07-27,7,14,NJ,US,21,1224
OUTLANDER 450,2020-07-27,6,6,NJ,US,12,1260
OUTLANDER 1000,2020-08-03,6,6,NJ,US,12,1261
OUTLANDER 850,2020-08-03,5,9,NJ,US,14,1238
OUTLANDER 450,2020-08-03,0,9,NJ,US,9,1269
OUTLANDER 1000,2020-08-10,9,14,NJ,US,23,1284
OUTLANDER 850,2020-08-10,3,1,NJ,US,4,1242
OUTLANDER 450,2020-08-10,13,15,NJ,US,28,1297
OUTLANDER 1000,2020-08-17,10,14,NJ,US,24,1308
OUTLANDER 850,2020-08-17,12,12,NJ,US,24,1266
OUTLANDER 450,2020-08-17,9,1,NJ,US,10,1307
OUTLANDER 1000,2020-08-24,0,5,NJ,US,5,1313
OUTLANDER 850,2020-08-24,0,9,NJ,US,9,1275
OUTLANDER 450,2020-08-24,2,8,NJ,US,10,1317
OUTLANDER 1000,2020-08-31,4,14,NJ,US,18,1331
OUTLANDER 850,2020-08-31,5,5,NJ,US,10,1285
OUTLANDER 450,2020-08-31,1,4,NJ,US,5,1322
OUTLANDER 1000,2020-09-07,1,10,NJ,US,11,1342
OUTLANDER 850,2020-09-07,4,15,NJ,US,19,1304
OUTLANDER 450,2020-09-07,4,5,NJ,US,9,1331
OUTLANDER 1000,2020-09-14,2,14,NJ,US,16,1358
OUTLANDER 850,2020-09-14,10,11,NJ,US,21,1325
OUTLANDER 450,2020-09-14,7,15,NJ,US,22,1353
OUTLANDER 1000,2020-09-21,13,13,NJ,US,26,1384
OUTLANDER 850,2020-09-21,12,8,NJ,US,20,1345
OUTLANDER 450,2020-09-21,3,1,NJ,US,4,1357
OUTLANDER 1000,2020-09-28,12,2,NJ,US,14,1398
OUTLANDER 850,2020-09-28,13,13,NJ,US,26,1371
OUTLANDER 450,2020-09-28,14,7,NJ,US,21,1378
OUTLANDER 1000,2020-10-05,10,13,NJ,US,23,1421
OUTLANDER 850,2020-10-05,2,14,NJ,US,16,1387
OUTLANDER 450,2020-10-05,9,4,NJ,US,13,1391
OUTLANDER 1000,2020-10-12,12,14,NJ,US,26,1447
OUTLANDER 850,2020-10-12,12,8,NJ,US,20,1407
OUTLANDER 450,2020-10-12,7,12,NJ,US,19,1410
OUTLANDER 1000,2020-10-19,12,13,NJ,US,25,1472
OUTLANDER 850,2020-10-19,11,13,NJ,US,24,1431
OUTLANDER 450,2020-10-19,4,15,NJ,US,19,1429
OUTLANDER 1000,2020-10-26,3,6,NJ,US,9,1481
OUTLANDER 850,2020-10-26,2,10,NJ,US,12,1443
OUTLANDER 450,2020-10-26,3,3,NJ,US,6,1435
OUTLANDER 1000,2020-11-02,13,1,NJ,US,14,1495
OUTLANDER 850,2020-11-02,10,5,NJ,US,15,1458
OUTLANDER 450,2020-11-02,6,10,NJ,US,16,1451
OUTLANDER 1000,2020-11-09,8,5,NJ,US,13,1508
OUTLANDER 850,2020-11-09,11,1,NJ,US,12,1470
OUTLANDER 450,2020-11-09,8,8,NJ,US,16,1467
OUTLANDER 1000,2020-11-16,12,8,NJ,US,20,1528
OUTLANDER 850,2020-11-16,14,14,NJ,US,28,1498
OUTLANDER 450,2020-11-16,9,5,NJ,US,14,1481
OUTLANDER 1000,2020-11-23,3,1,NJ,US,4,1532
OUTLANDER 850,2020-11-23,12,1,NJ,US,13,1511
OUTLANDER 450,2020-11-23,13,4,NJ,US,17,1498
OUTLANDER 1000,2020-11-30,12,8,NJ,US,20,1552
OUTLANDER 850,2020-11-30,6,9,NJ,US,15,1526
OUTLANDER 450,2020-11-30,8,10,NJ,US,18,1516
OUTLANDER 1000,2020-12-07,5,10,NJ,US,15,1567
OUTLANDER 850,2020-12-07,11,8,NJ,US,19,1545
OUTLANDER 450,2020-12-07,4,3,NJ,US,7,1523
OUTLANDER 1000,2020-12-14,5,13,NJ,US,18,1585
OUTLANDER 850,2020-12-14,8,10,NJ,US,18,1563
OUTLANDER 450,2020-12-14,9,0,NJ,US,9,1532
OUTLANDER 1000,2020-12-21,14,10,NJ,US,24,1609
OUTLANDER 850,2020-12-21,14,7,NJ,US,21,1584
OUTLANDER 450,2020-12-21,3,13,NJ,US,16,1548
OUTLANDER 1000,2020-12-28,7,2,NJ,US,9,1618
OUTLANDER 850,2020-12-28,13,3,NJ,US,16,1600
OUTLANDER 450,2020-12-28,1,2,NJ,US,3,1551
OUTLANDER 1000,2021-01-04,9,5,NJ,US,14,1632
OUTLANDER 850,2021-01-04,13,6,NJ,US,19,1619
OUTLANDER 450,2021-01-04,2,4,NJ,US,6,1557
OUTLANDER 1000,2021-01-11,12,1,NJ,US,13,1645
OUTLANDER 850,2021-01-11,1,14,NJ,US,15,1634
OUTLANDER 450,2021-01-11,13,8,NJ,US,21,1578
OUTLANDER 1000,2021-01-18,7,14,NJ,US,21,1666
OUTLANDER 850,2021-01-18,1,0,NJ,US,1,1635
OUTLANDER 450,2021-01-18,14,9,NJ,US,23,1601
OUTLANDER 1000,2021-01-25,5,8,NJ,US,13,1679
OUTLANDER 850,2021-01-25,5,1,NJ,US,6,1641
OUTLANDER 450,2021-01-25,8,7,NJ,US,15,1616
OUTLANDER 1000,2021-02-01,11,9,NJ,US,20,1699
OUTLANDER 850,2021-02-01,5,2,NJ,US,7,1648
OUTLANDER 450,2021-02-01,5,1,NJ,US,6,1622
OUTLANDER 1000,2021-02-08,2,9,NJ,US,11,1710
OUTLANDER 850,2021-02-08,5,8,NJ,US,13,1661
OUTLANDER 450,2021-02-08,12,13,NJ,US,25,1647
OUTLANDER 1000,2021-02-15,5,13,NJ,US,18,1728
OUTLANDER 850,2021-02-15,0,9,NJ,US,9,1670
OUTLANDER 450,2021-02-15,7,10,NJ,US,17,1664
OUTLANDER 1000,2021-02-22,3,8,NJ,US,11,1739
OUTLANDER 850,2021-02-22,10,2,NJ,US,12,1682
OUTLANDER 450,2021-02-22,6,6,NJ,US,12,1676
OUTLANDER 1000,2021-03-01,1,10,NJ,US,11,1750
OUTLANDER 850,2021-03-01,9,15,NJ,US,24,1706
OUTLANDER 450,2021-03-01,2,11,NJ,US,13,1689
OUTLANDER 1000,2021-03-08,3,4,NJ,US,7,1757
OUTLANDER 850,2021-03-08,2,6,NJ,US,8,1714
OUTLANDER 450,2021-03-08,10,2,NJ,US,12,1701
OUTLANDER 1000,2021-03-15,4,2,NJ,US,6,1763
OUTLANDER 850,2021-03-15,14,13,NJ,US,27,1741
OUTLANDER 450,2021-03-15,7,14,NJ,US,21,1722
OUTLANDER 1000,2021-03-22,14,3,NJ,US,17,1780
OUTLANDER 850,2021-03-22,3,8,NJ,US,11,1752
OUTLANDER 450,2021-03-22,12,9,NJ,US,21,1743
OUTLANDER 1000,2021-03-29,14,8,NJ,US,22,1802
OUTLANDER 850,2021-03-29,10,7,NJ,US,17,1769
OUTLANDER 450,2021-03-29,6,6,NJ,US,12,1755
OUTLANDER 1000,2021-04-05,1,4,NJ,US,5,1807
OUTLANDER 850,2021-04-05,14,6,NJ,US,20,1789
OUTLANDER 450,2021-04-05,10,13,NJ,US,23,1778
OUTLANDER 1000,2021-04-12,10,7,NJ,US,17,1824
OUTLANDER 850,2021-04-12,1,8,NJ,US,9,1798
OUTLANDER 450,2021-04-12,4,3,NJ,US,7,1785
OUTLANDER 1000,2021-04-19,5,1,NJ,US,6,1830
OUTLANDER 850,2021-04-19,1,2,NJ,US,3,1801
OUTLANDER 450,2021-04-19,2,14,NJ,US,16,1801
OUTLANDER 1000,2021-04-26,12,5,NJ,US,17,1847
OUTLANDER 850,2021-04-26,5,3,NJ,US,8,1809
OUTLANDER 450,2021-04-26,4,2,NJ,US,6,1807
OUTLANDER 1000,2021-05-03,8,5,NJ,US,13,1860
OUTLANDER 850,2021-05-03,15,15,NJ,US,30,1839
OUTLANDER 450,2021-05-03,12,5,NJ,US,17,1824
OUTLANDER 1000,2021-05-10,9,13,NJ,US,22,1882
OUTLANDER 850,2021-05-10,5,1,NJ,US,6,1845
OUTLANDER 450,2021-05-10,0,14,NJ,US,14,1838
OUTLANDER 1000,2021-05-17,14,9,NJ,US,23,1905
OUTLANDER 850,2021-05-17,6,10,NJ,US,16,1861
OUTLANDER 450,2021-05-17,7,4,NJ,US,11,1849
OUTLANDER 1000,2021-05-24,8,7,NJ,US,15,1920
OUTLANDER 850,2021-05-24,3,3,NJ,US,6,1867
OUTLANDER 450,2021-05-24,8,5,NJ,US,13,1862
OUTLANDER 1000,2021-05-31,12,12,NJ,US,24,1944
OUTLANDER 850,2021-05-31,9,6,NJ,US,15,1882
OUTLANDER 450,2021-05-31,10,3,NJ,US,13,1875
OUTLANDER 1000,2021-06-07,11,7,NJ,US,18,1962
OUTLANDER 850,2021-06-07,1,4,NJ,US,5,1887
OUTLANDER 450,2021-06-07,13,2,NJ,US,15,1890
OUTLANDER 1000,2021-06-14,4,15,NJ,US,19,1981
OUTLANDER 850,2021-06-14,12,7,NJ,US,19,1906
OUTLANDER 450,2021-06-14,9,3,NJ,US,12,1902
OUTLANDER 1000,2021-06-21,8,0,NJ,US,8,1989
OUTLANDER 850,2021-06-21,14,13,NJ,US,27,1933
OUTLANDER 450,2021-06-21,12,12,NJ,US,24,1926
OUTLANDER 1000,2021-06-28,5,15,NJ,US,20,2009
OUTLANDER 850,2021-06-28,4,6,NJ,US,10,1943
OUTLANDER 450,2021-06-28,8,11,NJ,US,19,1945
OUTLANDER 1000,2021-07-05,7,5,NJ,US,12,2021
OUTLANDER 850,2021-07-05,5,10,NJ,US,15,1958
OUTLANDER 450,2021-07-05,14,2,NJ,US,16,1961
OUTLANDER 1000,2021-07-12,5,6,NJ,US,11,2032
OUTLANDER 850,2021-07-12,3,12,NJ,US,15,1973
OUTLANDER 450,2021-07-12,3,12,NJ,US,15,1976
OUTLANDER 1000,2021-07-19,13,11,NJ,US,24,2056
OUTLANDER 850,2021-07-19,9,15,NJ,US,24,1997
OUTLANDER 450,2021-07-19,14,4,NJ,US,18,1994
OUTLANDER 1000,2021-07-26,6,5,NJ,US,11,2067
OUTLANDER 850,2021-07-26,13,1,NJ,US,14,2011
OUTLANDER 450,2021-07-26,8,14,NJ,US,22,2016
OUTLANDER 1000,2021-08-02,1,14,NJ,US,15,2082
OUTLANDER 850,2021-08-02,6,6,NJ,US,12,2023
OUTLANDER 450,2021-08-02,13,3,NJ,US,16,2032
OUTLANDER 1000,2021-08-09,4,9,NJ,US,13,2095
OUTLANDER 850,2021-08-09,1,10,NJ,US,11,2034
OUTLANDER 450,2021-08-09,9,12,NJ,US,21,2053
OUTLANDER 1000,2021-08-16,6,5,NJ,US,11,2106
OUTLANDER 850,2021-08-16,4,7,NJ,US,11,2045
OUTLANDER 450,2021-08-16,2,6,NJ,US,8,2061
OUTLANDER 1000,2021-08-23,13,2,NJ,US,15,2121
OUTLANDER 850,2021-08-23,3,15,NJ,US,18,2063
OUTLANDER 450,2021-08-23,3,4,NJ,US,7,2068
OUTLANDER 1000,2021-08-30,13,9,NJ,US,22,2143
OUTLANDER 850,2021-08-30,6,3,NJ,US,9,2072
OUTLANDER 450,2021-08-30,9,0,NJ,US,9,2077
OUTLANDER 1000,2021-09-06,0,7,NJ,US,7,2150
OUTLANDER 850,2021-09-06,5,3,NJ,US,8,2080
OUTLANDER 450,2021-09-06,12,4,NJ,US,16,2093
OUTLANDER 1000,2021-09-13,11,3,NJ,US,14,2164
OUTLANDER 850,2021-09-13,3,9,NJ,US,12,2092
OUTLANDER 450,2021-09-13,15,2,NJ,US,17,2110
OUTLANDER 1000,2021-09-20,2,9,NJ,US,11,2175
OUTLANDER 850,2021-09-20,6,2,NJ,US,8,2100
OUTLANDER 450,2021-09-20,3,14,NJ,US,17,2127
OUTLANDER 1000,2021-09-27,5,1,NJ,US,6,2181
OUTLANDER 850,2021-09-27,12,7,NJ,US,19,2119
OUTLANDER 450,2021-09-27,10,3,NJ,US,13,2140
OUTLANDER 1000,2021-10-04,8,15,NJ,US,23,2204
OUTLANDER 850,2021-10-04,7,4,NJ,US,11,2130
OUTLANDER 450,2021-10-04,2,14,NJ,US,16,2156
OUTLANDER 1000,2021-10-11,14,0,NJ,US,14,2218
OUTLANDER 850,2021-10-11,10,10,NJ,US,20,2150
OUTLANDER 450,2021-10-11,12,14,NJ,US,26,2182
OUTLANDER 1000,2021-10-18,4,8,NJ,US,12,2230
OUTLANDER 850,2021-10-18,2,1,NJ,US,3,2153
OUTLANDER 450,2021-10-18,10,3,NJ,US,13,2195
OUTLANDER 1000,2021-10-25,9,5,NJ,US,14,2244
OUTLANDER 850,2021-10-25,12,8,NJ,US,20,2173
OUTLANDER 450,2021-10-25,6,11,NJ,US,17,2212
OUTLANDER 1000,2021-11-01,10,6,NJ,US,16,2260
OUTLANDER 850,2021-11-01,10,9,NJ,US,19,2192
OUTLANDER 450,2021-11-01,6,3,NJ,US,9,2221
OUTLANDER 1000,2021-11-08,3,8,NJ,US,11,2271
OUTLANDER 850,2021-11-08,11,7,NJ,US,18,2210
OUTLANDER 450,2021-11-08,0,9,NJ,US,9,2230
OUTLANDER 1000,2021-11-15,7,10,NJ,US,17,2288
OUTLANDER 850,2021-11-15,14,9,NJ,US,23,2233
OUTLANDER 450,2021-11-15,12,1,NJ,US,13,2243
OUTLANDER 1000,2021-11-22,13,2,NJ,US,15,2303
OUTLANDER 850,2021-11-22,11,4,NJ,US,15,2248
OUTLANDER 450,2021-11-22,1,3,NJ,US,4,2247
OUTLANDER 1000,2021-11-29,7,10,NJ,US,17,2320
OUTLANDER 850,2021-11-29,7,9,NJ,US,16,2264
OUTLANDER 450,2021-11-29,5,10,NJ,US,15,2262
OUTLANDER 1000,2021-12-06,1,15,NJ,US,16,2336
OUTLANDER 850,2021-12-06,4,2,NJ,US,6,2270
OUTLANDER 450,2021-12-06,12,4,NJ,US,16,2278
OUTLANDER 1000,2021-12-13,8,10,NJ,US,18,2354
OUTLANDER 850,2021-12-13,10,1,NJ,US,11,2281
OUTLANDER 450,2021-12-13,2,1,NJ,US,3,2281
OUTLANDER 1000,2021-12-20,2,3,NJ,US,5,2359
OUTLANDER 850,2021-12-20,12,7,NJ,US,19,2300
OUTLANDER 450,2021-12-20,9,13,NJ,US,22,2303
OUTLANDER 1000,2021-12-27,11,6,NJ,US,17,2376
OUTLANDER 850,2021-12-27,7,7,NJ,US,14,2314
OUTLANDER 450,2021-12-27,9,5,NJ,US,14,2317
OUTLANDER 1000,2019-01-07,7,8,NM,US,15,15
OUTLANDER 850,2019-01-07,2,7,NM,US,9,9
OUTLANDER 450,2019-01-07,9,7,NM,US,16,16
OUTLANDER 1000,2019-01-14,2,8,NM,US,10,25
OUTLANDER 850,2019-01-14,1,1,NM,US,2,11
OUTLANDER 450,2019-01-14,4,9,NM,US,13,29
OUTLANDER 1000,2019-01-21,14,12,NM,US,26,51
OUTLANDER 850,2019-01-21,1,14,NM,US,15,26
OUTLANDER 450,2019-01-21,12,10,NM,US,22,51
OUTLANDER 1000,2019-01-28,1,10,NM,US,11,62
OUTLANDER 850,2019-01-28,2,15,NM,US,17,43
OUTLANDER 450,2019-01-28,2,6,NM,US,8,59
OUTLANDER 1000,2019-02-04,13,9,NM,US,22,84
OUTLANDER 850,2019-02-04,5,12,NM,US,17,60
OUTLANDER 450,2019-02-04,15,9,NM,US,24,83
OUTLANDER 1000,2019-02-11,1,3,NM,US,4,88
OUTLANDER 850,2019-02-11,1,7,NM,US,8,68
OUTLANDER 450,2019-02-11,5,4,NM,US,9,92
OUTLANDER 1000,2019-02-18,4,14,NM,US,18,106
OUTLANDER 850,2019-02-18,14,2,NM,US,16,84
OUTLANDER 450,2019-02-18,9,11,NM,US,20,112
OUTLANDER 1000,2019-02-25,5,1,NM,US,6,112
OUTLANDER 850,2019-02-25,1,12,NM,US,13,97
OUTLANDER 450,2019-02-25,11,10,NM,US,21,133
OUTLANDER 1000,2019-03-04,2,6,NM,US,8,120
OUTLANDER 850,2019-03-04,3,6,NM,US,9,106
OUTLANDER 450,2019-03-04,7,13,NM,US,20,153
OUTLANDER 1000,2019-03-11,12,5,NM,US,17,137
OUTLANDER 850,2019-03-11,7,11,NM,US,18,124
OUTLANDER 450,2019-03-11,13,6,NM,US,19,172
OUTLANDER 1000,2019-03-18,0,15,NM,US,15,152
OUTLANDER 850,2019-03-18,11,0,NM,US,11,135
OUTLANDER 450,2019-03-18,10,3,NM,US,13,185
OUTLANDER 1000,2019-03-25,11,13,NM,US,24,176
OUTLANDER 850,2019-03-25,7,9,NM,US,16,151
OUTLANDER 450,2019-03-25,13,7,NM,US,20,205
OUTLANDER 1000,2019-04-01,2,10,NM,US,12,188
OUTLANDER 850,2019-04-01,7,9,NM,US,16,167
OUTLANDER 450,2019-04-01,11,4,NM,US,15,220
OUTLANDER 1000,2019-04-08,7,1,NM,US,8,196
OUTLANDER 850,2019-04-08,4,2,NM,US,6,173
OUTLANDER 450,2019-04-08,9,13,NM,US,22,242
OUTLANDER 1000,2019-04-15,11,4,NM,US,15,211
OUTLANDER 850,2019-04-15,3,8,NM,US,11,184
OUTLANDER 450,2019-04-15,13,0,NM,US,13,255
OUTLANDER 1000,2019-04-22,9,12,NM,US,21,232
OUTLANDER 850,2019-04-22,7,9,NM,US,16,200
OUTLANDER 450,2019-04-22,14,2,NM,US,16,271
OUTLANDER 1000,2019-04-29,0,1,NM,US,1,233
OUTLANDER 850,2019-04-29,2,11,NM,US,13,213
OUTLANDER 450,2019-04-29,1,4,NM,US,5,276
OUTLANDER 1000,2019-05-06,14,1,NM,US,15,248
OUTLANDER 850,2019-05-06,3,13,NM,US,16,229
OUTLANDER 450,2019-05-06,4,3,NM,US,7,283
OUTLANDER 1000,2019-05-13,12,7,NM,US,19,267
OUTLANDER 850,2019-05-13,7,6,NM,US,13,242
OUTLANDER 450,2019-05-13,10,8,NM,US,18,301
OUTLANDER 1000,2019-05-20,12,11,NM,US,23,290
OUTLANDER 850,2019-05-20,2,8,NM,US,10,252
OUTLANDER 450,2019-05-20,14,8,NM,US,22,323
OUTLANDER 1000,2019-05-27,5,2,NM,US,7,297
OUTLANDER 850,2019-05-27,5,6,NM,US,11,263
OUTLANDER 450,2019-05-27,11,3,NM,US,14,337
OUTLANDER 1000,2019-06-03,5,6,NM,US,11,308
OUTLANDER 850,2019-06-03,4,15,NM,US,19,282
OUTLANDER 450,2019-06-03,8,2,NM,US,10,347
OUTLANDER 1000,2019-06-10,6,10,NM,US,16,324
OUTLANDER 850,2019-06-10,7,1,NM,US,8,290
OUTLANDER 450,2019-06-10,4,2,NM,US,6,353
OUTLANDER 1000,2019-06-17,6,13,NM,US,19,343
OUTLANDER 850,2019-06-17,13,12,NM,US,25,315
OUTLANDER 450,2019-06-17,2,1,NM,US,3,356
OUTLANDER 1000,2019-06-24,0,4,NM,US,4,347
OUTLANDER 850,2019-06-24,10,12,NM,US,22,337
OUTLANDER 450,2019-06-24,7,2,NM,US,9,365
OUTLANDER 1000,2019-07-01,9,1,NM,US,10,357
OUTLANDER 850,2019-07-01,5,9,NM,US,14,351
OUTLANDER 450,2019-07-01,13,10,NM,US,23,388
OUTLANDER 1000,2019-07-08,12,12,NM,US,24,381
OUTLANDER 850,2019-07-08,15,13,NM,US,28,379
OUTLANDER 450,2019-07-08,11,8,NM,US,19,407
OUTLANDER 1000,2019-07-15,1,7,NM,US,8,389
OUTLANDER 850,2019-07-15,11,11,NM,US,22,401
OUTLANDER 450,2019-07-15,13,3,NM,US,16,423
OUTLANDER 1000,2019-07-22,0,10,NM,US,10,399
OUTLANDER 850,2019-07-22,3,8,NM,US,11,412
OUTLANDER 450,2019-07-22,11,3,NM,US,14,437
OUTLANDER 1000,2019-07-29,5,13,NM,US,18,417
OUTLANDER 850,2019-07-29,6,11,NM,US,17,429
OUTLANDER 450,2019-07-29,13,15,NM,US,28,465
OUTLANDER 1000,2019-08-05,15,9,NM,US,24,441
OUTLANDER 850,2019-08-05,3,2,NM,US,5,434
OUTLANDER 450,2019-08-05,9,11,NM,US,20,485
OUTLANDER 1000,2019-08-12,6,10,NM,US,16,457
OUTLANDER 850,2019-08-12,15,4,NM,US,19,453
OUTLANDER 450,2019-08-12,14,11,NM,US,25,510
OUTLANDER 1000,2019-08-19,10,0,NM,US,10,467
OUTLANDER 850,2019-08-19,10,9,NM,US,19,472
OUTLANDER 450,2019-08-19,8,4,NM,US,12,522
OUTLANDER 1000,2019-08-26,5,11,NM,US,16,483
OUTLANDER 850,2019-08-26,3,3,NM,US,6,478
OUTLANDER 450,2019-08-26,6,13,NM,US,19,541
OUTLANDER 1000,2019-09-02,12,5,NM,US,17,500
OUTLANDER 850,2019-09-02,7,5,NM,US,12,490
OUTLANDER 450,2019-09-02,10,2,NM,US,12,553
OUTLANDER 1000,2019-09-09,13,4,NM,US,17,517
OUTLANDER 850,2019-09-09,5,3,NM,US,8,498
OUTLANDER 450,2019-09-09,14,13,NM,US,27,580
OUTLANDER 1000,2019-09-16,15,12,NM,US,27,544
OUTLANDER 850,2019-09-16,8,3,NM,US,11,509
OUTLANDER 450,2019-09-16,8,7,NM,US,15,595
OUTLANDER 1000,2019-09-23,10,3,NM,US,13,557
OUTLANDER 850,2019-09-23,9,8,NM,US,17,526
OUTLANDER 450,2019-09-23,7,5,NM,US,12,607
OUTLANDER 1000,2019-09-30,1,4,NM,US,5,562
OUTLANDER 850,2019-09-30,6,11,NM,US,17,543
OUTLANDER 450,2019-09-30,8,4,NM,US,12,619
OUTLANDER 1000,2019-10-07,0,8,NM,US,8,570
OUTLANDER 850,2019-10-07,6,11,NM,US,17,560
OUTLANDER 450,2019-10-07,15,10,NM,US,25,644
OUTLANDER 1000,2019-10-14,2,8,NM,US,10,580
OUTLANDER 850,2019-10-14,13,10,NM,US,23,583
OUTLANDER 450,2019-10-14,3,6,NM,US,9,653
OUTLANDER 1000,2019-10-21,12,5,NM,US,17,597
OUTLANDER 850,2019-10-21,1,15,NM,US,16,599
OUTLANDER 450,2019-10-21,13,1,NM,US,14,667
OUTLANDER 1000,2019-10-28,2,11,NM,US,13,610
OUTLANDER 850,2019-10-28,11,5,NM,US,16,615
OUTLANDER 450,2019-10-28,5,1,NM,US,6,673
OUTLANDER 1000,2019-11-04,12,1,NM,US,13,623
OUTLANDER 850,2019-11-04,8,4,NM,US,12,627
OUTLANDER 450,2019-11-04,5,1,NM,US,6,679
OUTLANDER 1000,2019-11-11,4,13,NM,US,17,640
OUTLANDER 850,2019-11-11,14,8,NM,US,22,649
OUTLANDER 450,2019-11-11,4,11,NM,US,15,694
OUTLANDER 1000,2019-11-18,13,10,NM,US,23,663
OUTLANDER 850,2019-11-18,7,6,NM,US,13,662
OUTLANDER 450,2019-11-18,6,10,NM,US,16,710
OUTLANDER 1000,2019-11-25,11,6,NM,US,17,680
OUTLANDER 850,2019-11-25,4,1,NM,US,5,667
OUTLANDER 450,2019-11-25,7,2,NM,US,9,719
OUTLANDER 1000,2019-12-02,1,8,NM,US,9,689
OUTLANDER 850,2019-12-02,14,10,NM,US,24,691
OUTLANDER 450,2019-12-02,14,2,NM,US,16,735
OUTLANDER 1000,2019-12-09,1,3,NM,US,4,693
OUTLANDER 850,2019-12-09,5,2,NM,US,7,698
OUTLANDER 450,2019-12-09,9,4,NM,US,13,748
OUTLANDER 1000,2019-12-16,4,5,NM,US,9,702
OUTLANDER 850,2019-12-16,4,7,NM,US,11,709
OUTLANDER 450,2019-12-16,6,13,NM,US,19,767
OUTLANDER 1000,2019-12-23,8,1,NM,US,9,711
OUTLANDER 850,2019-12-23,1,1,NM,US,2,711
OUTLANDER 450,2019-12-23,2,14,NM,US,16,783
OUTLANDER 1000,2019-12-30,4,3,NM,US,7,718
OUTLANDER 850,2019-12-30,7,10,NM,US,17,728
OUTLANDER 450,2019-12-30,8,4,NM,US,12,795
OUTLANDER 1000,2020-01-06,1,14,NM,US,15,733
OUTLANDER 850,2020-01-06,4,2,NM,US,6,734
OUTLANDER 450,2020-01-06,13,9,NM,US,22,817
OUTLANDER 1000,2020-01-13,3,10,NM,US,13,746
OUTLANDER 850,2020-01-13,2,6,NM,US,8,742
OUTLANDER 450,2020-01-13,8,4,NM,US,12,829
OUTLANDER 1000,2020-01-20,2,6,NM,US,8,754
OUTLANDER 850,2020-01-20,6,6,NM,US,12,754
OUTLANDER 450,2020-01-20,5,10,NM,US,15,844
OUTLANDER 1000,2020-01-27,2,5,NM,US,7,761
OUTLANDER 850,2020-01-27,8,12,NM,US,20,774
OUTLANDER 450,2020-01-27,7,8,NM,US,15,859
OUTLANDER 1000,2020-02-03,3,14,NM,US,17,778
OUTLANDER 850,2020-02-03,0,8,NM,US,8,782
OUTLANDER 450,2020-02-03,10,9,NM,US,19,878
OUTLANDER 1000,2020-02-10,14,7,NM,US,21,799
OUTLANDER 850,2020-02-10,13,0,NM,US,13,795
OUTLANDER 450,2020-02-10,14,10,NM,US,24,902
OUTLANDER 1000,2020-02-17,1,6,NM,US,7,806
OUTLANDER 850,2020-02-17,1,10,NM,US,11,806
OUTLANDER 450,2020-02-17,3,2,NM,US,5,907
OUTLANDER 1000,2020-02-24,15,9,NM,US,24,830
OUTLANDER 850,2020-02-24,5,5,NM,US,10,816
OUTLANDER 450,2020-02-24,6,12,NM,US,18,925
OUTLANDER 1000,2020-03-02,15,5,NM,US,20,850
OUTLANDER 850,2020-03-02,1,10,NM,US,11,827
OUTLANDER 450,2020-03-02,0,14,NM,US,14,939
OUTLANDER 1000,2020-03-09,15,6,NM,US,21,871
OUTLANDER 850,2020-03-09,3,1,NM,US,4,831
OUTLANDER 450,2020-03-09,15,2,NM,US,17,956
OUTLANDER 1000,2020-03-16,10,1,NM,US,11,882
OUTLANDER 850,2020-03-16,1,11,NM,US,12,843
OUTLANDER 450,2020-03-16,5,4,NM,US,9,965
OUTLANDER 1000,2020-03-23,4,7,NM,US,11,893
OUTLANDER 850,2020-03-23,9,11,NM,US,20,863
OUTLANDER 450,2020-03-23,1,14,NM,US,15,980
OUTLANDER 1000,2020-03-30,7,6,NM,US,13,906
OUTLANDER 850,2020-03-30,1,9,NM,US,10,873
OUTLANDER 450,2020-03-30,5,3,NM,US,8,988
OUTLANDER 1000,2020-04-06,14,8,NM,US,22,928
OUTLANDER 850,2020-04-06,12,6,NM,US,18,891
OUTLANDER 450,2020-04-06,1,4,NM,US,5,993
OUTLANDER 1000,2020-04-13,13,2,NM,US,15,943
OUTLANDER 850,2020-04-13,14,12,NM,US,26,917
OUTLANDER 450,2020-04-13,9,3,NM,US,12,1005
OUTLANDER 1000,2020-04-20,7,8,NM,US,15,958
OUTLANDER 850,2020-04-20,1,12,NM,US,13,930
OUTLANDER 450,2020-04-20,2,14,NM,US,16,1021
OUTLANDER 1000,2020-04-27,12,0,NM,US,12,970
OUTLANDER 850,2020-04-27,4,11,NM,US,15,945
OUTLANDER 450,2020-04-27,3,9,NM,US,12,1033
OUTLANDER 1000,2020-05-04,10,3,NM,US,13,983
OUTLANDER 850,2020-05-04,13,4,NM,US,17,962
OUTLANDER 450,2020-05-04,2,13,NM,US,15,1048
OUTLANDER 1000,2020-05-11,6,5,NM,US,11,994
OUTLANDER 850,2020-05-11,13,11,NM,US,24,986
OUTLANDER 450,2020-05-11,2,0,NM,US,2,1050
OUTLANDER 1000,2020-05-18,14,13,NM,US,27,1021
OUTLANDER 850,2020-05-18,13,6,NM,US,19,1005
OUTLANDER 450,2020-05-18,2,12,NM,US,14,1064
OUTLANDER 1000,2020-05-25,6,2,NM,US,8,1029
OUTLANDER 850,2020-05-25,6,15,NM,US,21,1026
OUTLANDER 450,2020-05-25,7,13,NM,US,20,1084
OUTLANDER 1000,2020-06-01,5,4,NM,US,9,1038
OUTLANDER 850,2020-06-01,14,1,NM,US,15,1041
OUTLANDER 450,2020-06-01,10,9,NM,US,19,1103
OUTLANDER 1000,2020-06-08,8,9,NM,US,17,1055
OUTLANDER 850,2020-06-08,12,5,NM,US,17,1058
OUTLANDER 450,2020-06-08,9,8,NM,US,17,1120
OUTLANDER 1000,2020-06-15,0,8,NM,US,8,1063
OUTLANDER 850,2020-06-15,5,0,NM,US,5,1063
OUTLANDER 450,2020-06-15,4,10,NM,US,14,1134
OUTLANDER 1000,2020-06-22,10,0,NM,US,10,1073
OUTLANDER 850,2020-06-22,13,4,NM,US,17,1080
OUTLANDER 450,2020-06-22,12,0,NM,US,12,1146
OUTLANDER 1000,2020-06-29,8,13,NM,US,21,1094
OUTLANDER 850,2020-06-29,5,6,NM,US,11,1091
OUTLANDER 450,2020-06-29,14,10,NM,US,24,1170
OUTLANDER 1000,2020-07-06,1,5,NM,US,6,1100
OUTLANDER 850,2020-07-06,10,14,NM,US,24,1115
OUTLANDER 450,2020-07-06,3,13,NM,US,16,1186
OUTLANDER 1000,2020-07-13,2,0,NM,US,2,1102
OUTLANDER 850,2020-07-13,13,4,NM,US,17,1132
OUTLANDER 450,2020-07-13,5,2,NM,US,7,1193
OUTLANDER 1000,2020-07-20,2,11,NM,US,13,1115
OUTLANDER 850,2020-07-20,10,10,NM,US,20,1152
OUTLANDER 450,2020-07-20,10,7,NM,US,17,1210
OUTLANDER 1000,2020-07-27,10,3,NM,US,13,1128
OUTLANDER 850,2020-07-27,1,1,NM,US,2,1154
OUTLANDER 450,2020-07-27,2,7,NM,US,9,1219
OUTLANDER 1000,2020-08-03,11,1,NM,US,12,1140
OUTLANDER 850,2020-08-03,1,2,NM,US,3,1157
OUTLANDER 450,2020-08-03,7,14,NM,US,21,1240
OUTLANDER 1000,2020-08-10,15,14,NM,US,29,1169
OUTLANDER 850,2020-08-10,3,1,NM,US,4,1161
OUTLANDER 450,2020-08-10,12,3,NM,US,15,1255
OUTLANDER 1000,2020-08-17,8,12,NM,US,20,1189
OUTLANDER 850,2020-08-17,6,3,NM,US,9,1170
OUTLANDER 450,2020-08-17,8,1,NM,US,9,1264
OUTLANDER 1000,2020-08-24,9,3,NM,US,12,1201
OUTLANDER 850,2020-08-24,15,4,NM,US,19,1189
OUTLANDER 450,2020-08-24,13,4,NM,US,17,1281
OUTLANDER 1000,2020-08-31,0,14,NM,US,14,1215
OUTLANDER 850,2020-08-31,6,3,NM,US,9,1198
OUTLANDER 450,2020-08-31,11,9,NM,US,20,1301
OUTLANDER 1000,2020-09-07,8,9,NM,US,17,1232
OUTLANDER 850,2020-09-07,13,8,NM,US,21,1219
OUTLANDER 450,2020-09-07,3,9,NM,US,12,1313
OUTLANDER 1000,2020-09-14,0,10,NM,US,10,1242
OUTLANDER 850,2020-09-14,4,8,NM,US,12,1231
OUTLANDER 450,2020-09-14,5,14,NM,US,19,1332
OUTLANDER 1000,2020-09-21,6,3,NM,US,9,1251
OUTLANDER 850,2020-09-21,9,2,NM,US,11,1242
OUTLANDER 450,2020-09-21,10,7,NM,US,17,1349
OUTLANDER 1000,2020-09-28,4,12,NM,US,16,1267
OUTLANDER 850,2020-09-28,7,1,NM,US,8,1250
OUTLANDER 450,2020-09-28,2,2,NM,US,4,1353
OUTLANDER 1000,2020-10-05,6,3,NM,US,9,1276
OUTLANDER 850,2020-10-05,2,3,NM,US,5,1255
OUTLANDER 450,2020-10-05,11,0,NM,US,11,1364
OUTLANDER 1000,2020-10-12,12,7,NM,US,19,1295
OUTLANDER 850,2020-10-12,5,11,NM,US,16,1271
OUTLANDER 450,2020-10-12,8,2,NM,US,10,1374
OUTLANDER 1000,2020-10-19,4,2,NM,US,6,1301
OUTLANDER 850,2020-10-19,0,4,NM,US,4,1275
OUTLANDER 450,2020-10-19,1,2,NM,US,3,1377
OUTLANDER 1000,2020-10-26,2,15,NM,US,17,1318
OUTLANDER 850,2020-10-26,2,3,NM,US,5,1280
OUTLANDER 450,2020-10-26,12,4,NM,US,16,1393
OUTLANDER 1000,2020-11-02,7,9,NM,US,16,1334
OUTLANDER 850,2020-11-02,0,4,NM,US,4,1284
OUTLANDER 450,2020-11-02,12,13,NM,US,25,1418
OUTLANDER 1000,2020-11-09,11,1,NM,US,12,1346
OUTLANDER 850,2020-11-09,5,9,NM,US,14,1298
OUTLANDER 450,2020-11-09,9,13,NM,US,22,1440
OUTLANDER 1000,2020-11-16,10,3,NM,US,13,1359
OUTLANDER 850,2020-11-16,9,10,NM,US,19,1317
OUTLANDER 450,2020-11-16,7,14,NM,US,21,1461
OUTLANDER 1000,2020-11-23,13,13,NM,US,26,1385
OUTLANDER 850,2020-11-23,8,5,NM,US,13,1330
OUTLANDER 450,2020-11-23,7,9,NM,US,16,1477
OUTLANDER 1000,2020-11-30,6,3,NM,US,9,1394
OUTLANDER 850,2020-11-30,13,7,NM,US,20,1350
OUTLANDER 450,2020-11-30,6,4,NM,US,10,1487
OUTLANDER 1000,2020-12-07,9,11,NM,US,20,1414
OUTLANDER 850,2020-12-07,3,5,NM,US,8,1358
OUTLANDER 450,2020-12-07,14,3,NM,US,17,1504
OUTLANDER 1000,2020-12-14,11,12,NM,US,23,1437
OUTLANDER 850,2020-12-14,12,12,NM,US,24,1382
OUTLANDER 450,2020-12-14,1,5,NM,US,6,1510
OUTLANDER 1000,2020-12-21,9,6,NM,US,15,1452
OUTLANDER 850,2020-12-21,8,4,NM,US,12,1394
OUTLANDER 450,2020-12-21,4,5,NM,US,9,1519
OUTLANDER 1000,2020-12-28,1,7,NM,US,8,1460
OUTLANDER 850,2020-12-28,3,1,NM,US,4,1398
OUTLANDER 450,2020-12-28,1,12,NM,US,13,1532
OUTLANDER 1000,2021-01-04,13,5,NM,US,18,1478
OUTLANDER 850,2021-01-04,1,3,NM,US,4,1402
OUTLANDER 450,2021-01-04,3,3,NM,US,6,1538
OUTLANDER 1000,2021-01-11,13,13,NM,US,26,1504
OUTLANDER 850,2021-01-11,13,12,NM,US,25,1427
OUTLANDER 450,2021-01-11,6,2,NM,US,8,1546
OUTLANDER 1000,2021-01-18,9,10,NM,US,19,1523
OUTLANDER 850,2021-01-18,3,2,NM,US,5,1432
OUTLANDER 450,2021-01-18,4,0,NM,US,4,1550
OUTLANDER 1000,2021-01-25,8,13,NM,US,21,1544
OUTLANDER 850,2021-01-25,1,5,NM,US,6,1438
OUTLANDER 450,2021-01-25,6,2,NM,US,8,1558
OUTLANDER 1000,2021-02-01,14,8,NM,US,22,1566
OUTLANDER 850,2021-02-01,1,0,NM,US,1,1439
OUTLANDER 450,2021-02-01,7,4,NM,US,11,1569
OUTLANDER 1000,2021-02-08,4,3,NM,US,7,1573
OUTLANDER 850,2021-02-08,8,10,NM,US,18,1457
OUTLANDER 450,2021-02-08,5,11,NM,US,16,1585
OUTLANDER 1000,2021-02-15,7,1,NM,US,8,1581
OUTLANDER 850,2021-02-15,8,2,NM,US,10,1467
OUTLANDER 450,2021-02-15,13,6,NM,US,19,1604
OUTLANDER 1000,2021-02-22,7,9,NM,US,16,1597
OUTLANDER 850,2021-02-22,14,11,NM,US,25,1492
OUTLANDER 450,2021-02-22,15,12,NM,US,27,1631
OUTLANDER 1000,2021-03-01,8,15,NM,US,23,1620
OUTLANDER 850,2021-03-01,14,8,NM,US,22,1514
OUTLANDER 450,2021-03-01,7,1,NM,US,8,1639
OUTLANDER 1000,2021-03-08,6,3,NM,US,9,1629
OUTLANDER 850,2021-03-08,2,6,NM,US,8,1522
OUTLANDER 450,2021-03-08,5,9,NM,US,14,1653
OUTLANDER 1000,2021-03-15,14,6,NM,US,20,1649
OUTLANDER 850,2021-03-15,10,13,NM,US,23,1545
OUTLANDER 450,2021-03-15,15,7,NM,US,22,1675
OUTLANDER 1000,2021-03-22,14,8,NM,US,22,1671
OUTLANDER 850,2021-03-22,4,13,NM,US,17,1562
OUTLANDER 450,2021-03-22,2,4,NM,US,6,1681
OUTLANDER 1000,2021-03-29,9,6,NM,US,15,1686
OUTLANDER 850,2021-03-29,3,9,NM,US,12,1574
OUTLANDER 450,2021-03-29,13,8,NM,US,21,1702
OUTLANDER 1000,2021-04-05,6,10,NM,US,16,1702
OUTLANDER 850,2021-04-05,10,14,NM,US,24,1598
OUTLANDER 450,2021-04-05,9,8,NM,US,17,1719
OUTLANDER 1000,2021-04-12,6,11,NM,US,17,1719
OUTLANDER 850,2021-04-12,5,5,NM,US,10,1608
OUTLANDER 450,2021-04-12,11,11,NM,US,22,1741
OUTLANDER 1000,2021-04-19,6,14,NM,US,20,1739
OUTLANDER 850,2021-04-19,6,3,NM,US,9,1617
OUTLANDER 450,2021-04-19,9,1,NM,US,10,1751
OUTLANDER 1000,2021-04-26,14,1,NM,US,15,1754
OUTLANDER 850,2021-04-26,1,11,NM,US,12,1629
OUTLANDER 450,2021-04-26,4,11,NM,US,15,1766
OUTLANDER 1000,2021-05-03,8,2,NM,US,10,1764
OUTLANDER 850,2021-05-03,6,10,NM,US,16,1645
OUTLANDER 450,2021-05-03,2,11,NM,US,13,1779
OUTLANDER 1000,2021-05-10,8,0,NM,US,8,1772
OUTLANDER 850,2021-05-10,12,14,NM,US,26,1671
OUTLANDER 450,2021-05-10,3,13,NM,US,16,1795
OUTLANDER 1000,2021-05-17,1,7,NM,US,8,1780
OUTLANDER 850,2021-05-17,14,10,NM,US,24,1695
OUTLANDER 450,2021-05-17,6,0,NM,US,6,1801
OUTLANDER 1000,2021-05-24,15,5,NM,US,20,1800
OUTLANDER 850,2021-05-24,15,2,NM,US,17,1712
OUTLANDER 450,2021-05-24,3,14,NM,US,17,1818
OUTLANDER 1000,2021-05-31,14,2,NM,US,16,1816
OUTLANDER 850,2021-05-31,3,6,NM,US,9,1721
OUTLANDER 450,2021-05-31,15,11,NM,US,26,1844
OUTLANDER 1000,2021-06-07,1,10,NM,US,11,1827
OUTLANDER 850,2021-06-07,7,8,NM,US,15,1736
OUTLANDER 450,2021-06-07,5,10,NM,US,15,1859
OUTLANDER 1000,2021-06-14,5,4,NM,US,9,1836
OUTLANDER 850,2021-06-14,8,11,NM,US,19,1755
OUTLANDER 450,2021-06-14,2,9,NM,US,11,1870
OUTLANDER 1000,2021-06-21,9,1,NM,US,10,1846
OUTLANDER 850,2021-06-21,15,3,NM,US,18,1773
OUTLANDER 450,2021-06-21,13,9,NM,US,22,1892
OUTLANDER 1000,2021-06-28,12,15,NM,US,27,1873
OUTLANDER 850,2021-06-28,14,5,NM,US,19,1792
OUTLANDER 450,2021-06-28,1,6,NM,US,7,1899
OUTLANDER 1000,2021-07-05,7,7,NM,US,14,1887
OUTLANDER 850,2021-07-05,8,14,NM,US,22,1814
OUTLANDER 450,2021-07-05,2,0,NM,US,2,1901
OUTLANDER 1000,2021-07-12,5,11,NM,US,16,1903
OUTLANDER 850,2021-07-12,3,10,NM,US,13,1827
OUTLANDER 450,2021-07-12,13,6,NM,US,19,1920
OUTLANDER 1000,2021-07-19,14,1,NM,US,15,1918
OUTLANDER 850,2021-07-19,6,14,NM,US,20,1847
OUTLANDER 450,2021-07-19,1,15,NM,US,16,1936
OUTLANDER 1000,2021-07-26,4,9,NM,US,13,1931
OUTLANDER 850,2021-07-26,7,1,NM,US,8,1855
OUTLANDER 450,2021-07-26,15,13,NM,US,28,1964
OUTLANDER 1000,2021-08-02,11,8,NM,US,19,1950
OUTLANDER 850,2021-08-02,8,3,NM,US,11,1866
OUTLANDER 450,2021-08-02,9,10,NM,US,19,1983
OUTLANDER 1000,2021-08-09,0,8,NM,US,8,1958
OUTLANDER 850,2021-08-09,4,10,NM,US,14,1880
OUTLANDER 450,2021-08-09,6,6,NM,US,12,1995
OUTLANDER 1000,2021-08-16,8,3,NM,US,11,1969
OUTLANDER 850,2021-08-16,6,15,NM,US,21,1901
OUTLANDER 450,2021-08-16,3,4,NM,US,7,2002
OUTLANDER 1000,2021-08-23,10,1,NM,US,11,1980
OUTLANDER 850,2021-08-23,1,14,NM,US,15,1916
OUTLANDER 450,2021-08-23,4,2,NM,US,6,2008
OUTLANDER 1000,2021-08-30,10,13,NM,US,23,2003
OUTLANDER 850,2021-08-30,9,12,NM,US,21,1937
OUTLANDER 450,2021-08-30,2,9,NM,US,11,2019
OUTLANDER 1000,2021-09-06,9,2,NM,US,11,2014
OUTLANDER 850,2021-09-06,14,7,NM,US,21,1958
OUTLANDER 450,2021-09-06,11,7,NM,US,18,2037
OUTLANDER 1000,2021-09-13,4,13,NM,US,17,2031
OUTLANDER 850,2021-09-13,4,13,NM,US,17,1975
OUTLANDER 450,2021-09-13,6,1,NM,US,7,2044
OUTLANDER 1000,2021-09-20,0,9,NM,US,9,2040
OUTLANDER 850,2021-09-20,10,11,NM,US,21,1996
OUTLANDER 450,2021-09-20,1,2,NM,US,3,2047
OUTLANDER 1000,2021-09-27,10,10,NM,US,20,2060
OUTLANDER 850,2021-09-27,4,12,NM,US,16,2012
OUTLANDER 450,2021-09-27,5,3,NM,US,8,2055
OUTLANDER 1000,2021-10-04,7,1,NM,US,8,2068
OUTLANDER 850,2021-10-04,15,4,NM,US,19,2031
OUTLANDER 450,2021-10-04,9,10,NM,US,19,2074
OUTLANDER 1000,2021-10-11,13,14,NM,US,27,2095
OUTLANDER 850,2021-10-11,6,11,NM,US,17,2048
OUTLANDER 450,2021-10-11,7,5,NM,US,12,2086
OUTLANDER 1000,2021-10-18,12,5,NM,US,17,2112
OUTLANDER 850,2021-10-18,7,13,NM,US,20,2068
OUTLANDER 450,2021-10-18,4,2,NM,US,6,2092
OUTLANDER 1000,2021-10-25,3,0,NM,US,3,2115
OUTLANDER 850,2021-10-25,15,6,NM,US,21,2089
OUTLANDER 450,2021-10-25,6,7,NM,US,13,2105
OUTLANDER 1000,2021-11-01,3,3,NM,US,6,2121
OUTLANDER 850,2021-11-01,12,1,NM,US,13,2102
OUTLANDER 450,2021-11-01,3,14,NM,US,17,2122
OUTLANDER 1000,2021-11-08,9,13,NM,US,22,2143
OUTLANDER 850,2021-11-08,4,10,NM,US,14,2116
OUTLANDER 450,2021-11-08,12,4,NM,US,16,2138
OUTLANDER 1000,2021-11-15,9,1,NM,US,10,2153
OUTLANDER 850,2021-11-15,3,2,NM,US,5,2121
OUTLANDER 450,2021-11-15,11,2,NM,US,13,2151
OUTLANDER 1000,2021-11-22,3,7,NM,US,10,2163
OUTLANDER 850,2021-11-22,6,15,NM,US,21,2142
OUTLANDER 450,2021-11-22,3,9,NM,US,12,2163
OUTLANDER 1000,2021-11-29,6,1,NM,US,7,2170
OUTLANDER 850,2021-11-29,0,13,NM,US,13,2155
OUTLANDER 450,2021-11-29,0,13,NM,US,13,2176
OUTLANDER 1000,2021-12-06,1,5,NM,US,6,2176
OUTLANDER 850,2021-12-06,10,3,NM,US,13,2168
OUTLANDER 450,2021-12-06,8,4,NM,US,12,2188
OUTLANDER 1000,2021-12-13,10,11,NM,US,21,2197
OUTLANDER 850,2021-12-13,15,5,NM,US,20,2188
OUTLANDER 450,2021-12-13,0,12,NM,US,12,2200
OUTLANDER 1000,2021-12-20,13,8,NM,US,21,2218
OUTLANDER 850,2021-12-20,3,9,NM,US,12,2200
OUTLANDER 450,2021-12-20,15,6,NM,US,21,2221
OUTLANDER 1000,2021-12-27,12,15,NM,US,27,2245
OUTLANDER 850,2021-12-27,3,10,NM,US,13,2213
OUTLANDER 450,2021-12-27,0,3,NM,US,3,2224
OUTLANDER 1000,2019-01-07,4,0,NY,US,4,4
OUTLANDER 850,2019-01-07,12,5,NY,US,17,17
OUTLANDER 450,2019-01-07,10,1,NY,US,11,11
OUTLANDER 1000,2019-01-14,0,3,NY,US,3,7
OUTLANDER 850,2019-01-14,9,10,NY,US,19,36
OUTLANDER 450,2019-01-14,3,10,NY,US,13,24
OUTLANDER 1000,2019-01-21,10,7,NY,US,17,24
OUTLANDER 850,2019-01-21,0,2,NY,US,2,38
OUTLANDER 450,2019-01-21,13,8,NY,US,21,45
OUTLANDER 1000,2019-01-28,12,4,NY,US,16,40
OUTLANDER 850,2019-01-28,8,8,NY,US,16,54
OUTLANDER 450,2019-01-28,10,2,NY,US,12,57
OUTLANDER 1000,2019-02-04,7,11,NY,US,18,58
OUTLANDER 850,2019-02-04,0,5,NY,US,5,59
OUTLANDER 450,2019-02-04,7,13,NY,US,20,77
OUTLANDER 1000,2019-02-11,3,11,NY,US,14,72
OUTLANDER 850,2019-02-11,10,4,NY,US,14,73
OUTLANDER 450,2019-02-11,2,8,NY,US,10,87
OUTLANDER 1000,2019-02-18,0,9,NY,US,9,81
OUTLANDER 850,2019-02-18,10,12,NY,US,22,95
OUTLANDER 450,2019-02-18,4,15,NY,US,19,106
OUTLANDER 1000,2019-02-25,2,12,NY,US,14,95
OUTLANDER 850,2019-02-25,8,10,NY,US,18,113
OUTLANDER 450,2019-02-25,6,5,NY,US,11,117
OUTLANDER 1000,2019-03-04,11,10,NY,US,21,116
OUTLANDER 850,2019-03-04,10,7,NY,US,17,130
OUTLANDER 450,2019-03-04,0,12,NY,US,12,129
OUTLANDER 1000,2019-03-11,6,9,NY,US,15,131
OUTLANDER 850,2019-03-11,10,10,NY,US,20,150
OUTLANDER 450,2019-03-11,11,14,NY,US,25,154
OUTLANDER 1000,2019-03-18,13,9,NY,US,22,153
OUTLANDER 850,2019-03-18,1,11,NY,US,12,162
OUTLANDER 450,2019-03-18,10,13,NY,US,23,177
OUTLANDER 1000,2019-03-25,2,7,NY,US,9,162
OUTLANDER 850,2019-03-25,7,14,NY,US,21,183
OUTLANDER 450,2019-03-25,11,13,NY,US,24,201
OUTLANDER 1000,2019-04-01,6,13,NY,US,19,181
OUTLANDER 850,2019-04-01,12,7,NY,US,19,202
OUTLANDER 450,2019-04-01,3,13,NY,US,16,217
OUTLANDER 1000,2019-04-08,1,14,NY,US,15,196
OUTLANDER 850,2019-04-08,5,10,NY,US,15,217
OUTLANDER 450,2019-04-08,14,13,NY,US,27,244
OUTLANDER 1000,2019-04-15,12,2,NY,US,14,210
OUTLANDER 850,2019-04-15,1,5,NY,US,6,223
OUTLANDER 450,2019-04-15,11,5,NY,US,16,260
OUTLANDER 1000,2019-04-22,1,13,NY,US,14,224
OUTLANDER 850,2019-04-22,13,9,NY,US,22,245
OUTLANDER 450,2019-04-22,3,12,NY,US,15,275
OUTLANDER 1000,2019-04-29,8,6,NY,US,14,238
OUTLANDER 850,2019-04-29,5,9,NY,US,14,259
OUTLANDER 450,2019-04-29,5,4,NY,US,9,284
OUTLANDER 1000,2019-05-06,6,5,NY,US,11,249
OUTLANDER 850,2019-05-06,4,3,NY,US,7,266
OUTLANDER 450,2019-05-06,8,6,NY,US,14,298
OUTLANDER 1000,2019-05-13,8,2,NY,US,10,259
OUTLANDER 850,2019-05-13,8,8,NY,US,16,282
OUTLANDER 450,2019-05-13,5,13,NY,US,18,316
OUTLANDER 1000,2019-05-20,5,10,NY,US,15,274
OUTLANDER 850,2019-05-20,12,4,NY,US,16,298
OUTLANDER 450,2019-05-20,14,9,NY,US,23,339
OUTLANDER 1000,2019-05-27,4,3,NY,US,7,281
OUTLANDER 850,2019-05-27,15,1,NY,US,16,314
OUTLANDER 450,2019-05-27,4,8,NY,US,12,351
OUTLANDER 1000,2019-06-03,13,6,NY,US,19,300
OUTLANDER 850,2019-06-03,13,4,NY,US,17,331
OUTLANDER 450,2019-06-03,8,8,NY,US,16,367
OUTLANDER 1000,2019-06-10,0,8,NY,US,8,308
OUTLANDER 850,2019-06-10,5,15,NY,US,20,351
OUTLANDER 450,2019-06-10,13,7,NY,US,20,387
OUTLANDER 1000,2019-06-17,10,3,NY,US,13,321
OUTLANDER 850,2019-06-17,10,11,NY,US,21,372
OUTLANDER 450,2019-06-17,4,0,NY,US,4,391
OUTLANDER 1000,2019-06-24,12,8,NY,US,20,341
OUTLANDER 850,2019-06-24,7,3,NY,US,10,382
OUTLANDER 450,2019-06-24,3,10,NY,US,13,404
OUTLANDER 1000,2019-07-01,12,9,NY,US,21,362
OUTLANDER 850,2019-07-01,3,4,NY,US,7,389
OUTLANDER 450,2019-07-01,6,2,NY,US,8,412
OUTLANDER 1000,2019-07-08,11,1,NY,US,12,374
OUTLANDER 850,2019-07-08,6,14,NY,US,20,409
OUTLANDER 450,2019-07-08,4,7,NY,US,11,423
OUTLANDER 1000,2019-07-15,8,4,NY,US,12,386
OUTLANDER 850,2019-07-15,2,8,NY,US,10,419
OUTLANDER 450,2019-07-15,2,3,NY,US,5,428
OUTLANDER 1000,2019-07-22,0,2,NY,US,2,388
OUTLANDER 850,2019-07-22,3,6,NY,US,9,428
OUTLANDER 450,2019-07-22,5,6,NY,US,11,439
OUTLANDER 1000,2019-07-29,8,8,NY,US,16,404
OUTLANDER 850,2019-07-29,8,8,NY,US,16,444
OUTLANDER 450,2019-07-29,12,1,NY,US,13,452
OUTLANDER 1000,2019-08-05,3,13,NY,US,16,420
OUTLANDER 850,2019-08-05,12,2,NY,US,14,458
OUTLANDER 450,2019-08-05,9,11,NY,US,20,472
OUTLANDER 1000,2019-08-12,14,2,NY,US,16,436
OUTLANDER 850,2019-08-12,3,12,NY,US,15,473
OUTLANDER 450,2019-08-12,14,3,NY,US,17,489
OUTLANDER 1000,2019-08-19,6,1,NY,US,7,443
OUTLANDER 850,2019-08-19,5,15,NY,US,20,493
OUTLANDER 450,2019-08-19,5,4,NY,US,9,498
OUTLANDER 1000,2019-08-26,12,0,NY,US,12,455
OUTLANDER 850,2019-08-26,9,7,NY,US,16,509
OUTLANDER 450,2019-08-26,9,8,NY,US,17,515
OUTLANDER 1000,2019-09-02,10,11,NY,US,21,476
OUTLANDER 850,2019-09-02,8,8,NY,US,16,525
OUTLANDER 450,2019-09-02,5,4,NY,US,9,524
OUTLANDER 1000,2019-09-09,1,6,NY,US,7,483
OUTLANDER 850,2019-09-09,8,6,NY,US,14,539
OUTLANDER 450,2019-09-09,8,4,NY,US,12,536
OUTLANDER 1000,2019-09-16,8,10,NY,US,18,501
OUTLANDER 850,2019-09-16,10,0,NY,US,10,549
OUTLANDER 450,2019-09-16,3,7,NY,US,10,546
OUTLANDER 1000,2019-09-23,0,13,NY,US,13,514
OUTLANDER 850,2019-09-23,11,13,NY,US,24,573
OUTLANDER 450,2019-09-23,0,6,NY,US,6,552
OUTLANDER 1000,2019-09-30,1,9,NY,US,10,524
OUTLANDER 850,2019-09-30,11,2,NY,US,13,586
OUTLANDER 450,2019-09-30,6,9,NY,US,15,567
OUTLANDER 1000,2019-10-07,5,11,NY,US,16,540
OUTLANDER 850,2019-10-07,14,8,NY,US,22,608
OUTLANDER 450,2019-10-07,4,9,NY,US,13,580
OUTLANDER 1000,2019-10-14,13,0,NY,US,13,553
OUTLANDER 850,2019-10-14,8,6,NY,US,14,622
OUTLANDER 450,2019-10-14,5,13,NY,US,18,598
OUTLANDER 1000,2019-10-21,0,4,NY,US,4,557
OUTLANDER 850,2019-10-21,5,8,NY,US,13,635
OUTLANDER 450,2019-10-21,2,6,NY,US,8,606
OUTLANDER 1000,2019-10-28,14,6,NY,US,20,577
OUTLANDER 850,2019-10-28,11,11,NY,US,22,657
OUTLANDER 450,2019-10-28,7,10,NY,US,17,623
OUTLANDER 1000,2019-11-04,8,1,NY,US,9,586
OUTLANDER 850,2019-11-04,0,14,NY,US,14,671
OUTLANDER 450,2019-11-04,5,3,NY,US,8,631
OUTLANDER 1000,2019-11-11,14,5,NY,US,19,605
OUTLANDER 850,2019-11-11,2,2,NY,US,4,675
OUTLANDER 450,2019-11-11,10,0,NY,US,10,641
OUTLANDER 1000,2019-11-18,1,8,NY,US,9,614
OUTLANDER 850,2019-11-18,14,1,NY,US,15,690
OUTLANDER 450,2019-11-18,14,10,NY,US,24,665
OUTLANDER 1000,2019-11-25,9,6,NY,US,15,629
OUTLANDER 850,2019-11-25,3,2,NY,US,5,695
OUTLANDER 450,2019-11-25,13,5,NY,US,18,683
OUTLANDER 1000,2019-12-02,3,7,NY,US,10,639
OUTLANDER 850,2019-12-02,4,10,NY,US,14,709
OUTLANDER 450,2019-12-02,4,9,NY,US,13,696
OUTLANDER 1000,2019-12-09,9,4,NY,US,13,652
OUTLANDER 850,2019-12-09,9,1,NY,US,10,719
OUTLANDER 450,2019-12-09,5,11,NY,US,16,712
OUTLANDER 1000,2019-12-16,7,3,NY,US,10,662
OUTLANDER 850,2019-12-16,5,10,NY,US,15,734
OUTLANDER 450,2019-12-16,14,10,NY,US,24,736
OUTLANDER 1000,2019-12-23,0,8,NY,US,8,670
OUTLANDER 850,2019-12-23,8,3,NY,US,11,745
OUTLANDER 450,2019-12-23,7,15,NY,US,22,758
OUTLANDER 1000,2019-12-30,3,14,NY,US,17,687
OUTLANDER 850,2019-12-30,6,14,NY,US,20,765
OUTLANDER 450,2019-12-30,13,7,NY,US,20,778
OUTLANDER 1000,2020-01-06,3,13,NY,US,16,703
OUTLANDER 850,2020-01-06,4,3,NY,US,7,772
OUTLANDER 450,2020-01-06,13,8,NY,US,21,799
OUTLANDER 1000,2020-01-13,14,2,NY,US,16,719
OUTLANDER 850,2020-01-13,9,14,NY,US,23,795
OUTLANDER 450,2020-01-13,3,5,NY,US,8,807
OUTLANDER 1000,2020-01-20,4,14,NY,US,18,737
OUTLANDER 850,2020-01-20,9,2,NY,US,11,806
OUTLANDER 450,2020-01-20,2,11,NY,US,13,820
OUTLANDER 1000,2020-01-27,3,0,NY,US,3,740
OUTLANDER 850,2020-01-27,14,7,NY,US,21,827
OUTLANDER 450,2020-01-27,14,10,NY,US,24,844
OUTLANDER 1000,2020-02-03,1,9,NY,US,10,750
OUTLANDER 850,2020-02-03,7,7,NY,US,14,841
OUTLANDER 450,2020-02-03,12,3,NY,US,15,859
OUTLANDER 1000,2020-02-10,10,4,NY,US,14,764
OUTLANDER 850,2020-02-10,8,12,NY,US,20,861
OUTLANDER 450,2020-02-10,7,11,NY,US,18,877
OUTLANDER 1000,2020-02-17,4,1,NY,US,5,769
OUTLANDER 850,2020-02-17,12,6,NY,US,18,879
OUTLANDER 450,2020-02-17,7,12,NY,US,19,896
OUTLANDER 1000,2020-02-24,2,13,NY,US,15,784
OUTLANDER 850,2020-02-24,8,3,NY,US,11,890
OUTLANDER 450,2020-02-24,3,7,NY,US,10,906
OUTLANDER 1000,2020-03-02,3,6,NY,US,9,793
OUTLANDER 850,2020-03-02,14,4,NY,US,18,908
OUTLANDER 450,2020-03-02,1,9,NY,US,10,916
OUTLANDER 1000,2020-03-09,0,5,NY,US,5,798
OUTLANDER 850,2020-03-09,11,3,NY,US,14,922
OUTLANDER 450,2020-03-09,4,2,NY,US,6,922
OUTLANDER 1000,2020-03-16,11,11,NY,US,22,820
OUTLANDER 850,2020-03-16,4,8,NY,US,12,934
OUTLANDER 450,2020-03-16,12,13,NY,US,25,947
OUTLANDER 1000,2020-03-23,3,11,NY,US,14,834
OUTLANDER 850,2020-03-23,12,6,NY,US,18,952
OUTLANDER 450,2020-03-23,15,11,NY,US,26,973
OUTLANDER 1000,2020-03-30,6,5,NY,US,11,845
OUTLANDER 850,2020-03-30,5,11,NY,US,16,968
OUTLANDER 450,2020-03-30,10,4,NY,US,14,987
OUTLANDER 1000,2020-04-06,13,11,NY,US,24,869
OUTLANDER 850,2020-04-06,5,13,NY,US,18,986
OUTLANDER 450,2020-04-06,9,1,NY,US,10,997
OUTLANDER 1000,2020-04-13,9,10,NY,US,19,888
OUTLANDER 850,2020-04-13,10,6,NY,US,16,1002
OUTLANDER 450,2020-04-13,3,9,NY,US,12,1009
OUTLANDER 1000,2020-04-20,15,7,NY,US,22,910
OUTLANDER 850,2020-04-20,15,11,NY,US,26,1028
OUTLANDER 450,2020-04-20,3,2,NY,US,5,1014
OUTLANDER 1000,2020-04-27,1,12,NY,US,13,923
OUTLANDER 850,2020-04-27,3,2,NY,US,5,1033
OUTLANDER 450,2020-04-27,10,2,NY,US,12,1026
OUTLANDER 1000,2020-05-04,8,7,NY,US,15,938
OUTLANDER 850,2020-05-04,15,5,NY,US,20,1053
OUTLANDER 450,2020-05-04,8,4,NY,US,12,1038
OUTLANDER 1000,2020-05-11,13,8,NY,US,21,959
OUTLANDER 850,2020-05-11,2,13,NY,US,15,1068
OUTLANDER 450,2020-05-11,14,13,NY,US,27,1065
OUTLANDER 1000,2020-05-18,3,7,NY,US,10,969
OUTLANDER 850,2020-05-18,6,2,NY,US,8,1076
OUTLANDER 450,2020-05-18,13,1,NY,US,14,1079
OUTLANDER 1000,2020-05-25,2,13,NY,US,15,984
OUTLANDER 850,2020-05-25,8,12,NY,US,20,1096
OUTLANDER 450,2020-05-25,3,5,NY,US,8,1087
OUTLANDER 1000,2020-06-01,1,14,NY,US,15,999
OUTLANDER 850,2020-06-01,14,13,NY,US,27,1123
OUTLANDER 450,2020-06-01,5,3,NY,US,8,1095
OUTLANDER 1000,2020-06-08,8,10,NY,US,18,1017
OUTLANDER 850,2020-06-08,14,4,NY,US,18,1141
OUTLANDER 450,2020-06-08,1,6,NY,US,7,1102
OUTLANDER 1000,2020-06-15,2,2,NY,US,4,1021
OUTLANDER 850,2020-06-15,3,1,NY,US,4,1145
OUTLANDER 450,2020-06-15,4,0,NY,US,4,1106
OUTLANDER 1000,2020-06-22,9,9,NY,US,18,1039
OUTLANDER 850,2020-06-22,15,5,NY,US,20,1165
OUTLANDER 450,2020-06-22,8,2,NY,US,10,1116
OUTLANDER 1000,2020-06-29,1,0,NY,US,1,1040
OUTLANDER 850,2020-06-29,8,5,NY,US,13,1178
OUTLANDER 450,2020-06-29,3,14,NY,US,17,1133
OUTLANDER 1000,2020-07-06,11,14,NY,US,25,1065
OUTLANDER 850,2020-07-06,13,1,NY,US,14,1192
OUTLANDER 450,2020-07-06,8,11,NY,US,19,1152
OUTLANDER 1000,2020-07-13,6,6,NY,US,12,1077
OUTLANDER 850,2020-07-13,1,15,NY,US,16,1208
OUTLANDER 450,2020-07-13,4,6,NY,US,10,1162
OUTLANDER 1000,2020-07-20,8,3,NY,US,11,1088
OUTLANDER 850,2020-07-20,3,10,NY,US,13,1221
OUTLANDER 450,2020-07-20,2,14,NY,US,16,1178
OUTLANDER 1000,2020-07-27,4,13,NY,US,17,1105
OUTLANDER 850,2020-07-27,7,10,NY,US,17,1238
OUTLANDER 450,2020-07-27,0,11,NY,US,11,1189
OUTLANDER 1000,2020-08-03,14,2,NY,US,16,1121
OUTLANDER 850,2020-08-03,1,12,NY,US,13,1251
OUTLANDER 450,2020-08-03,1,4,NY,US,5,1194
OUTLANDER 1000,2020-08-10,12,9,NY,US,21,1142
OUTLANDER 850,2020-08-10,6,4,NY,US,10,1261
OUTLANDER 450,2020-08-10,14,10,NY,US,24,1218
OUTLANDER 1000,2020-08-17,12,9,NY,US,21,1163
OUTLANDER 850,2020-08-17,6,4,NY,US,10,1271
OUTLANDER 450,2020-08-17,12,12,NY,US,24,1242
OUTLANDER 1000,2020-08-24,1,1,NY,US,2,1165
OUTLANDER 850,2020-08-24,8,1,NY,US,9,1280
OUTLANDER 450,2020-08-24,7,6,NY,US,13,1255
OUTLANDER 1000,2020-08-31,1,13,NY,US,14,1179
OUTLANDER 850,2020-08-31,14,5,NY,US,19,1299
OUTLANDER 450,2020-08-31,11,6,NY,US,17,1272
OUTLANDER 1000,2020-09-07,9,8,NY,US,17,1196
OUTLANDER 850,2020-09-07,8,3,NY,US,11,1310
OUTLANDER 450,2020-09-07,4,15,NY,US,19,1291
OUTLANDER 1000,2020-09-14,13,1,NY,US,14,1210
OUTLANDER 850,2020-09-14,10,3,NY,US,13,1323
OUTLANDER 450,2020-09-14,5,5,NY,US,10,1301
OUTLANDER 1000,2020-09-21,1,4,NY,US,5,1215
OUTLANDER 850,2020-09-21,7,4,NY,US,11,1334
OUTLANDER 450,2020-09-21,8,8,NY,US,16,1317
OUTLANDER 1000,2020-09-28,9,9,NY,US,18,1233
OUTLANDER 850,2020-09-28,11,11,NY,US,22,1356
OUTLANDER 450,2020-09-28,9,8,NY,US,17,1334
OUTLANDER 1000,2020-10-05,10,14,NY,US,24,1257
OUTLANDER 850,2020-10-05,14,5,NY,US,19,1375
OUTLANDER 450,2020-10-05,8,5,NY,US,13,1347
OUTLANDER 1000,2020-10-12,13,11,NY,US,24,1281
OUTLANDER 850,2020-10-12,13,12,NY,US,25,1400
OUTLANDER 450,2020-10-12,13,9,NY,US,22,1369
OUTLANDER 1000,2020-10-19,2,9,NY,US,11,1292
OUTLANDER 850,2020-10-19,12,8,NY,US,20,1420
OUTLANDER 450,2020-10-19,10,7,NY,US,17,1386
OUTLANDER 1000,2020-10-26,15,2,NY,US,17,1309
OUTLANDER 850,2020-10-26,13,7,NY,US,20,1440
OUTLANDER 450,2020-10-26,3,11,NY,US,14,1400
OUTLANDER 1000,2020-11-02,12,11,NY,US,23,1332
OUTLANDER 850,2020-11-02,12,14,NY,US,26,1466
OUTLANDER 450,2020-11-02,12,11,NY,US,23,1423
OUTLANDER 1000,2020-11-09,2,12,NY,US,14,1346
OUTLANDER 850,2020-11-09,11,1,NY,US,12,1478
OUTLANDER 450,2020-11-09,7,13,NY,US,20,1443
OUTLANDER 1000,2020-11-16,8,1,NY,US,9,1355
OUTLANDER 850,2020-11-16,12,4,NY,US,16,1494
OUTLANDER 450,2020-11-16,10,11,NY,US,21,1464
OUTLANDER 1000,2020-11-23,1,6,NY,US,7,1362
OUTLANDER 850,2020-11-23,12,10,NY,US,22,1516
OUTLANDER 450,2020-11-23,7,5,NY,US,12,1476
OUTLANDER 1000,2020-11-30,5,9,NY,US,14,1376
OUTLANDER 850,2020-11-30,10,7,NY,US,17,1533
OUTLANDER 450,2020-11-30,14,3,NY,US,17,1493
OUTLANDER 1000,2020-12-07,2,12,NY,US,14,1390
OUTLANDER 850,2020-12-07,4,11,NY,US,15,1548
OUTLANDER 450,2020-12-07,11,1,NY,US,12,1505
OUTLANDER 1000,2020-12-14,9,4,NY,US,13,1403
OUTLANDER 850,2020-12-14,8,14,NY,US,22,1570
OUTLANDER 450,2020-12-14,1,9,NY,US,10,1515
OUTLANDER 1000,2020-12-21,3,1,NY,US,4,1407
OUTLANDER 850,2020-12-21,3,12,NY,US,15,1585
OUTLANDER 450,2020-12-21,3,15,NY,US,18,1533
OUTLANDER 1000,2020-12-28,10,0,NY,US,10,1417
OUTLANDER 850,2020-12-28,13,1,NY,US,14,1599
OUTLANDER 450,2020-12-28,6,15,NY,US,21,1554
OUTLANDER 1000,2021-01-04,1,13,NY,US,14,1431
OUTLANDER 850,2021-01-04,11,10,NY,US,21,1620
OUTLANDER 450,2021-01-04,2,3,NY,US,5,1559
OUTLANDER 1000,2021-01-11,7,8,NY,US,15,1446
OUTLANDER 850,2021-01-11,7,13,NY,US,20,1640
OUTLANDER 450,2021-01-11,2,0,NY,US,2,1561
OUTLANDER 1000,2021-01-18,1,0,NY,US,1,1447
OUTLANDER 850,2021-01-18,1,6,NY,US,7,1647
OUTLANDER 450,2021-01-18,8,3,NY,US,11,1572
OUTLANDER 1000,2021-01-25,7,8,NY,US,15,1462
OUTLANDER 850,2021-01-25,5,13,NY,US,18,1665
OUTLANDER 450,2021-01-25,15,14,NY,US,29,1601
OUTLANDER 1000,2021-02-01,2,6,NY,US,8,1470
OUTLANDER 850,2021-02-01,3,6,NY,US,9,1674
OUTLANDER 450,2021-02-01,13,13,NY,US,26,1627
OUTLANDER 1000,2021-02-08,14,2,NY,US,16,1486
OUTLANDER 850,2021-02-08,3,14,NY,US,17,1691
OUTLANDER 450,2021-02-08,3,13,NY,US,16,1643
OUTLANDER 1000,2021-02-15,0,9,NY,US,9,1495
OUTLANDER 850,2021-02-15,14,7,NY,US,21,1712
OUTLANDER 450,2021-02-15,2,2,NY,US,4,1647
OUTLANDER 1000,2021-02-22,1,3,NY,US,4,1499
OUTLANDER 850,2021-02-22,9,8,NY,US,17,1729
OUTLANDER 450,2021-02-22,4,7,NY,US,11,1658
OUTLANDER 1000,2021-03-01,12,3,NY,US,15,1514
OUTLANDER 850,2021-03-01,9,1,NY,US,10,1739
OUTLANDER 450,2021-03-01,13,6,NY,US,19,1677
OUTLANDER 1000,2021-03-08,7,6,NY,US,13,1527
OUTLANDER 850,2021-03-08,5,14,NY,US,19,1758
OUTLANDER 450,2021-03-08,11,12,NY,US,23,1700
OUTLANDER 1000,2021-03-15,7,6,NY,US,13,1540
OUTLANDER 850,2021-03-15,8,9,NY,US,17,1775
OUTLANDER 450,2021-03-15,1,4,NY,US,5,1705
OUTLANDER 1000,2021-03-22,1,1,NY,US,2,1542
OUTLANDER 850,2021-03-22,7,11,NY,US,18,1793
OUTLANDER 450,2021-03-22,9,6,NY,US,15,1720
OUTLANDER 1000,2021-03-29,5,14,NY,US,19,1561
OUTLANDER 850,2021-03-29,9,3,NY,US,12,1805
OUTLANDER 450,2021-03-29,13,13,NY,US,26,1746
OUTLANDER 1000,2021-04-05,6,1,NY,US,7,1568
OUTLANDER 850,2021-04-05,10,9,NY,US,19,1824
OUTLANDER 450,2021-04-05,9,9,NY,US,18,1764
OUTLANDER 1000,2021-04-12,1,12,NY,US,13,1581
OUTLANDER 850,2021-04-12,10,3,NY,US,13,1837
OUTLANDER 450,2021-04-12,1,5,NY,US,6,1770
OUTLANDER 1000,2021-04-19,8,7,NY,US,15,1596
OUTLANDER 850,2021-04-19,4,8,NY,US,12,1849
OUTLANDER 450,2021-04-19,2,4,NY,US,6,1776
OUTLANDER 1000,2021-04-26,12,4,NY,US,16,1612
OUTLANDER 850,2021-04-26,13,13,NY,US,26,1875
OUTLANDER 450,2021-04-26,10,11,NY,US,21,1797
OUTLANDER 1000,2021-05-03,7,5,NY,US,12,1624
OUTLANDER 850,2021-05-03,8,7,NY,US,15,1890
OUTLANDER 450,2021-05-03,12,7,NY,US,19,1816
OUTLANDER 1000,2021-05-10,7,7,NY,US,14,1638
OUTLANDER 850,2021-05-10,9,13,NY,US,22,1912
OUTLANDER 450,2021-05-10,11,13,NY,US,24,1840
OUTLANDER 1000,2021-05-17,7,6,NY,US,13,1651
OUTLANDER 850,2021-05-17,11,2,NY,US,13,1925
OUTLANDER 450,2021-05-17,11,9,NY,US,20,1860
OUTLANDER 1000,2021-05-24,7,5,NY,US,12,1663
OUTLANDER 850,2021-05-24,5,5,NY,US,10,1935
OUTLANDER 450,2021-05-24,10,12,NY,US,22,1882
OUTLANDER 1000,2021-05-31,7,6,NY,US,13,1676
OUTLANDER 850,2021-05-31,6,9,NY,US,15,1950
OUTLANDER 450,2021-05-31,6,4,NY,US,10,1892
OUTLANDER 1000,2021-06-07,4,8,NY,US,12,1688
OUTLANDER 850,2021-06-07,2,5,NY,US,7,1957
OUTLANDER 450,2021-06-07,15,3,NY,US,18,1910
OUTLANDER 1000,2021-06-14,10,1,NY,US,11,1699
OUTLANDER 850,2021-06-14,12,8,NY,US,20,1977
OUTLANDER 450,2021-06-14,2,14,NY,US,16,1926
OUTLANDER 1000,2021-06-21,12,1,NY,US,13,1712
OUTLANDER 850,2021-06-21,13,1,NY,US,14,1991
OUTLANDER 450,2021-06-21,14,12,NY,US,26,1952
OUTLANDER 1000,2021-06-28,2,15,NY,US,17,1729
OUTLANDER 850,2021-06-28,5,7,NY,US,12,2003
OUTLANDER 450,2021-06-28,2,10,NY,US,12,1964
OUTLANDER 1000,2021-07-05,6,10,NY,US,16,1745
OUTLANDER 850,2021-07-05,6,2,NY,US,8,2011
OUTLANDER 450,2021-07-05,10,8,NY,US,18,1982
OUTLANDER 1000,2021-07-12,14,15,NY,US,29,1774
OUTLANDER 850,2021-07-12,12,3,NY,US,15,2026
OUTLANDER 450,2021-07-12,5,7,NY,US,12,1994
OUTLANDER 1000,2021-07-19,5,14,NY,US,19,1793
OUTLANDER 850,2021-07-19,5,0,NY,US,5,2031
OUTLANDER 450,2021-07-19,2,4,NY,US,6,2000
OUTLANDER 1000,2021-07-26,0,11,NY,US,11,1804
OUTLANDER 850,2021-07-26,13,6,NY,US,19,2050
OUTLANDER 450,2021-07-26,8,13,NY,US,21,2021
OUTLANDER 1000,2021-08-02,5,14,NY,US,19,1823
OUTLANDER 850,2021-08-02,7,13,NY,US,20,2070
OUTLANDER 450,2021-08-02,12,11,NY,US,23,2044
OUTLANDER 1000,2021-08-09,9,4,NY,US,13,1836
OUTLANDER 850,2021-08-09,12,7,NY,US,19,2089
OUTLANDER 450,2021-08-09,7,4,NY,US,11,2055
OUTLANDER 1000,2021-08-16,14,10,NY,US,24,1860
OUTLANDER 850,2021-08-16,2,11,NY,US,13,2102
OUTLANDER 450,2021-08-16,5,6,NY,US,11,2066
OUTLANDER 1000,2021-08-23,3,9,NY,US,12,1872
OUTLANDER 850,2021-08-23,2,8,NY,US,10,2112
OUTLANDER 450,2021-08-23,5,6,NY,US,11,2077
OUTLANDER 1000,2021-08-30,1,7,NY,US,8,1880
OUTLANDER 850,2021-08-30,15,13,NY,US,28,2140
OUTLANDER 450,2021-08-30,3,6,NY,US,9,2086
OUTLANDER 1000,2021-09-06,12,0,NY,US,12,1892
OUTLANDER 850,2021-09-06,3,6,NY,US,9,2149
OUTLANDER 450,2021-09-06,9,2,NY,US,11,2097
OUTLANDER 1000,2021-09-13,10,8,NY,US,18,1910
OUTLANDER 850,2021-09-13,12,5,NY,US,17,2166
OUTLANDER 450,2021-09-13,2,1,NY,US,3,2100
OUTLANDER 1000,2021-09-20,6,9,NY,US,15,1925
OUTLANDER 850,2021-09-20,4,12,NY,US,16,2182
OUTLANDER 450,2021-09-20,6,8,NY,US,14,2114
OUTLANDER 1000,2021-09-27,7,8,NY,US,15,1940
OUTLANDER 850,2021-09-27,7,4,NY,US,11,2193
OUTLANDER 450,2021-09-27,5,12,NY,US,17,2131
OUTLANDER 1000,2021-10-04,4,8,NY,US,12,1952
OUTLANDER 850,2021-10-04,5,11,NY,US,16,2209
OUTLANDER 450,2021-10-04,13,10,NY,US,23,2154
OUTLANDER 1000,2021-10-11,4,4,NY,US,8,1960
OUTLANDER 850,2021-10-11,1,2,NY,US,3,2212
OUTLANDER 450,2021-10-11,15,14,NY,US,29,2183
OUTLANDER 1000,2021-10-18,4,1,NY,US,5,1965
OUTLANDER 850,2021-10-18,3,2,NY,US,5,2217
OUTLANDER 450,2021-10-18,11,6,NY,US,17,2200
OUTLANDER 1000,2021-10-25,12,4,NY,US,16,1981
OUTLANDER 850,2021-10-25,5,9,NY,US,14,2231
OUTLANDER 450,2021-10-25,7,0,NY,US,7,2207
OUTLANDER 1000,2021-11-01,15,11,NY,US,26,2007
OUTLANDER 850,2021-11-01,3,9,NY,US,12,2243
OUTLANDER 450,2021-11-01,14,6,NY,US,20,2227
OUTLANDER 1000,2021-11-08,5,5,NY,US,10,2017
OUTLANDER 850,2021-11-08,4,15,NY,US,19,2262
OUTLANDER 450,2021-11-08,10,12,NY,US,22,2249
OUTLANDER 1000,2021-11-15,4,0,NY,US,4,2021
OUTLANDER 850,2021-11-15,2,6,NY,US,8,2270
OUTLANDER 450,2021-11-15,11,1,NY,US,12,2261
OUTLANDER 1000,2021-11-22,8,13,NY,US,21,2042
OUTLANDER 850,2021-11-22,14,7,NY,US,21,2291
OUTLANDER 450,2021-11-22,7,8,NY,US,15,2276
OUTLANDER 1000,2021-11-29,11,14,NY,US,25,2067
OUTLANDER 850,2021-11-29,6,12,NY,US,18,2309
OUTLANDER 450,2021-11-29,9,14,NY,US,23,2299
OUTLANDER 1000,2021-12-06,11,14,NY,US,25,2092
OUTLANDER 850,2021-12-06,13,5,NY,US,18,2327
OUTLANDER 450,2021-12-06,9,15,NY,US,24,2323
OUTLANDER 1000,2021-12-13,9,2,NY,US,11,2103
OUTLANDER 850,2021-12-13,5,5,NY,US,10,2337
OUTLANDER 450,2021-12-13,4,13,NY,US,17,2340
OUTLANDER 1000,2021-12-20,1,11,NY,US,12,2115
OUTLANDER 850,2021-12-20,5,0,NY,US,5,2342
OUTLANDER 450,2021-12-20,15,1,NY,US,16,2356
OUTLANDER 1000,2021-12-27,3,3,NY,US,6,2121
OUTLANDER 850,2021-12-27,14,14,NY,US,28,2370
OUTLANDER 450,2021-12-27,13,11,NY,US,24,2380
OUTLANDER 1000,2019-01-07,10,8,NC,US,18,18
OUTLANDER 850,2019-01-07,5,10,NC,US,15,15
OUTLANDER 450,2019-01-07,13,15,NC,US,28,28
OUTLANDER 1000,2019-01-14,1,7,NC,US,8,26
OUTLANDER 850,2019-01-14,8,11,NC,US,19,34
OUTLANDER 450,2019-01-14,7,4,NC,US,11,39
OUTLANDER 1000,2019-01-21,1,10,NC,US,11,37
OUTLANDER 850,2019-01-21,2,1,NC,US,3,37
OUTLANDER 450,2019-01-21,5,11,NC,US,16,55
OUTLANDER 1000,2019-01-28,7,12,NC,US,19,56
OUTLANDER 850,2019-01-28,6,14,NC,US,20,57
OUTLANDER 450,2019-01-28,11,10,NC,US,21,76
OUTLANDER 1000,2019-02-04,12,11,NC,US,23,79
OUTLANDER 850,2019-02-04,0,4,NC,US,4,61
OUTLANDER 450,2019-02-04,12,13,NC,US,25,101
OUTLANDER 1000,2019-02-11,4,5,NC,US,9,88
OUTLANDER 850,2019-02-11,3,8,NC,US,11,72
OUTLANDER 450,2019-02-11,14,12,NC,US,26,127
OUTLANDER 1000,2019-02-18,2,3,NC,US,5,93
OUTLANDER 850,2019-02-18,0,2,NC,US,2,74
OUTLANDER 450,2019-02-18,8,7,NC,US,15,142
OUTLANDER 1000,2019-02-25,9,6,NC,US,15,108
OUTLANDER 850,2019-02-25,3,13,NC,US,16,90
OUTLANDER 450,2019-02-25,6,9,NC,US,15,157
OUTLANDER 1000,2019-03-04,8,1,NC,US,9,117
OUTLANDER 850,2019-03-04,6,9,NC,US,15,105
OUTLANDER 450,2019-03-04,14,14,NC,US,28,185
OUTLANDER 1000,2019-03-11,10,0,NC,US,10,127
OUTLANDER 850,2019-03-11,3,5,NC,US,8,113
OUTLANDER 450,2019-03-11,13,11,NC,US,24,209
OUTLANDER 1000,2019-03-18,11,4,NC,US,15,142
OUTLANDER 850,2019-03-18,5,4,NC,US,9,122
OUTLANDER 450,2019-03-18,10,6,NC,US,16,225
OUTLANDER 1000,2019-03-25,9,4,NC,US,13,155
OUTLANDER 850,2019-03-25,8,7,NC,US,15,137
OUTLANDER 450,2019-03-25,4,7,NC,US,11,236
OUTLANDER 1000,2019-04-01,2,6,NC,US,8,163
OUTLANDER 850,2019-04-01,4,11,NC,US,15,152
OUTLANDER 450,2019-04-01,12,0,NC,US,12,248
OUTLANDER 1000,2019-04-08,14,2,NC,US,16,179
OUTLANDER 850,2019-04-08,1,10,NC,US,11,163
OUTLANDER 450,2019-04-08,6,4,NC,US,10,258
OUTLANDER 1000,2019-04-15,4,7,NC,US,11,190
OUTLANDER 850,2019-04-15,5,3,NC,US,8,171
OUTLANDER 450,2019-04-15,11,11,NC,US,22,280
OUTLANDER 1000,2019-04-22,13,8,NC,US,21,211
OUTLANDER 850,2019-04-22,11,13,NC,US,24,195
OUTLANDER 450,2019-04-22,6,11,NC,US,17,297
OUTLANDER 1000,2019-04-29,9,9,NC,US,18,229
OUTLANDER 850,2019-04-29,5,5,NC,US,10,205
OUTLANDER 450,2019-04-29,4,1,NC,US,5,302
OUTLANDER 1000,2019-05-06,1,2,NC,US,3,232
OUTLANDER 850,2019-05-06,6,10,NC,US,16,221
OUTLANDER 450,2019-05-06,13,9,NC,US,22,324
OUTLANDER 1000,2019-05-13,6,14,NC,US,20,252
OUTLANDER 850,2019-05-13,6,9,NC,US,15,236
OUTLANDER 450,2019-05-13,11,5,NC,US,16,340
OUTLANDER 1000,2019-05-20,9,3,NC,US,12,264
OUTLANDER 850,2019-05-20,11,10,NC,US,21,257
OUTLANDER 450,2019-05-20,4,1,NC,US,5,345
OUTLANDER 1000,2019-05-27,11,8,NC,US,19,283
OUTLANDER 850,2019-05-27,5,5,NC,US,10,267
OUTLANDER 450,2019-05-27,2,4,NC,US,6,351
OUTLANDER 1000,2019-06-03,12,1,NC,US,13,296
OUTLANDER 850,2019-06-03,8,2,NC,US,10,277
OUTLANDER 450,2019-06-03,5,6,NC,US,11,362
OUTLANDER 1000,2019-06-10,7,14,NC,US,21,317
OUTLANDER 850,2019-06-10,5,7,NC,US,12,289
OUTLANDER 450,2019-06-10,7,10,NC,US,17,379
OUTLANDER 1000,2019-06-17,11,14,NC,US,25,342
OUTLANDER 850,2019-06-17,15,9,NC,US,24,313
OUTLANDER 450,2019-06-17,1,11,NC,US,12,391
OUTLANDER 1000,2019-06-24,8,12,NC,US,20,362
OUTLANDER 850,2019-06-24,10,12,NC,US,22,335
OUTLANDER 450,2019-06-24,8,2,NC,US,10,401
OUTLANDER 1000,2019-07-01,5,7,NC,US,12,374
OUTLANDER 850,2019-07-01,8,13,NC,US,21,356
OUTLANDER 450,2019-07-01,8,9,NC,US,17,418
OUTLANDER 1000,2019-07-08,4,10,NC,US,14,388
OUTLANDER 850,2019-07-08,3,15,NC,US,18,374
OUTLANDER 450,2019-07-08,3,12,NC,US,15,433
OUTLANDER 1000,2019-07-15,8,9,NC,US,17,405
OUTLANDER 850,2019-07-15,12,6,NC,US,18,392
OUTLANDER 450,2019-07-15,4,8,NC,US,12,445
OUTLANDER 1000,2019-07-22,4,8,NC,US,12,417
OUTLANDER 850,2019-07-22,3,6,NC,US,9,401
OUTLANDER 450,2019-07-22,13,7,NC,US,20,465
OUTLANDER 1000,2019-07-29,11,4,NC,US,15,432
OUTLANDER 850,2019-07-29,2,2,NC,US,4,405
OUTLANDER 450,2019-07-29,7,6,NC,US,13,478
OUTLANDER 1000,2019-08-05,13,5,NC,US,18,450
OUTLANDER 850,2019-08-05,3,9,NC,US,12,417
OUTLANDER 450,2019-08-05,8,12,NC,US,20,498
OUTLANDER 1000,2019-08-12,4,12,NC,US,16,466
OUTLANDER 850,2019-08-12,15,10,NC,US,25,442
OUTLANDER 450,2019-08-12,1,10,NC,US,11,509
OUTLANDER 1000,2019-08-19,3,11,NC,US,14,480
OUTLANDER 850,2019-08-19,5,4,NC,US,9,451
OUTLANDER 450,2019-08-19,12,11,NC,US,23,532
OUTLANDER 1000,2019-08-26,9,2,NC,US,11,491
OUTLANDER 850,2019-08-26,3,11,NC,US,14,465
OUTLANDER 450,2019-08-26,2,7,NC,US,9,541
OUTLANDER 1000,2019-09-02,6,10,NC,US,16,507
OUTLANDER 850,2019-09-02,2,10,NC,US,12,477
OUTLANDER 450,2019-09-02,15,1,NC,US,16,557
OUTLANDER 1000,2019-09-09,3,11,NC,US,14,521
OUTLANDER 850,2019-09-09,12,0,NC,US,12,489
OUTLANDER 450,2019-09-09,13,9,NC,US,22,579
OUTLANDER 1000,2019-09-16,11,12,NC,US,23,544
OUTLANDER 850,2019-09-16,0,6,NC,US,6,495
OUTLANDER 450,2019-09-16,5,9,NC,US,14,593
OUTLANDER 1000,2019-09-23,13,5,NC,US,18,562
OUTLANDER 850,2019-09-23,10,5,NC,US,15,510
OUTLANDER 450,2019-09-23,10,7,NC,US,17,610
OUTLANDER 1000,2019-09-30,3,4,NC,US,7,569
OUTLANDER 850,2019-09-30,6,13,NC,US,19,529
OUTLANDER 450,2019-09-30,5,3,NC,US,8,618
OUTLANDER 1000,2019-10-07,3,0,NC,US,3,572
OUTLANDER 850,2019-10-07,0,3,NC,US,3,532
OUTLANDER 450,2019-10-07,12,6,NC,US,18,636
OUTLANDER 1000,2019-10-14,10,7,NC,US,17,589
OUTLANDER 850,2019-10-14,4,11,NC,US,15,547
OUTLANDER 450,2019-10-14,11,1,NC,US,12,648
OUTLANDER 1000,2019-10-21,9,1,NC,US,10,599
OUTLANDER 850,2019-10-21,6,3,NC,US,9,556
OUTLANDER 450,2019-10-21,11,13,NC,US,24,672
OUTLANDER 1000,2019-10-28,4,2,NC,US,6,605
OUTLANDER 850,2019-10-28,13,15,NC,US,28,584
OUTLANDER 450,2019-10-28,9,10,NC,US,19,691
OUTLANDER 1000,2019-11-04,13,13,NC,US,26,631
OUTLANDER 850,2019-11-04,15,2,NC,US,17,601
OUTLANDER 450,2019-11-04,15,2,NC,US,17,708
OUTLANDER 1000,2019-11-11,7,10,NC,US,17,648
OUTLANDER 850,2019-11-11,3,2,NC,US,5,606
OUTLANDER 450,2019-11-11,12,10,NC,US,22,730
OUTLANDER 1000,2019-11-18,6,12,NC,US,18,666
OUTLANDER 850,2019-11-18,3,11,NC,US,14,620
OUTLANDER 450,2019-11-18,5,7,NC,US,12,742
OUTLANDER 1000,2019-11-25,5,7,NC,US,12,678
OUTLANDER 850,2019-11-25,13,3,NC,US,16,636
OUTLANDER 450,2019-11-25,7,10,NC,US,17,759
OUTLANDER 1000,2019-12-02,10,3,NC,US,13,691
OUTLANDER 850,2019-12-02,4,15,NC,US,19,655
OUTLANDER 450,2019-12-02,1,7,NC,US,8,767
OUTLANDER 1000,2019-12-09,7,1,NC,US,8,699
OUTLANDER 850,2019-12-09,1,3,NC,US,4,659
OUTLANDER 450,2019-12-09,6,6,NC,US,12,779
OUTLANDER 1000,2019-12-16,9,4,NC,US,13,712
OUTLANDER 850,2019-12-16,4,2,NC,US,6,665
OUTLANDER 450,2019-12-16,9,1,NC,US,10,789
OUTLANDER 1000,2019-12-23,10,13,NC,US,23,735
OUTLANDER 850,2019-12-23,11,14,NC,US,25,690
OUTLANDER 450,2019-12-23,3,13,NC,US,16,805
OUTLANDER 1000,2019-12-30,1,11,NC,US,12,747
OUTLANDER 850,2019-12-30,11,14,NC,US,25,715
OUTLANDER 450,2019-12-30,9,4,NC,US,13,818
OUTLANDER 1000,2020-01-06,3,12,NC,US,15,762
OUTLANDER 850,2020-01-06,9,13,NC,US,22,737
OUTLANDER 450,2020-01-06,3,1,NC,US,4,822
OUTLANDER 1000,2020-01-13,14,4,NC,US,18,780
OUTLANDER 850,2020-01-13,6,14,NC,US,20,757
OUTLANDER 450,2020-01-13,14,1,NC,US,15,837
OUTLANDER 1000,2020-01-20,12,8,NC,US,20,800
OUTLANDER 850,2020-01-20,2,14,NC,US,16,773
OUTLANDER 450,2020-01-20,5,7,NC,US,12,849
OUTLANDER 1000,2020-01-27,8,9,NC,US,17,817
OUTLANDER 850,2020-01-27,11,1,NC,US,12,785
OUTLANDER 450,2020-01-27,12,3,NC,US,15,864
OUTLANDER 1000,2020-02-03,5,6,NC,US,11,828
OUTLANDER 850,2020-02-03,14,7,NC,US,21,806
OUTLANDER 450,2020-02-03,11,6,NC,US,17,881
OUTLANDER 1000,2020-02-10,3,8,NC,US,11,839
OUTLANDER 850,2020-02-10,15,2,NC,US,17,823
OUTLANDER 450,2020-02-10,1,0,NC,US,1,882
OUTLANDER 1000,2020-02-17,14,3,NC,US,17,856
OUTLANDER 850,2020-02-17,12,5,NC,US,17,840
OUTLANDER 450,2020-02-17,3,8,NC,US,11,893
OUTLANDER 1000,2020-02-24,1,2,NC,US,3,859
OUTLANDER 850,2020-02-24,11,2,NC,US,13,853
OUTLANDER 450,2020-02-24,12,5,NC,US,17,910
OUTLANDER 1000,2020-03-02,2,11,NC,US,13,872
OUTLANDER 850,2020-03-02,4,4,NC,US,8,861
OUTLANDER 450,2020-03-02,1,2,NC,US,3,913
OUTLANDER 1000,2020-03-09,11,11,NC,US,22,894
OUTLANDER 850,2020-03-09,1,15,NC,US,16,877
OUTLANDER 450,2020-03-09,6,2,NC,US,8,921
OUTLANDER 1000,2020-03-16,10,1,NC,US,11,905
OUTLANDER 850,2020-03-16,13,5,NC,US,18,895
OUTLANDER 450,2020-03-16,4,5,NC,US,9,930
OUTLANDER 1000,2020-03-23,6,7,NC,US,13,918
OUTLANDER 850,2020-03-23,12,5,NC,US,17,912
OUTLANDER 450,2020-03-23,7,13,NC,US,20,950
OUTLANDER 1000,2020-03-30,14,8,NC,US,22,940
OUTLANDER 850,2020-03-30,0,15,NC,US,15,927
OUTLANDER 450,2020-03-30,13,10,NC,US,23,973
OUTLANDER 1000,2020-04-06,3,1,NC,US,4,944
OUTLANDER 850,2020-04-06,8,7,NC,US,15,942
OUTLANDER 450,2020-04-06,10,0,NC,US,10,983
OUTLANDER 1000,2020-04-13,5,7,NC,US,12,956
OUTLANDER 850,2020-04-13,14,6,NC,US,20,962
OUTLANDER 450,2020-04-13,12,2,NC,US,14,997
OUTLANDER 1000,2020-04-20,12,0,NC,US,12,968
OUTLANDER 850,2020-04-20,7,9,NC,US,16,978
OUTLANDER 450,2020-04-20,9,3,NC,US,12,1009
OUTLANDER 1000,2020-04-27,1,8,NC,US,9,977
OUTLANDER 850,2020-04-27,1,9,NC,US,10,988
OUTLANDER 450,2020-04-27,4,2,NC,US,6,1015
OUTLANDER 1000,2020-05-04,9,11,NC,US,20,997
OUTLANDER 850,2020-05-04,10,4,NC,US,14,1002
OUTLANDER 450,2020-05-04,2,14,NC,US,16,1031
OUTLANDER 1000,2020-05-11,3,14,NC,US,17,1014
OUTLANDER 850,2020-05-11,14,5,NC,US,19,1021
OUTLANDER 450,2020-05-11,2,10,NC,US,12,1043
OUTLANDER 1000,2020-05-18,3,9,NC,US,12,1026
OUTLANDER 850,2020-05-18,13,12,NC,US,25,1046
OUTLANDER 450,2020-05-18,4,5,NC,US,9,1052
OUTLANDER 1000,2020-05-25,5,3,NC,US,8,1034
OUTLANDER 850,2020-05-25,5,4,NC,US,9,1055
OUTLANDER 450,2020-05-25,3,12,NC,US,15,1067
OUTLANDER 1000,2020-06-01,15,11,NC,US,26,1060
OUTLANDER 850,2020-06-01,3,3,NC,US,6,1061
OUTLANDER 450,2020-06-01,8,4,NC,US,12,1079
OUTLANDER 1000,2020-06-08,6,4,NC,US,10,1070
OUTLANDER 850,2020-06-08,13,8,NC,US,21,1082
OUTLANDER 450,2020-06-08,11,10,NC,US,21,1100
OUTLANDER 1000,2020-06-15,14,11,NC,US,25,1095
OUTLANDER 850,2020-06-15,1,7,NC,US,8,1090
OUTLANDER 450,2020-06-15,10,13,NC,US,23,1123
OUTLANDER 1000,2020-06-22,0,6,NC,US,6,1101
OUTLANDER 850,2020-06-22,13,10,NC,US,23,1113
OUTLANDER 450,2020-06-22,9,10,NC,US,19,1142
OUTLANDER 1000,2020-06-29,10,7,NC,US,17,1118
OUTLANDER 850,2020-06-29,10,7,NC,US,17,1130
OUTLANDER 450,2020-06-29,10,0,NC,US,10,1152
OUTLANDER 1000,2020-07-06,10,10,NC,US,20,1138
OUTLANDER 850,2020-07-06,13,1,NC,US,14,1144
OUTLANDER 450,2020-07-06,6,4,NC,US,10,1162
OUTLANDER 1000,2020-07-13,9,1,NC,US,10,1148
OUTLANDER 850,2020-07-13,2,15,NC,US,17,1161
OUTLANDER 450,2020-07-13,12,4,NC,US,16,1178
OUTLANDER 1000,2020-07-20,2,3,NC,US,5,1153
OUTLANDER 850,2020-07-20,9,4,NC,US,13,1174
OUTLANDER 450,2020-07-20,1,3,NC,US,4,1182
OUTLANDER 1000,2020-07-27,2,6,NC,US,8,1161
OUTLANDER 850,2020-07-27,6,9,NC,US,15,1189
OUTLANDER 450,2020-07-27,1,1,NC,US,2,1184
OUTLANDER 1000,2020-08-03,8,11,NC,US,19,1180
OUTLANDER 850,2020-08-03,6,5,NC,US,11,1200
OUTLANDER 450,2020-08-03,4,8,NC,US,12,1196
OUTLANDER 1000,2020-08-10,7,2,NC,US,9,1189
OUTLANDER 850,2020-08-10,3,10,NC,US,13,1213
OUTLANDER 450,2020-08-10,7,3,NC,US,10,1206
OUTLANDER 1000,2020-08-17,7,8,NC,US,15,1204
OUTLANDER 850,2020-08-17,15,6,NC,US,21,1234
OUTLANDER 450,2020-08-17,15,2,NC,US,17,1223
OUTLANDER 1000,2020-08-24,3,6,NC,US,9,1213
OUTLANDER 850,2020-08-24,13,11,NC,US,24,1258
OUTLANDER 450,2020-08-24,7,14,NC,US,21,1244
OUTLANDER 1000,2020-08-31,5,9,NC,US,14,1227
OUTLANDER 850,2020-08-31,14,6,NC,US,20,1278
OUTLANDER 450,2020-08-31,10,2,NC,US,12,1256
OUTLANDER 1000,2020-09-07,13,10,NC,US,23,1250
OUTLANDER 850,2020-09-07,3,6,NC,US,9,1287
OUTLANDER 450,2020-09-07,11,10,NC,US,21,1277
OUTLANDER 1000,2020-09-14,9,15,NC,US,24,1274
OUTLANDER 850,2020-09-14,2,3,NC,US,5,1292
OUTLANDER 450,2020-09-14,10,5,NC,US,15,1292
OUTLANDER 1000,2020-09-21,4,1,NC,US,5,1279
OUTLANDER 850,2020-09-21,3,12,NC,US,15,1307
OUTLANDER 450,2020-09-21,0,13,NC,US,13,1305
OUTLANDER 1000,2020-09-28,9,3,NC,US,12,1291
OUTLANDER 850,2020-09-28,1,6,NC,US,7,1314
OUTLANDER 450,2020-09-28,15,8,NC,US,23,1328
OUTLANDER 1000,2020-10-05,0,6,NC,US,6,1297
OUTLANDER 850,2020-10-05,8,6,NC,US,14,1328
OUTLANDER 450,2020-10-05,7,3,NC,US,10,1338
OUTLANDER 1000,2020-10-12,9,15,NC,US,24,1321
OUTLANDER 850,2020-10-12,12,6,NC,US,18,1346
OUTLANDER 450,2020-10-12,3,3,NC,US,6,1344
OUTLANDER 1000,2020-10-19,9,7,NC,US,16,1337
OUTLANDER 850,2020-10-19,0,9,NC,US,9,1355
OUTLANDER 450,2020-10-19,15,15,NC,US,30,1374
OUTLANDER 1000,2020-10-26,8,4,NC,US,12,1349
OUTLANDER 850,2020-10-26,5,13,NC,US,18,1373
OUTLANDER 450,2020-10-26,3,11,NC,US,14,1388
OUTLANDER 1000,2020-11-02,12,13,NC,US,25,1374
OUTLANDER 850,2020-11-02,11,13,NC,US,24,1397
OUTLANDER 450,2020-11-02,3,4,NC,US,7,1395
OUTLANDER 1000,2020-11-09,11,1,NC,US,12,1386
OUTLANDER 850,2020-11-09,12,11,NC,US,23,1420
OUTLANDER 450,2020-11-09,5,4,NC,US,9,1404
OUTLANDER 1000,2020-11-16,10,5,NC,US,15,1401
OUTLANDER 850,2020-11-16,13,6,NC,US,19,1439
OUTLANDER 450,2020-11-16,9,8,NC,US,17,1421
OUTLANDER 1000,2020-11-23,10,4,NC,US,14,1415
OUTLANDER 850,2020-11-23,5,5,NC,US,10,1449
OUTLANDER 450,2020-11-23,4,12,NC,US,16,1437
OUTLANDER 1000,2020-11-30,13,11,NC,US,24,1439
OUTLANDER 850,2020-11-30,1,4,NC,US,5,1454
OUTLANDER 450,2020-11-30,10,10,NC,US,20,1457
OUTLANDER 1000,2020-12-07,12,7,NC,US,19,1458
OUTLANDER 850,2020-12-07,11,10,NC,US,21,1475
OUTLANDER 450,2020-12-07,5,14,NC,US,19,1476
OUTLANDER 1000,2020-12-14,1,10,NC,US,11,1469
OUTLANDER 850,2020-12-14,13,1,NC,US,14,1489
OUTLANDER 450,2020-12-14,7,6,NC,US,13,1489
OUTLANDER 1000,2020-12-21,2,4,NC,US,6,1475
OUTLANDER 850,2020-12-21,10,7,NC,US,17,1506
OUTLANDER 450,2020-12-21,11,1,NC,US,12,1501
OUTLANDER 1000,2020-12-28,3,5,NC,US,8,1483
OUTLANDER 850,2020-12-28,6,10,NC,US,16,1522
OUTLANDER 450,2020-12-28,10,1,NC,US,11,1512
OUTLANDER 1000,2021-01-04,12,3,NC,US,15,1498
OUTLANDER 850,2021-01-04,15,0,NC,US,15,1537
OUTLANDER 450,2021-01-04,7,10,NC,US,17,1529
OUTLANDER 1000,2021-01-11,5,11,NC,US,16,1514
OUTLANDER 850,2021-01-11,4,10,NC,US,14,1551
OUTLANDER 450,2021-01-11,8,7,NC,US,15,1544
OUTLANDER 1000,2021-01-18,1,1,NC,US,2,1516
OUTLANDER 850,2021-01-18,5,11,NC,US,16,1567
OUTLANDER 450,2021-01-18,0,9,NC,US,9,1553
OUTLANDER 1000,2021-01-25,11,13,NC,US,24,1540
OUTLANDER 850,2021-01-25,13,7,NC,US,20,1587
OUTLANDER 450,2021-01-25,14,11,NC,US,25,1578
OUTLANDER 1000,2021-02-01,7,5,NC,US,12,1552
OUTLANDER 850,2021-02-01,9,4,NC,US,13,1600
OUTLANDER 450,2021-02-01,14,3,NC,US,17,1595
OUTLANDER 1000,2021-02-08,12,6,NC,US,18,1570
OUTLANDER 850,2021-02-08,10,8,NC,US,18,1618
OUTLANDER 450,2021-02-08,4,5,NC,US,9,1604
OUTLANDER 1000,2021-02-15,10,10,NC,US,20,1590
OUTLANDER 850,2021-02-15,14,0,NC,US,14,1632
OUTLANDER 450,2021-02-15,11,0,NC,US,11,1615
OUTLANDER 1000,2021-02-22,7,10,NC,US,17,1607
OUTLANDER 850,2021-02-22,14,6,NC,US,20,1652
OUTLANDER 450,2021-02-22,15,6,NC,US,21,1636
OUTLANDER 1000,2021-03-01,13,5,NC,US,18,1625
OUTLANDER 850,2021-03-01,5,13,NC,US,18,1670
OUTLANDER 450,2021-03-01,12,8,NC,US,20,1656
OUTLANDER 1000,2021-03-08,8,11,NC,US,19,1644
OUTLANDER 850,2021-03-08,15,4,NC,US,19,1689
OUTLANDER 450,2021-03-08,14,8,NC,US,22,1678
OUTLANDER 1000,2021-03-15,14,10,NC,US,24,1668
OUTLANDER 850,2021-03-15,11,4,NC,US,15,1704
OUTLANDER 450,2021-03-15,15,2,NC,US,17,1695
OUTLANDER 1000,2021-03-22,13,12,NC,US,25,1693
OUTLANDER 850,2021-03-22,7,9,NC,US,16,1720
OUTLANDER 450,2021-03-22,7,14,NC,US,21,1716
OUTLANDER 1000,2021-03-29,6,4,NC,US,10,1703
OUTLANDER 850,2021-03-29,6,3,NC,US,9,1729
OUTLANDER 450,2021-03-29,15,2,NC,US,17,1733
OUTLANDER 1000,2021-04-05,12,4,NC,US,16,1719
OUTLANDER 850,2021-04-05,12,2,NC,US,14,1743
OUTLANDER 450,2021-04-05,0,14,NC,US,14,1747
OUTLANDER 1000,2021-04-12,9,6,NC,US,15,1734
OUTLANDER 850,2021-04-12,6,1,NC,US,7,1750
OUTLANDER 450,2021-04-12,7,3,NC,US,10,1757
OUTLANDER 1000,2021-04-19,15,11,NC,US,26,1760
OUTLANDER 850,2021-04-19,13,2,NC,US,15,1765
OUTLANDER 450,2021-04-19,14,5,NC,US,19,1776
OUTLANDER 1000,2021-04-26,2,12,NC,US,14,1774
OUTLANDER 850,2021-04-26,10,5,NC,US,15,1780
OUTLANDER 450,2021-04-26,9,5,NC,US,14,1790
OUTLANDER 1000,2021-05-03,2,3,NC,US,5,1779
OUTLANDER 850,2021-05-03,8,2,NC,US,10,1790
OUTLANDER 450,2021-05-03,8,8,NC,US,16,1806
OUTLANDER 1000,2021-05-10,7,1,NC,US,8,1787
OUTLANDER 850,2021-05-10,12,1,NC,US,13,1803
OUTLANDER 450,2021-05-10,14,1,NC,US,15,1821
OUTLANDER 1000,2021-05-17,5,1,NC,US,6,1793
OUTLANDER 850,2021-05-17,4,2,NC,US,6,1809
OUTLANDER 450,2021-05-17,13,2,NC,US,15,1836
OUTLANDER 1000,2021-05-24,11,6,NC,US,17,1810
OUTLANDER 850,2021-05-24,2,15,NC,US,17,1826
OUTLANDER 450,2021-05-24,11,15,NC,US,26,1862
OUTLANDER 1000,2021-05-31,3,13,NC,US,16,1826
OUTLANDER 850,2021-05-31,3,6,NC,US,9,1835
OUTLANDER 450,2021-05-31,13,15,NC,US,28,1890
OUTLANDER 1000,2021-06-07,4,8,NC,US,12,1838
OUTLANDER 850,2021-06-07,3,2,NC,US,5,1840
OUTLANDER 450,2021-06-07,12,7,NC,US,19,1909
OUTLANDER 1000,2021-06-14,15,7,NC,US,22,1860
OUTLANDER 850,2021-06-14,4,4,NC,US,8,1848
OUTLANDER 450,2021-06-14,6,2,NC,US,8,1917
OUTLANDER 1000,2021-06-21,1,7,NC,US,8,1868
OUTLANDER 850,2021-06-21,13,3,NC,US,16,1864
OUTLANDER 450,2021-06-21,1,3,NC,US,4,1921
OUTLANDER 1000,2021-06-28,2,6,NC,US,8,1876
OUTLANDER 850,2021-06-28,7,11,NC,US,18,1882
OUTLANDER 450,2021-06-28,13,14,NC,US,27,1948
OUTLANDER 1000,2021-07-05,12,0,NC,US,12,1888
OUTLANDER 850,2021-07-05,8,14,NC,US,22,1904
OUTLANDER 450,2021-07-05,12,5,NC,US,17,1965
OUTLANDER 1000,2021-07-12,14,6,NC,US,20,1908
OUTLANDER 850,2021-07-12,4,14,NC,US,18,1922
OUTLANDER 450,2021-07-12,13,6,NC,US,19,1984
OUTLANDER 1000,2021-07-19,11,12,NC,US,23,1931
OUTLANDER 850,2021-07-19,15,12,NC,US,27,1949
OUTLANDER 450,2021-07-19,0,13,NC,US,13,1997
OUTLANDER 1000,2021-07-26,7,2,NC,US,9,1940
OUTLANDER 850,2021-07-26,4,12,NC,US,16,1965
OUTLANDER 450,2021-07-26,0,14,NC,US,14,2011
OUTLANDER 1000,2021-08-02,9,11,NC,US,20,1960
OUTLANDER 850,2021-08-02,5,4,NC,US,9,1974
OUTLANDER 450,2021-08-02,1,5,NC,US,6,2017
OUTLANDER 1000,2021-08-09,1,12,NC,US,13,1973
OUTLANDER 850,2021-08-09,13,1,NC,US,14,1988
OUTLANDER 450,2021-08-09,9,14,NC,US,23,2040
OUTLANDER 1000,2021-08-16,2,5,NC,US,7,1980
OUTLANDER 850,2021-08-16,15,14,NC,US,29,2017
OUTLANDER 450,2021-08-16,13,13,NC,US,26,2066
OUTLANDER 1000,2021-08-23,1,15,NC,US,16,1996
OUTLANDER 850,2021-08-23,14,6,NC,US,20,2037
OUTLANDER 450,2021-08-23,13,15,NC,US,28,2094
OUTLANDER 1000,2021-08-30,10,3,NC,US,13,2009
OUTLANDER 850,2021-08-30,7,14,NC,US,21,2058
OUTLANDER 450,2021-08-30,7,11,NC,US,18,2112
OUTLANDER 1000,2021-09-06,2,4,NC,US,6,2015
OUTLANDER 850,2021-09-06,11,14,NC,US,25,2083
OUTLANDER 450,2021-09-06,7,3,NC,US,10,2122
OUTLANDER 1000,2021-09-13,14,2,NC,US,16,2031
OUTLANDER 850,2021-09-13,8,6,NC,US,14,2097
OUTLANDER 450,2021-09-13,12,0,NC,US,12,2134
OUTLANDER 1000,2021-09-20,2,3,NC,US,5,2036
OUTLANDER 850,2021-09-20,2,1,NC,US,3,2100
OUTLANDER 450,2021-09-20,3,0,NC,US,3,2137
OUTLANDER 1000,2021-09-27,11,11,NC,US,22,2058
OUTLANDER 850,2021-09-27,13,14,NC,US,27,2127
OUTLANDER 450,2021-09-27,9,0,NC,US,9,2146
OUTLANDER 1000,2021-10-04,10,1,NC,US,11,2069
OUTLANDER 850,2021-10-04,12,3,NC,US,15,2142
OUTLANDER 450,2021-10-04,5,5,NC,US,10,2156
OUTLANDER 1000,2021-10-11,5,10,NC,US,15,2084
OUTLANDER 850,2021-10-11,5,14,NC,US,19,2161
OUTLANDER 450,2021-10-11,8,4,NC,US,12,2168
OUTLANDER 1000,2021-10-18,12,4,NC,US,16,2100
OUTLANDER 850,2021-10-18,2,9,NC,US,11,2172
OUTLANDER 450,2021-10-18,4,14,NC,US,18,2186
OUTLANDER 1000,2021-10-25,8,9,NC,US,17,2117
OUTLANDER 850,2021-10-25,0,6,NC,US,6,2178
OUTLANDER 450,2021-10-25,5,13,NC,US,18,2204
OUTLANDER 1000,2021-11-01,1,6,NC,US,7,2124
OUTLANDER 850,2021-11-01,14,9,NC,US,23,2201
OUTLANDER 450,2021-11-01,9,1,NC,US,10,2214
OUTLANDER 1000,2021-11-08,14,8,NC,US,22,2146
OUTLANDER 850,2021-11-08,3,7,NC,US,10,2211
OUTLANDER 450,2021-11-08,14,10,NC,US,24,2238
OUTLANDER 1000,2021-11-15,9,8,NC,US,17,2163
OUTLANDER 850,2021-11-15,8,12,NC,US,20,2231
OUTLANDER 450,2021-11-15,1,6,NC,US,7,2245
OUTLANDER 1000,2021-11-22,6,10,NC,US,16,2179
OUTLANDER 850,2021-11-22,7,10,NC,US,17,2248
OUTLANDER 450,2021-11-22,12,6,NC,US,18,2263
OUTLANDER 1000,2021-11-29,5,6,NC,US,11,2190
OUTLANDER 850,2021-11-29,3,11,NC,US,14,2262
OUTLANDER 450,2021-11-29,9,9,NC,US,18,2281
OUTLANDER 1000,2021-12-06,13,12,NC,US,25,2215
OUTLANDER 850,2021-12-06,12,7,NC,US,19,2281
OUTLANDER 450,2021-12-06,11,7,NC,US,18,2299
OUTLANDER 1000,2021-12-13,7,5,NC,US,12,2227
OUTLANDER 850,2021-12-13,6,10,NC,US,16,2297
OUTLANDER 450,2021-12-13,9,13,NC,US,22,2321
OUTLANDER 1000,2021-12-20,12,0,NC,US,12,2239
OUTLANDER 850,2021-12-20,4,14,NC,US,18,2315
OUTLANDER 450,2021-12-20,13,4,NC,US,17,2338
OUTLANDER 1000,2021-12-27,7,1,NC,US,8,2247
OUTLANDER 850,2021-12-27,1,10,NC,US,11,2326
OUTLANDER 450,2021-12-27,6,4,NC,US,10,2348
OUTLANDER 1000,2019-01-07,8,4,ND,US,12,12
OUTLANDER 850,2019-01-07,5,6,ND,US,11,11
OUTLANDER 450,2019-01-07,12,4,ND,US,16,16
OUTLANDER 1000,2019-01-14,5,0,ND,US,5,17
OUTLANDER 850,2019-01-14,3,10,ND,US,13,24
OUTLANDER 450,2019-01-14,1,2,ND,US,3,19
OUTLANDER 1000,2019-01-21,13,1,ND,US,14,31
OUTLANDER 850,2019-01-21,10,11,ND,US,21,45
OUTLANDER 450,2019-01-21,6,10,ND,US,16,35
OUTLANDER 1000,2019-01-28,8,5,ND,US,13,44
OUTLANDER 850,2019-01-28,2,7,ND,US,9,54
OUTLANDER 450,2019-01-28,1,6,ND,US,7,42
OUTLANDER 1000,2019-02-04,12,14,ND,US,26,70
OUTLANDER 850,2019-02-04,14,10,ND,US,24,78
OUTLANDER 450,2019-02-04,14,4,ND,US,18,60
OUTLANDER 1000,2019-02-11,13,10,ND,US,23,93
OUTLANDER 850,2019-02-11,10,9,ND,US,19,97
OUTLANDER 450,2019-02-11,7,15,ND,US,22,82
OUTLANDER 1000,2019-02-18,9,6,ND,US,15,108
OUTLANDER 850,2019-02-18,10,2,ND,US,12,109
OUTLANDER 450,2019-02-18,3,6,ND,US,9,91
OUTLANDER 1000,2019-02-25,12,8,ND,US,20,128
OUTLANDER 850,2019-02-25,12,13,ND,US,25,134
OUTLANDER 450,2019-02-25,4,14,ND,US,18,109
OUTLANDER 1000,2019-03-04,14,7,ND,US,21,149
OUTLANDER 850,2019-03-04,8,6,ND,US,14,148
OUTLANDER 450,2019-03-04,13,2,ND,US,15,124
OUTLANDER 1000,2019-03-11,1,11,ND,US,12,161
OUTLANDER 850,2019-03-11,6,7,ND,US,13,161
OUTLANDER 450,2019-03-11,6,15,ND,US,21,145
OUTLANDER 1000,2019-03-18,2,2,ND,US,4,165
OUTLANDER 850,2019-03-18,6,7,ND,US,13,174
OUTLANDER 450,2019-03-18,3,2,ND,US,5,150
OUTLANDER 1000,2019-03-25,4,14,ND,US,18,183
OUTLANDER 850,2019-03-25,15,4,ND,US,19,193
OUTLANDER 450,2019-03-25,13,12,ND,US,25,175
OUTLANDER 1000,2019-04-01,4,8,ND,US,12,195
OUTLANDER 850,2019-04-01,12,10,ND,US,22,215
OUTLANDER 450,2019-04-01,13,2,ND,US,15,190
OUTLANDER 1000,2019-04-08,4,6,ND,US,10,205
OUTLANDER 850,2019-04-08,9,3,ND,US,12,227
OUTLANDER 450,2019-04-08,15,15,ND,US,30,220
OUTLANDER 1000,2019-04-15,15,6,ND,US,21,226
OUTLANDER 850,2019-04-15,7,12,ND,US,19,246
OUTLANDER 450,2019-04-15,6,12,ND,US,18,238
OUTLANDER 1000,2019-04-22,4,10,ND,US,14,240
OUTLANDER 850,2019-04-22,14,1,ND,US,15,261
OUTLANDER 450,2019-04-22,10,8,ND,US,18,256
OUTLANDER 1000,2019-04-29,11,9,ND,US,20,260
OUTLANDER 850,2019-04-29,4,0,ND,US,4,265
OUTLANDER 450,2019-04-29,13,12,ND,US,25,281
OUTLANDER 1000,2019-05-06,5,10,ND,US,15,275
OUTLANDER 850,2019-05-06,5,7,ND,US,12,277
OUTLANDER 450,2019-05-06,13,1,ND,US,14,295
OUTLANDER 1000,2019-05-13,11,6,ND,US,17,292
OUTLANDER 850,2019-05-13,14,7,ND,US,21,298
OUTLANDER 450,2019-05-13,8,1,ND,US,9,304
OUTLANDER 1000,2019-05-20,1,14,ND,US,15,307
OUTLANDER 850,2019-05-20,2,8,ND,US,10,308
OUTLANDER 450,2019-05-20,2,5,ND,US,7,311
OUTLANDER 1000,2019-05-27,13,2,ND,US,15,322
OUTLANDER 850,2019-05-27,10,4,ND,US,14,322
OUTLANDER 450,2019-05-27,8,10,ND,US,18,329
OUTLANDER 1000,2019-06-03,5,8,ND,US,13,335
OUTLANDER 850,2019-06-03,7,5,ND,US,12,334
OUTLANDER 450,2019-06-03,9,9,ND,US,18,347
OUTLANDER 1000,2019-06-10,11,5,ND,US,16,351
OUTLANDER 850,2019-06-10,2,7,ND,US,9,343
OUTLANDER 450,2019-06-10,10,3,ND,US,13,360
OUTLANDER 1000,2019-06-17,3,1,ND,US,4,355
OUTLANDER 850,2019-06-17,2,9,ND,US,11,354
OUTLANDER 450,2019-06-17,7,10,ND,US,17,377
OUTLANDER 1000,2019-06-24,11,6,ND,US,17,372
OUTLANDER 850,2019-06-24,13,11,ND,US,24,378
OUTLANDER 450,2019-06-24,13,15,ND,US,28,405
OUTLANDER 1000,2019-07-01,8,1,ND,US,9,381
OUTLANDER 850,2019-07-01,13,9,ND,US,22,400
OUTLANDER 450,2019-07-01,2,13,ND,US,15,420
OUTLANDER 1000,2019-07-08,12,5,ND,US,17,398
OUTLANDER 850,2019-07-08,9,1,ND,US,10,410
OUTLANDER 450,2019-07-08,6,2,ND,US,8,428
OUTLANDER 1000,2019-07-15,5,2,ND,US,7,405
OUTLANDER 850,2019-07-15,1,13,ND,US,14,424
OUTLANDER 450,2019-07-15,0,8,ND,US,8,436
OUTLANDER 1000,2019-07-22,12,12,ND,US,24,429
OUTLANDER 850,2019-07-22,3,9,ND,US,12,436
OUTLANDER 450,2019-07-22,10,14,ND,US,24,460
OUTLANDER 1000,2019-07-29,2,8,ND,US,10,439
OUTLANDER 850,2019-07-29,14,13,ND,US,27,463
OUTLANDER 450,2019-07-29,9,6,ND,US,15,475
OUTLANDER 1000,2019-08-05,4,13,ND,US,17,456
OUTLANDER 850,2019-08-05,9,3,ND,US,12,475
OUTLANDER 450,2019-08-05,0,2,ND,US,2,477
OUTLANDER 1000,2019-08-12,3,8,ND,US,11,467
OUTLANDER 850,2019-08-12,2,6,ND,US,8,483
OUTLANDER 450,2019-08-12,12,2,ND,US,14,491
OUTLANDER 1000,2019-08-19,6,14,ND,US,20,487
OUTLANDER 850,2019-08-19,9,12,ND,US,21,504
OUTLANDER 450,2019-08-19,8,11,ND,US,19,510
OUTLANDER 1000,2019-08-26,15,5,ND,US,20,507
OUTLANDER 850,2019-08-26,8,13,ND,US,21,525
OUTLANDER 450,2019-08-26,8,12,ND,US,20,530
OUTLANDER 1000,2019-09-02,1,13,ND,US,14,521
OUTLANDER 850,2019-09-02,11,8,ND,US,19,544
OUTLANDER 450,2019-09-02,1,4,ND,US,5,535
OUTLANDER 1000,2019-09-09,10,5,ND,US,15,536
OUTLANDER 850,2019-09-09,6,9,ND,US,15,559
OUTLANDER 450,2019-09-09,2,8,ND,US,10,545
OUTLANDER 1000,2019-09-16,15,1,ND,US,16,552
OUTLANDER 850,2019-09-16,10,6,ND,US,16,575
OUTLANDER 450,2019-09-16,14,4,ND,US,18,563
OUTLANDER 1000,2019-09-23,0,9,ND,US,9,561
OUTLANDER 850,2019-09-23,4,8,ND,US,12,587
OUTLANDER 450,2019-09-23,5,10,ND,US,15,578
OUTLANDER 1000,2019-09-30,7,3,ND,US,10,571
OUTLANDER 850,2019-09-30,1,13,ND,US,14,601
OUTLANDER 450,2019-09-30,1,13,ND,US,14,592
OUTLANDER 1000,2019-10-07,10,6,ND,US,16,587
OUTLANDER 850,2019-10-07,7,6,ND,US,13,614
OUTLANDER 450,2019-10-07,15,11,ND,US,26,618
OUTLANDER 1000,2019-10-14,7,2,ND,US,9,596
OUTLANDER 850,2019-10-14,7,15,ND,US,22,636
OUTLANDER 450,2019-10-14,5,10,ND,US,15,633
OUTLANDER 1000,2019-10-21,1,14,ND,US,15,611
OUTLANDER 850,2019-10-21,14,3,ND,US,17,653
OUTLANDER 450,2019-10-21,11,2,ND,US,13,646
OUTLANDER 1000,2019-10-28,3,9,ND,US,12,623
OUTLANDER 850,2019-10-28,1,11,ND,US,12,665
OUTLANDER 450,2019-10-28,14,5,ND,US,19,665
OUTLANDER 1000,2019-11-04,2,14,ND,US,16,639
OUTLANDER 850,2019-11-04,3,6,ND,US,9,674
OUTLANDER 450,2019-11-04,9,13,ND,US,22,687
OUTLANDER 1000,2019-11-11,2,2,ND,US,4,643
OUTLANDER 850,2019-11-11,12,3,ND,US,15,689
OUTLANDER 450,2019-11-11,6,4,ND,US,10,697
OUTLANDER 1000,2019-11-18,13,10,ND,US,23,666
OUTLANDER 850,2019-11-18,11,10,ND,US,21,710
OUTLANDER 450,2019-11-18,11,14,ND,US,25,722
OUTLANDER 1000,2019-11-25,6,8,ND,US,14,680
OUTLANDER 850,2019-11-25,10,7,ND,US,17,727
OUTLANDER 450,2019-11-25,9,0,ND,US,9,731
OUTLANDER 1000,2019-12-02,6,9,ND,US,15,695
OUTLANDER 850,2019-12-02,11,2,ND,US,13,740
OUTLANDER 450,2019-12-02,5,14,ND,US,19,750
OUTLANDER 1000,2019-12-09,10,11,ND,US,21,716
OUTLANDER 850,2019-12-09,1,11,ND,US,12,752
OUTLANDER 450,2019-12-09,15,9,ND,US,24,774
OUTLANDER 1000,2019-12-16,13,12,ND,US,25,741
OUTLANDER 850,2019-12-16,9,14,ND,US,23,775
OUTLANDER 450,2019-12-16,11,2,ND,US,13,787
OUTLANDER 1000,2019-12-23,6,7,ND,US,13,754
OUTLANDER 850,2019-12-23,14,13,ND,US,27,802
OUTLANDER 450,2019-12-23,8,6,ND,US,14,801
OUTLANDER 1000,2019-12-30,1,6,ND,US,7,761
OUTLANDER 850,2019-12-30,7,7,ND,US,14,816
OUTLANDER 450,2019-12-30,10,8,ND,US,18,819
OUTLANDER 1000,2020-01-06,14,2,ND,US,16,777
OUTLANDER 850,2020-01-06,5,13,ND,US,18,834
OUTLANDER 450,2020-01-06,11,9,ND,US,20,839
OUTLANDER 1000,2020-01-13,6,10,ND,US,16,793
OUTLANDER 850,2020-01-13,12,8,ND,US,20,854
OUTLANDER 450,2020-01-13,9,8,ND,US,17,856
OUTLANDER 1000,2020-01-20,10,10,ND,US,20,813
OUTLANDER 850,2020-01-20,0,12,ND,US,12,866
OUTLANDER 450,2020-01-20,14,13,ND,US,27,883
OUTLANDER 1000,2020-01-27,1,9,ND,US,10,823
OUTLANDER 850,2020-01-27,13,1,ND,US,14,880
OUTLANDER 450,2020-01-27,2,8,ND,US,10,893
OUTLANDER 1000,2020-02-03,5,13,ND,US,18,841
OUTLANDER 850,2020-02-03,11,2,ND,US,13,893
OUTLANDER 450,2020-02-03,5,7,ND,US,12,905
OUTLANDER 1000,2020-02-10,5,10,ND,US,15,856
OUTLANDER 850,2020-02-10,6,10,ND,US,16,909
OUTLANDER 450,2020-02-10,3,12,ND,US,15,920
OUTLANDER 1000,2020-02-17,15,13,ND,US,28,884
OUTLANDER 850,2020-02-17,14,13,ND,US,27,936
OUTLANDER 450,2020-02-17,4,4,ND,US,8,928
OUTLANDER 1000,2020-02-24,7,4,ND,US,11,895
OUTLANDER 850,2020-02-24,4,1,ND,US,5,941
OUTLANDER 450,2020-02-24,2,13,ND,US,15,943
OUTLANDER 1000,2020-03-02,6,6,ND,US,12,907
OUTLANDER 850,2020-03-02,15,11,ND,US,26,967
OUTLANDER 450,2020-03-02,11,1,ND,US,12,955
OUTLANDER 1000,2020-03-09,14,5,ND,US,19,926
OUTLANDER 850,2020-03-09,11,12,ND,US,23,990
OUTLANDER 450,2020-03-09,6,13,ND,US,19,974
OUTLANDER 1000,2020-03-16,12,10,ND,US,22,948
OUTLANDER 850,2020-03-16,12,6,ND,US,18,1008
OUTLANDER 450,2020-03-16,4,3,ND,US,7,981
OUTLANDER 1000,2020-03-23,3,3,ND,US,6,954
OUTLANDER 850,2020-03-23,1,11,ND,US,12,1020
OUTLANDER 450,2020-03-23,0,4,ND,US,4,985
OUTLANDER 1000,2020-03-30,6,14,ND,US,20,974
OUTLANDER 850,2020-03-30,5,6,ND,US,11,1031
OUTLANDER 450,2020-03-30,3,14,ND,US,17,1002
OUTLANDER 1000,2020-04-06,4,4,ND,US,8,982
OUTLANDER 850,2020-04-06,8,8,ND,US,16,1047
OUTLANDER 450,2020-04-06,9,1,ND,US,10,1012
OUTLANDER 1000,2020-04-13,10,3,ND,US,13,995
OUTLANDER 850,2020-04-13,11,7,ND,US,18,1065
OUTLANDER 450,2020-04-13,12,0,ND,US,12,1024
OUTLANDER 1000,2020-04-20,11,0,ND,US,11,1006
OUTLANDER 850,2020-04-20,6,2,ND,US,8,1073
OUTLANDER 450,2020-04-20,6,9,ND,US,15,1039
OUTLANDER 1000,2020-04-27,10,14,ND,US,24,1030
OUTLANDER 850,2020-04-27,1,1,ND,US,2,1075
OUTLANDER 450,2020-04-27,0,3,ND,US,3,1042
OUTLANDER 1000,2020-05-04,8,15,ND,US,23,1053
OUTLANDER 850,2020-05-04,12,6,ND,US,18,1093
OUTLANDER 450,2020-05-04,2,11,ND,US,13,1055
OUTLANDER 1000,2020-05-11,14,12,ND,US,26,1079
OUTLANDER 850,2020-05-11,9,15,ND,US,24,1117
OUTLANDER 450,2020-05-11,12,4,ND,US,16,1071
OUTLANDER 1000,2020-05-18,4,14,ND,US,18,1097
OUTLANDER 850,2020-05-18,7,10,ND,US,17,1134
OUTLANDER 450,2020-05-18,2,7,ND,US,9,1080
OUTLANDER 1000,2020-05-25,1,9,ND,US,10,1107
OUTLANDER 850,2020-05-25,5,11,ND,US,16,1150
OUTLANDER 450,2020-05-25,7,1,ND,US,8,1088
OUTLANDER 1000,2020-06-01,6,15,ND,US,21,1128
OUTLANDER 850,2020-06-01,8,5,ND,US,13,1163
OUTLANDER 450,2020-06-01,2,4,ND,US,6,1094
OUTLANDER 1000,2020-06-08,13,1,ND,US,14,1142
OUTLANDER 850,2020-06-08,3,3,ND,US,6,1169
OUTLANDER 450,2020-06-08,7,7,ND,US,14,1108
OUTLANDER 1000,2020-06-15,15,9,ND,US,24,1166
OUTLANDER 850,2020-06-15,14,12,ND,US,26,1195
OUTLANDER 450,2020-06-15,13,13,ND,US,26,1134
OUTLANDER 1000,2020-06-22,10,6,ND,US,16,1182
OUTLANDER 850,2020-06-22,5,9,ND,US,14,1209
OUTLANDER 450,2020-06-22,4,15,ND,US,19,1153
OUTLANDER 1000,2020-06-29,11,6,ND,US,17,1199
OUTLANDER 850,2020-06-29,3,5,ND,US,8,1217
OUTLANDER 450,2020-06-29,4,4,ND,US,8,1161
OUTLANDER 1000,2020-07-06,10,15,ND,US,25,1224
OUTLANDER 850,2020-07-06,7,14,ND,US,21,1238
OUTLANDER 450,2020-07-06,5,5,ND,US,10,1171
OUTLANDER 1000,2020-07-13,1,10,ND,US,11,1235
OUTLANDER 850,2020-07-13,14,7,ND,US,21,1259
OUTLANDER 450,2020-07-13,0,2,ND,US,2,1173
OUTLANDER 1000,2020-07-20,3,8,ND,US,11,1246
OUTLANDER 850,2020-07-20,15,8,ND,US,23,1282
OUTLANDER 450,2020-07-20,13,1,ND,US,14,1187
OUTLANDER 1000,2020-07-27,11,7,ND,US,18,1264
OUTLANDER 850,2020-07-27,13,10,ND,US,23,1305
OUTLANDER 450,2020-07-27,3,3,ND,US,6,1193
OUTLANDER 1000,2020-08-03,12,15,ND,US,27,1291
OUTLANDER 850,2020-08-03,5,9,ND,US,14,1319
OUTLANDER 450,2020-08-03,8,4,ND,US,12,1205
OUTLANDER 1000,2020-08-10,13,4,ND,US,17,1308
OUTLANDER 850,2020-08-10,12,10,ND,US,22,1341
OUTLANDER 450,2020-08-10,9,11,ND,US,20,1225
OUTLANDER 1000,2020-08-17,2,11,ND,US,13,1321
OUTLANDER 850,2020-08-17,1,11,ND,US,12,1353
OUTLANDER 450,2020-08-17,6,3,ND,US,9,1234
OUTLANDER 1000,2020-08-24,6,1,ND,US,7,1328
OUTLANDER 850,2020-08-24,3,11,ND,US,14,1367
OUTLANDER 450,2020-08-24,14,3,ND,US,17,1251
OUTLANDER 1000,2020-08-31,7,1,ND,US,8,1336
OUTLANDER 850,2020-08-31,7,1,ND,US,8,1375
OUTLANDER 450,2020-08-31,3,4,ND,US,7,1258
OUTLANDER 1000,2020-09-07,12,10,ND,US,22,1358
OUTLANDER 850,2020-09-07,13,2,ND,US,15,1390
OUTLANDER 450,2020-09-07,5,0,ND,US,5,1263
OUTLANDER 1000,2020-09-14,10,15,ND,US,25,1383
OUTLANDER 850,2020-09-14,12,2,ND,US,14,1404
OUTLANDER 450,2020-09-14,0,7,ND,US,7,1270
OUTLANDER 1000,2020-09-21,2,11,ND,US,13,1396
OUTLANDER 850,2020-09-21,13,5,ND,US,18,1422
OUTLANDER 450,2020-09-21,12,10,ND,US,22,1292
OUTLANDER 1000,2020-09-28,15,10,ND,US,25,1421
OUTLANDER 850,2020-09-28,8,2,ND,US,10,1432
OUTLANDER 450,2020-09-28,4,13,ND,US,17,1309
OUTLANDER 1000,2020-10-05,4,7,ND,US,11,1432
OUTLANDER 850,2020-10-05,7,3,ND,US,10,1442
OUTLANDER 450,2020-10-05,13,11,ND,US,24,1333
OUTLANDER 1000,2020-10-12,10,3,ND,US,13,1445
OUTLANDER 850,2020-10-12,9,13,ND,US,22,1464
OUTLANDER 450,2020-10-12,9,7,ND,US,16,1349
OUTLANDER 1000,2020-10-19,10,9,ND,US,19,1464
OUTLANDER 850,2020-10-19,7,10,ND,US,17,1481
OUTLANDER 450,2020-10-19,5,8,ND,US,13,1362
OUTLANDER 1000,2020-10-26,6,6,ND,US,12,1476
OUTLANDER 850,2020-10-26,2,4,ND,US,6,1487
OUTLANDER 450,2020-10-26,7,15,ND,US,22,1384
OUTLANDER 1000,2020-11-02,1,1,ND,US,2,1478
OUTLANDER 850,2020-11-02,12,2,ND,US,14,1501
OUTLANDER 450,2020-11-02,1,8,ND,US,9,1393
OUTLANDER 1000,2020-11-09,13,5,ND,US,18,1496
OUTLANDER 850,2020-11-09,6,15,ND,US,21,1522
OUTLANDER 450,2020-11-09,9,15,ND,US,24,1417
OUTLANDER 1000,2020-11-16,0,5,ND,US,5,1501
OUTLANDER 850,2020-11-16,5,14,ND,US,19,1541
OUTLANDER 450,2020-11-16,5,10,ND,US,15,1432
OUTLANDER 1000,2020-11-23,8,9,ND,US,17,1518
OUTLANDER 850,2020-11-23,8,1,ND,US,9,1550
OUTLANDER 450,2020-11-23,1,8,ND,US,9,1441
OUTLANDER 1000,2020-11-30,1,10,ND,US,11,1529
OUTLANDER 850,2020-11-30,12,3,ND,US,15,1565
OUTLANDER 450,2020-11-30,13,10,ND,US,23,1464
OUTLANDER 1000,2020-12-07,11,1,ND,US,12,1541
OUTLANDER 850,2020-12-07,11,12,ND,US,23,1588
OUTLANDER 450,2020-12-07,13,4,ND,US,17,1481
OUTLANDER 1000,2020-12-14,1,1,ND,US,2,1543
OUTLANDER 850,2020-12-14,15,4,ND,US,19,1607
OUTLANDER 450,2020-12-14,10,5,ND,US,15,1496
OUTLANDER 1000,2020-12-21,1,7,ND,US,8,1551
OUTLANDER 850,2020-12-21,9,2,ND,US,11,1618
OUTLANDER 450,2020-12-21,13,8,ND,US,21,1517
OUTLANDER 1000,2020-12-28,10,8,ND,US,18,1569
OUTLANDER 850,2020-12-28,4,15,ND,US,19,1637
OUTLANDER 450,2020-12-28,12,5,ND,US,17,1534
OUTLANDER 1000,2021-01-04,13,3,ND,US,16,1585
OUTLANDER 850,2021-01-04,15,12,ND,US,27,1664
OUTLANDER 450,2021-01-04,2,11,ND,US,13,1547
OUTLANDER 1000,2021-01-11,1,7,ND,US,8,1593
OUTLANDER 850,2021-01-11,7,5,ND,US,12,1676
OUTLANDER 450,2021-01-11,13,15,ND,US,28,1575
OUTLANDER 1000,2021-01-18,13,14,ND,US,27,1620
OUTLANDER 850,2021-01-18,2,9,ND,US,11,1687
OUTLANDER 450,2021-01-18,8,2,ND,US,10,1585
OUTLANDER 1000,2021-01-25,13,9,ND,US,22,1642
OUTLANDER 850,2021-01-25,4,10,ND,US,14,1701
OUTLANDER 450,2021-01-25,6,11,ND,US,17,1602
OUTLANDER 1000,2021-02-01,8,3,ND,US,11,1653
OUTLANDER 850,2021-02-01,3,5,ND,US,8,1709
OUTLANDER 450,2021-02-01,11,15,ND,US,26,1628
OUTLANDER 1000,2021-02-08,7,0,ND,US,7,1660
OUTLANDER 850,2021-02-08,6,0,ND,US,6,1715
OUTLANDER 450,2021-02-08,13,9,ND,US,22,1650
OUTLANDER 1000,2021-02-15,5,13,ND,US,18,1678
OUTLANDER 850,2021-02-15,10,4,ND,US,14,1729
OUTLANDER 450,2021-02-15,7,7,ND,US,14,1664
OUTLANDER 1000,2021-02-22,14,9,ND,US,23,1701
OUTLANDER 850,2021-02-22,1,7,ND,US,8,1737
OUTLANDER 450,2021-02-22,1,2,ND,US,3,1667
OUTLANDER 1000,2021-03-01,1,7,ND,US,8,1709
OUTLANDER 850,2021-03-01,3,4,ND,US,7,1744
OUTLANDER 450,2021-03-01,1,12,ND,US,13,1680
OUTLANDER 1000,2021-03-08,10,15,ND,US,25,1734
OUTLANDER 850,2021-03-08,12,8,ND,US,20,1764
OUTLANDER 450,2021-03-08,8,7,ND,US,15,1695
OUTLANDER 1000,2021-03-15,9,11,ND,US,20,1754
OUTLANDER 850,2021-03-15,10,1,ND,US,11,1775
OUTLANDER 450,2021-03-15,9,3,ND,US,12,1707
OUTLANDER 1000,2021-03-22,2,13,ND,US,15,1769
OUTLANDER 850,2021-03-22,10,14,ND,US,24,1799
OUTLANDER 450,2021-03-22,5,7,ND,US,12,1719
OUTLANDER 1000,2021-03-29,13,14,ND,US,27,1796
OUTLANDER 850,2021-03-29,14,13,ND,US,27,1826
OUTLANDER 450,2021-03-29,9,3,ND,US,12,1731
OUTLANDER 1000,2021-04-05,14,13,ND,US,27,1823
OUTLANDER 850,2021-04-05,10,11,ND,US,21,1847
OUTLANDER 450,2021-04-05,0,6,ND,US,6,1737
OUTLANDER 1000,2021-04-12,7,13,ND,US,20,1843
OUTLANDER 850,2021-04-12,9,6,ND,US,15,1862
OUTLANDER 450,2021-04-12,9,13,ND,US,22,1759
OUTLANDER 1000,2021-04-19,5,9,ND,US,14,1857
OUTLANDER 850,2021-04-19,8,12,ND,US,20,1882
OUTLANDER 450,2021-04-19,11,13,ND,US,24,1783
OUTLANDER 1000,2021-04-26,5,5,ND,US,10,1867
OUTLANDER 850,2021-04-26,1,3,ND,US,4,1886
OUTLANDER 450,2021-04-26,8,5,ND,US,13,1796
OUTLANDER 1000,2021-05-03,2,14,ND,US,16,1883
OUTLANDER 850,2021-05-03,8,9,ND,US,17,1903
OUTLANDER 450,2021-05-03,8,9,ND,US,17,1813
OUTLANDER 1000,2021-05-10,6,1,ND,US,7,1890
OUTLANDER 850,2021-05-10,8,2,ND,US,10,1913
OUTLANDER 450,2021-05-10,1,3,ND,US,4,1817
OUTLANDER 1000,2021-05-17,6,3,ND,US,9,1899
OUTLANDER 850,2021-05-17,13,4,ND,US,17,1930
OUTLANDER 450,2021-05-17,3,4,ND,US,7,1824
OUTLANDER 1000,2021-05-24,9,10,ND,US,19,1918
OUTLANDER 850,2021-05-24,11,13,ND,US,24,1954
OUTLANDER 450,2021-05-24,14,1,ND,US,15,1839
OUTLANDER 1000,2021-05-31,6,3,ND,US,9,1927
OUTLANDER 850,2021-05-31,7,1,ND,US,8,1962
OUTLANDER 450,2021-05-31,2,7,ND,US,9,1848
OUTLANDER 1000,2021-06-07,7,13,ND,US,20,1947
OUTLANDER 850,2021-06-07,12,10,ND,US,22,1984
OUTLANDER 450,2021-06-07,13,2,ND,US,15,1863
OUTLANDER 1000,2021-06-14,10,10,ND,US,20,1967
OUTLANDER 850,2021-06-14,5,1,ND,US,6,1990
OUTLANDER 450,2021-06-14,7,9,ND,US,16,1879
OUTLANDER 1000,2021-06-21,4,0,ND,US,4,1971
OUTLANDER 850,2021-06-21,12,12,ND,US,24,2014
OUTLANDER 450,2021-06-21,4,12,ND,US,16,1895
OUTLANDER 1000,2021-06-28,1,14,ND,US,15,1986
OUTLANDER 850,2021-06-28,5,10,ND,US,15,2029
OUTLANDER 450,2021-06-28,4,6,ND,US,10,1905
OUTLANDER 1000,2021-07-05,12,9,ND,US,21,2007
OUTLANDER 850,2021-07-05,2,15,ND,US,17,2046
OUTLANDER 450,2021-07-05,10,12,ND,US,22,1927
OUTLANDER 1000,2021-07-12,7,13,ND,US,20,2027
OUTLANDER 850,2021-07-12,11,10,ND,US,21,2067
OUTLANDER 450,2021-07-12,12,14,ND,US,26,1953
OUTLANDER 1000,2021-07-19,0,9,ND,US,9,2036
OUTLANDER 850,2021-07-19,3,14,ND,US,17,2084
OUTLANDER 450,2021-07-19,12,1,ND,US,13,1966
OUTLANDER 1000,2021-07-26,4,4,ND,US,8,2044
OUTLANDER 850,2021-07-26,14,8,ND,US,22,2106
OUTLANDER 450,2021-07-26,4,7,ND,US,11,1977
OUTLANDER 1000,2021-08-02,13,8,ND,US,21,2065
OUTLANDER 850,2021-08-02,12,3,ND,US,15,2121
OUTLANDER 450,2021-08-02,9,14,ND,US,23,2000
OUTLANDER 1000,2021-08-09,8,8,ND,US,16,2081
OUTLANDER 850,2021-08-09,13,6,ND,US,19,2140
OUTLANDER 450,2021-08-09,2,14,ND,US,16,2016
OUTLANDER 1000,2021-08-16,5,1,ND,US,6,2087
OUTLANDER 850,2021-08-16,11,11,ND,US,22,2162
OUTLANDER 450,2021-08-16,15,10,ND,US,25,2041
OUTLANDER 1000,2021-08-23,10,12,ND,US,22,2109
OUTLANDER 850,2021-08-23,0,14,ND,US,14,2176
OUTLANDER 450,2021-08-23,6,2,ND,US,8,2049
OUTLANDER 1000,2021-08-30,8,1,ND,US,9,2118
OUTLANDER 850,2021-08-30,5,5,ND,US,10,2186
OUTLANDER 450,2021-08-30,11,5,ND,US,16,2065
OUTLANDER 1000,2021-09-06,6,8,ND,US,14,2132
OUTLANDER 850,2021-09-06,8,1,ND,US,9,2195
OUTLANDER 450,2021-09-06,2,8,ND,US,10,2075
OUTLANDER 1000,2021-09-13,13,3,ND,US,16,2148
OUTLANDER 850,2021-09-13,1,6,ND,US,7,2202
OUTLANDER 450,2021-09-13,5,6,ND,US,11,2086
OUTLANDER 1000,2021-09-20,4,0,ND,US,4,2152
OUTLANDER 850,2021-09-20,3,10,ND,US,13,2215
OUTLANDER 450,2021-09-20,14,15,ND,US,29,2115
OUTLANDER 1000,2021-09-27,10,1,ND,US,11,2163
OUTLANDER 850,2021-09-27,2,1,ND,US,3,2218
OUTLANDER 450,2021-09-27,8,5,ND,US,13,2128
OUTLANDER 1000,2021-10-04,8,6,ND,US,14,2177
OUTLANDER 850,2021-10-04,5,11,ND,US,16,2234
OUTLANDER 450,2021-10-04,3,3,ND,US,6,2134
OUTLANDER 1000,2021-10-11,14,13,ND,US,27,2204
OUTLANDER 850,2021-10-11,12,10,ND,US,22,2256
OUTLANDER 450,2021-10-11,3,10,ND,US,13,2147
OUTLANDER 1000,2021-10-18,3,2,ND,US,5,2209
OUTLANDER 850,2021-10-18,5,7,ND,US,12,2268
OUTLANDER 450,2021-10-18,7,14,ND,US,21,2168
OUTLANDER 1000,2021-10-25,8,11,ND,US,19,2228
OUTLANDER 850,2021-10-25,8,5,ND,US,13,2281
OUTLANDER 450,2021-10-25,7,10,ND,US,17,2185
OUTLANDER 1000,2021-11-01,6,12,ND,US,18,2246
OUTLANDER 850,2021-11-01,9,1,ND,US,10,2291
OUTLANDER 450,2021-11-01,13,8,ND,US,21,2206
OUTLANDER 1000,2021-11-08,6,1,ND,US,7,2253
OUTLANDER 850,2021-11-08,6,9,ND,US,15,2306
OUTLANDER 450,2021-11-08,8,14,ND,US,22,2228
OUTLANDER 1000,2021-11-15,3,8,ND,US,11,2264
OUTLANDER 850,2021-11-15,2,5,ND,US,7,2313
OUTLANDER 450,2021-11-15,14,4,ND,US,18,2246
OUTLANDER 1000,2021-11-22,11,3,ND,US,14,2278
OUTLANDER 850,2021-11-22,12,9,ND,US,21,2334
OUTLANDER 450,2021-11-22,9,14,ND,US,23,2269
OUTLANDER 1000,2021-11-29,4,2,ND,US,6,2284
OUTLANDER 850,2021-11-29,8,6,ND,US,14,2348
OUTLANDER 450,2021-11-29,2,6,ND,US,8,2277
OUTLANDER 1000,2021-12-06,3,10,ND,US,13,2297
OUTLANDER 850,2021-12-06,10,11,ND,US,21,2369
OUTLANDER 450,2021-12-06,12,13,ND,US,25,2302
OUTLANDER 1000,2021-12-13,8,6,ND,US,14,2311
OUTLANDER 850,2021-12-13,13,3,ND,US,16,2385
OUTLANDER 450,2021-12-13,4,5,ND,US,9,2311
OUTLANDER 1000,2021-12-20,10,2,ND,US,12,2323
OUTLANDER 850,2021-12-20,5,10,ND,US,15,2400
OUTLANDER 450,2021-12-20,5,1,ND,US,6,2317
OUTLANDER 1000,2021-12-27,8,5,ND,US,13,2336
OUTLANDER 850,2021-12-27,9,4,ND,US,13,2413
OUTLANDER 450,2021-12-27,14,13,ND,US,27,2344
OUTLANDER 1000,2019-01-07,14,2,OH,US,16,16
OUTLANDER 850,2019-01-07,2,11,OH,US,13,13
OUTLANDER 450,2019-01-07,14,3,OH,US,17,17
OUTLANDER 1000,2019-01-14,1,14,OH,US,15,31
OUTLANDER 850,2019-01-14,11,11,OH,US,22,35
OUTLANDER 450,2019-01-14,13,3,OH,US,16,33
OUTLANDER 1000,2019-01-21,7,13,OH,US,20,51
OUTLANDER 850,2019-01-21,0,12,OH,US,12,47
OUTLANDER 450,2019-01-21,4,8,OH,US,12,45
OUTLANDER 1000,2019-01-28,2,7,OH,US,9,60
OUTLANDER 850,2019-01-28,4,1,OH,US,5,52
OUTLANDER 450,2019-01-28,13,4,OH,US,17,62
OUTLANDER 1000,2019-02-04,13,14,OH,US,27,87
OUTLANDER 850,2019-02-04,3,10,OH,US,13,65
OUTLANDER 450,2019-02-04,4,4,OH,US,8,70
OUTLANDER 1000,2019-02-11,12,3,OH,US,15,102
OUTLANDER 850,2019-02-11,9,7,OH,US,16,81
OUTLANDER 450,2019-02-11,1,2,OH,US,3,73
OUTLANDER 1000,2019-02-18,13,14,OH,US,27,129
OUTLANDER 850,2019-02-18,6,9,OH,US,15,96
OUTLANDER 450,2019-02-18,10,9,OH,US,19,92
OUTLANDER 1000,2019-02-25,7,6,OH,US,13,142
OUTLANDER 850,2019-02-25,12,14,OH,US,26,122
OUTLANDER 450,2019-02-25,11,14,OH,US,25,117
OUTLANDER 1000,2019-03-04,12,8,OH,US,20,162
OUTLANDER 850,2019-03-04,1,13,OH,US,14,136
OUTLANDER 450,2019-03-04,4,8,OH,US,12,129
OUTLANDER 1000,2019-03-11,9,7,OH,US,16,178
OUTLANDER 850,2019-03-11,6,4,OH,US,10,146
OUTLANDER 450,2019-03-11,8,14,OH,US,22,151
OUTLANDER 1000,2019-03-18,9,1,OH,US,10,188
OUTLANDER 850,2019-03-18,14,7,OH,US,21,167
OUTLANDER 450,2019-03-18,9,8,OH,US,17,168
OUTLANDER 1000,2019-03-25,10,12,OH,US,22,210
OUTLANDER 850,2019-03-25,12,5,OH,US,17,184
OUTLANDER 450,2019-03-25,13,10,OH,US,23,191
OUTLANDER 1000,2019-04-01,11,5,OH,US,16,226
OUTLANDER 850,2019-04-01,6,5,OH,US,11,195
OUTLANDER 450,2019-04-01,11,7,OH,US,18,209
OUTLANDER 1000,2019-04-08,2,5,OH,US,7,233
OUTLANDER 850,2019-04-08,7,7,OH,US,14,209
OUTLANDER 450,2019-04-08,12,14,OH,US,26,235
OUTLANDER 1000,2019-04-15,14,14,OH,US,28,261
OUTLANDER 850,2019-04-15,15,7,OH,US,22,231
OUTLANDER 450,2019-04-15,1,9,OH,US,10,245
OUTLANDER 1000,2019-04-22,13,15,OH,US,28,289
OUTLANDER 850,2019-04-22,13,13,OH,US,26,257
OUTLANDER 450,2019-04-22,5,8,OH,US,13,258
OUTLANDER 1000,2019-04-29,0,6,OH,US,6,295
OUTLANDER 850,2019-04-29,12,3,OH,US,15,272
OUTLANDER 450,2019-04-29,14,7,OH,US,21,279
OUTLANDER 1000,2019-05-06,8,9,OH,US,17,312
OUTLANDER 850,2019-05-06,15,10,OH,US,25,297
OUTLANDER 450,2019-05-06,7,5,OH,US,12,291
OUTLANDER 1000,2019-05-13,13,3,OH,US,16,328
OUTLANDER 850,2019-05-13,4,10,OH,US,14,311
OUTLANDER 450,2019-05-13,9,4,OH,US,13,304
OUTLANDER 1000,2019-05-20,11,4,OH,US,15,343
OUTLANDER 850,2019-05-20,1,9,OH,US,10,321
OUTLANDER 450,2019-05-20,3,4,OH,US,7,311
OUTLANDER 1000,2019-05-27,3,2,OH,US,5,348
OUTLANDER 850,2019-05-27,6,11,OH,US,17,338
OUTLANDER 450,2019-05-27,0,13,OH,US,13,324
OUTLANDER 1000,2019-06-03,7,8,OH,US,15,363
OUTLANDER 850,2019-06-03,2,10,OH,US,12,350
OUTLANDER 450,2019-06-03,1,4,OH,US,5,329
OUTLANDER 1000,2019-06-10,8,1,OH,US,9,372
OUTLANDER 850,2019-06-10,9,10,OH,US,19,369
OUTLANDER 450,2019-06-10,6,12,OH,US,18,347
OUTLANDER 1000,2019-06-17,10,8,OH,US,18,390
OUTLANDER 850,2019-06-17,5,12,OH,US,17,386
OUTLANDER 450,2019-06-17,1,14,OH,US,15,362
OUTLANDER 1000,2019-06-24,13,2,OH,US,15,405
OUTLANDER 850,2019-06-24,0,3,OH,US,3,389
OUTLANDER 450,2019-06-24,5,4,OH,US,9,371
OUTLANDER 1000,2019-07-01,0,1,OH,US,1,406
OUTLANDER 850,2019-07-01,4,12,OH,US,16,405
OUTLANDER 450,2019-07-01,10,9,OH,US,19,390
OUTLANDER 1000,2019-07-08,1,7,OH,US,8,414
OUTLANDER 850,2019-07-08,7,6,OH,US,13,418
OUTLANDER 450,2019-07-08,5,7,OH,US,12,402
OUTLANDER 1000,2019-07-15,5,8,OH,US,13,427
OUTLANDER 850,2019-07-15,15,5,OH,US,20,438
OUTLANDER 450,2019-07-15,11,15,OH,US,26,428
OUTLANDER 1000,2019-07-22,5,4,OH,US,9,436
OUTLANDER 850,2019-07-22,11,13,OH,US,24,462
OUTLANDER 450,2019-07-22,10,4,OH,US,14,442
OUTLANDER 1000,2019-07-29,7,10,OH,US,17,453
OUTLANDER 850,2019-07-29,11,6,OH,US,17,479
OUTLANDER 450,2019-07-29,1,3,OH,US,4,446
OUTLANDER 1000,2019-08-05,2,4,OH,US,6,459
OUTLANDER 850,2019-08-05,5,6,OH,US,11,490
OUTLANDER 450,2019-08-05,12,3,OH,US,15,461
OUTLANDER 1000,2019-08-12,5,8,OH,US,13,472
OUTLANDER 850,2019-08-12,2,3,OH,US,5,495
OUTLANDER 450,2019-08-12,11,2,OH,US,13,474
OUTLANDER 1000,2019-08-19,12,15,OH,US,27,499
OUTLANDER 850,2019-08-19,5,13,OH,US,18,513
OUTLANDER 450,2019-08-19,3,2,OH,US,5,479
OUTLANDER 1000,2019-08-26,7,2,OH,US,9,508
OUTLANDER 850,2019-08-26,6,3,OH,US,9,522
OUTLANDER 450,2019-08-26,1,6,OH,US,7,486
OUTLANDER 1000,2019-09-02,5,5,OH,US,10,518
OUTLANDER 850,2019-09-02,0,15,OH,US,15,537
OUTLANDER 450,2019-09-02,5,6,OH,US,11,497
OUTLANDER 1000,2019-09-09,3,12,OH,US,15,533
OUTLANDER 850,2019-09-09,8,8,OH,US,16,553
OUTLANDER 450,2019-09-09,12,12,OH,US,24,521
OUTLANDER 1000,2019-09-16,7,10,OH,US,17,550
OUTLANDER 850,2019-09-16,13,4,OH,US,17,570
OUTLANDER 450,2019-09-16,13,8,OH,US,21,542
OUTLANDER 1000,2019-09-23,1,11,OH,US,12,562
OUTLANDER 850,2019-09-23,9,15,OH,US,24,594
OUTLANDER 450,2019-09-23,11,7,OH,US,18,560
OUTLANDER 1000,2019-09-30,3,3,OH,US,6,568
OUTLANDER 850,2019-09-30,12,2,OH,US,14,608
OUTLANDER 450,2019-09-30,5,5,OH,US,10,570
OUTLANDER 1000,2019-10-07,9,2,OH,US,11,579
OUTLANDER 850,2019-10-07,0,1,OH,US,1,609
OUTLANDER 450,2019-10-07,14,4,OH,US,18,588
OUTLANDER 1000,2019-10-14,8,13,OH,US,21,600
OUTLANDER 850,2019-10-14,8,13,OH,US,21,630
OUTLANDER 450,2019-10-14,13,4,OH,US,17,605
OUTLANDER 1000,2019-10-21,5,4,OH,US,9,609
OUTLANDER 850,2019-10-21,14,12,OH,US,26,656
OUTLANDER 450,2019-10-21,0,9,OH,US,9,614
OUTLANDER 1000,2019-10-28,8,1,OH,US,9,618
OUTLANDER 850,2019-10-28,6,5,OH,US,11,667
OUTLANDER 450,2019-10-28,15,3,OH,US,18,632
OUTLANDER 1000,2019-11-04,10,2,OH,US,12,630
OUTLANDER 850,2019-11-04,11,14,OH,US,25,692
OUTLANDER 450,2019-11-04,9,15,OH,US,24,656
OUTLANDER 1000,2019-11-11,11,13,OH,US,24,654
OUTLANDER 850,2019-11-11,6,12,OH,US,18,710
OUTLANDER 450,2019-11-11,11,12,OH,US,23,679
OUTLANDER 1000,2019-11-18,3,5,OH,US,8,662
OUTLANDER 850,2019-11-18,5,7,OH,US,12,722
OUTLANDER 450,2019-11-18,7,1,OH,US,8,687
OUTLANDER 1000,2019-11-25,3,2,OH,US,5,667
OUTLANDER 850,2019-11-25,14,3,OH,US,17,739
OUTLANDER 450,2019-11-25,1,2,OH,US,3,690
OUTLANDER 1000,2019-12-02,1,9,OH,US,10,677
OUTLANDER 850,2019-12-02,11,4,OH,US,15,754
OUTLANDER 450,2019-12-02,7,8,OH,US,15,705
OUTLANDER 1000,2019-12-09,2,10,OH,US,12,689
OUTLANDER 850,2019-12-09,14,11,OH,US,25,779
OUTLANDER 450,2019-12-09,8,0,OH,US,8,713
OUTLANDER 1000,2019-12-16,0,14,OH,US,14,703
OUTLANDER 850,2019-12-16,3,3,OH,US,6,785
OUTLANDER 450,2019-12-16,9,3,OH,US,12,725
OUTLANDER 1000,2019-12-23,14,6,OH,US,20,723
OUTLANDER 850,2019-12-23,3,8,OH,US,11,796
OUTLANDER 450,2019-12-23,5,14,OH,US,19,744
OUTLANDER 1000,2019-12-30,9,12,OH,US,21,744
OUTLANDER 850,2019-12-30,14,12,OH,US,26,822
OUTLANDER 450,2019-12-30,2,1,OH,US,3,747
OUTLANDER 1000,2020-01-06,9,14,OH,US,23,767
OUTLANDER 850,2020-01-06,4,9,OH,US,13,835
OUTLANDER 450,2020-01-06,15,14,OH,US,29,776
OUTLANDER 1000,2020-01-13,1,6,OH,US,7,774
OUTLANDER 850,2020-01-13,9,6,OH,US,15,850
OUTLANDER 450,2020-01-13,5,8,OH,US,13,789
OUTLANDER 1000,2020-01-20,7,9,OH,US,16,790
OUTLANDER 850,2020-01-20,1,8,OH,US,9,859
OUTLANDER 450,2020-01-20,6,1,OH,US,7,796
OUTLANDER 1000,2020-01-27,11,6,OH,US,17,807
OUTLANDER 850,2020-01-27,4,0,OH,US,4,863
OUTLANDER 450,2020-01-27,11,14,OH,US,25,821
OUTLANDER 1000,2020-02-03,9,6,OH,US,15,822
OUTLANDER 850,2020-02-03,10,2,OH,US,12,875
OUTLANDER 450,2020-02-03,7,15,OH,US,22,843
OUTLANDER 1000,2020-02-10,1,2,OH,US,3,825
OUTLANDER 850,2020-02-10,5,7,OH,US,12,887
OUTLANDER 450,2020-02-10,9,5,OH,US,14,857
OUTLANDER 1000,2020-02-17,9,15,OH,US,24,849
OUTLANDER 850,2020-02-17,9,15,OH,US,24,911
OUTLANDER 450,2020-02-17,0,2,OH,US,2,859
OUTLANDER 1000,2020-02-24,14,14,OH,US,28,877
OUTLANDER 850,2020-02-24,8,6,OH,US,14,925
OUTLANDER 450,2020-02-24,9,8,OH,US,17,876
OUTLANDER 1000,2020-03-02,12,1,OH,US,13,890
OUTLANDER 850,2020-03-02,4,10,OH,US,14,939
OUTLANDER 450,2020-03-02,8,13,OH,US,21,897
OUTLANDER 1000,2020-03-09,13,1,OH,US,14,904
OUTLANDER 850,2020-03-09,3,13,OH,US,16,955
OUTLANDER 450,2020-03-09,0,11,OH,US,11,908
OUTLANDER 1000,2020-03-16,4,15,OH,US,19,923
OUTLANDER 850,2020-03-16,2,6,OH,US,8,963
OUTLANDER 450,2020-03-16,3,2,OH,US,5,913
OUTLANDER 1000,2020-03-23,15,8,OH,US,23,946
OUTLANDER 850,2020-03-23,3,4,OH,US,7,970
OUTLANDER 450,2020-03-23,12,10,OH,US,22,935
OUTLANDER 1000,2020-03-30,8,3,OH,US,11,957
OUTLANDER 850,2020-03-30,11,3,OH,US,14,984
OUTLANDER 450,2020-03-30,11,10,OH,US,21,956
OUTLANDER 1000,2020-04-06,2,1,OH,US,3,960
OUTLANDER 850,2020-04-06,3,9,OH,US,12,996
OUTLANDER 450,2020-04-06,2,2,OH,US,4,960
OUTLANDER 1000,2020-04-13,5,1,OH,US,6,966
OUTLANDER 850,2020-04-13,10,2,OH,US,12,1008
OUTLANDER 450,2020-04-13,13,2,OH,US,15,975
OUTLANDER 1000,2020-04-20,2,2,OH,US,4,970
OUTLANDER 850,2020-04-20,13,1,OH,US,14,1022
OUTLANDER 450,2020-04-20,3,10,OH,US,13,988
OUTLANDER 1000,2020-04-27,9,14,OH,US,23,993
OUTLANDER 850,2020-04-27,10,12,OH,US,22,1044
OUTLANDER 450,2020-04-27,0,15,OH,US,15,1003
OUTLANDER 1000,2020-05-04,8,13,OH,US,21,1014
OUTLANDER 850,2020-05-04,13,4,OH,US,17,1061
OUTLANDER 450,2020-05-04,0,11,OH,US,11,1014
OUTLANDER 1000,2020-05-11,2,6,OH,US,8,1022
OUTLANDER 850,2020-05-11,0,7,OH,US,7,1068
OUTLANDER 450,2020-05-11,11,1,OH,US,12,1026
OUTLANDER 1000,2020-05-18,14,5,OH,US,19,1041
OUTLANDER 850,2020-05-18,5,11,OH,US,16,1084
OUTLANDER 450,2020-05-18,14,9,OH,US,23,1049
OUTLANDER 1000,2020-05-25,0,10,OH,US,10,1051
OUTLANDER 850,2020-05-25,11,3,OH,US,14,1098
OUTLANDER 450,2020-05-25,6,15,OH,US,21,1070
OUTLANDER 1000,2020-06-01,0,10,OH,US,10,1061
OUTLANDER 850,2020-06-01,8,6,OH,US,14,1112
OUTLANDER 450,2020-06-01,2,14,OH,US,16,1086
OUTLANDER 1000,2020-06-08,12,0,OH,US,12,1073
OUTLANDER 850,2020-06-08,9,13,OH,US,22,1134
OUTLANDER 450,2020-06-08,5,9,OH,US,14,1100
OUTLANDER 1000,2020-06-15,3,9,OH,US,12,1085
OUTLANDER 850,2020-06-15,0,0,OH,US,0,1134
OUTLANDER 450,2020-06-15,7,10,OH,US,17,1117
OUTLANDER 1000,2020-06-22,3,14,OH,US,17,1102
OUTLANDER 850,2020-06-22,12,12,OH,US,24,1158
OUTLANDER 450,2020-06-22,7,7,OH,US,14,1131
OUTLANDER 1000,2020-06-29,10,11,OH,US,21,1123
OUTLANDER 850,2020-06-29,7,9,OH,US,16,1174
OUTLANDER 450,2020-06-29,5,13,OH,US,18,1149
OUTLANDER 1000,2020-07-06,10,14,OH,US,24,1147
OUTLANDER 850,2020-07-06,11,11,OH,US,22,1196
OUTLANDER 450,2020-07-06,10,4,OH,US,14,1163
OUTLANDER 1000,2020-07-13,13,12,OH,US,25,1172
OUTLANDER 850,2020-07-13,6,11,OH,US,17,1213
OUTLANDER 450,2020-07-13,6,5,OH,US,11,1174
OUTLANDER 1000,2020-07-20,10,6,OH,US,16,1188
OUTLANDER 850,2020-07-20,8,12,OH,US,20,1233
OUTLANDER 450,2020-07-20,5,10,OH,US,15,1189
OUTLANDER 1000,2020-07-27,13,5,OH,US,18,1206
OUTLANDER 850,2020-07-27,9,13,OH,US,22,1255
OUTLANDER 450,2020-07-27,6,9,OH,US,15,1204
OUTLANDER 1000,2020-08-03,9,0,OH,US,9,1215
OUTLANDER 850,2020-08-03,1,12,OH,US,13,1268
OUTLANDER 450,2020-08-03,9,14,OH,US,23,1227
OUTLANDER 1000,2020-08-10,13,14,OH,US,27,1242
OUTLANDER 850,2020-08-10,1,6,OH,US,7,1275
OUTLANDER 450,2020-08-10,13,9,OH,US,22,1249
OUTLANDER 1000,2020-08-17,6,9,OH,US,15,1257
OUTLANDER 850,2020-08-17,7,1,OH,US,8,1283
OUTLANDER 450,2020-08-17,8,1,OH,US,9,1258
OUTLANDER 1000,2020-08-24,14,15,OH,US,29,1286
OUTLANDER 850,2020-08-24,9,11,OH,US,20,1303
OUTLANDER 450,2020-08-24,1,2,OH,US,3,1261
OUTLANDER 1000,2020-08-31,7,11,OH,US,18,1304
OUTLANDER 850,2020-08-31,3,4,OH,US,7,1310
OUTLANDER 450,2020-08-31,3,14,OH,US,17,1278
OUTLANDER 1000,2020-09-07,13,7,OH,US,20,1324
OUTLANDER 850,2020-09-07,10,11,OH,US,21,1331
OUTLANDER 450,2020-09-07,1,13,OH,US,14,1292
OUTLANDER 1000,2020-09-14,2,4,OH,US,6,1330
OUTLANDER 850,2020-09-14,10,2,OH,US,12,1343
OUTLANDER 450,2020-09-14,4,1,OH,US,5,1297
OUTLANDER 1000,2020-09-21,2,4,OH,US,6,1336
OUTLANDER 850,2020-09-21,4,3,OH,US,7,1350
OUTLANDER 450,2020-09-21,12,2,OH,US,14,1311
OUTLANDER 1000,2020-09-28,12,5,OH,US,17,1353
OUTLANDER 850,2020-09-28,12,3,OH,US,15,1365
OUTLANDER 450,2020-09-28,10,7,OH,US,17,1328
OUTLANDER 1000,2020-10-05,12,5,OH,US,17,1370
OUTLANDER 850,2020-10-05,5,7,OH,US,12,1377
OUTLANDER 450,2020-10-05,12,2,OH,US,14,1342
OUTLANDER 1000,2020-10-12,11,9,OH,US,20,1390
OUTLANDER 850,2020-10-12,13,11,OH,US,24,1401
OUTLANDER 450,2020-10-12,4,6,OH,US,10,1352
OUTLANDER 1000,2020-10-19,7,8,OH,US,15,1405
OUTLANDER 850,2020-10-19,10,14,OH,US,24,1425
OUTLANDER 450,2020-10-19,14,4,OH,US,18,1370
OUTLANDER 1000,2020-10-26,13,14,OH,US,27,1432
OUTLANDER 850,2020-10-26,9,4,OH,US,13,1438
OUTLANDER 450,2020-10-26,9,13,OH,US,22,1392
OUTLANDER 1000,2020-11-02,5,8,OH,US,13,1445
OUTLANDER 850,2020-11-02,4,0,OH,US,4,1442
OUTLANDER 450,2020-11-02,11,1,OH,US,12,1404
OUTLANDER 1000,2020-11-09,14,13,OH,US,27,1472
OUTLANDER 850,2020-11-09,4,14,OH,US,18,1460
OUTLANDER 450,2020-11-09,11,7,OH,US,18,1422
OUTLANDER 1000,2020-11-16,4,9,OH,US,13,1485
OUTLANDER 850,2020-11-16,15,14,OH,US,29,1489
OUTLANDER 450,2020-11-16,11,8,OH,US,19,1441
OUTLANDER 1000,2020-11-23,1,5,OH,US,6,1491
OUTLANDER 850,2020-11-23,6,5,OH,US,11,1500
OUTLANDER 450,2020-11-23,9,13,OH,US,22,1463
OUTLANDER 1000,2020-11-30,1,2,OH,US,3,1494
OUTLANDER 850,2020-11-30,1,11,OH,US,12,1512
OUTLANDER 450,2020-11-30,3,13,OH,US,16,1479
OUTLANDER 1000,2020-12-07,12,8,OH,US,20,1514
OUTLANDER 850,2020-12-07,3,14,OH,US,17,1529
OUTLANDER 450,2020-12-07,15,7,OH,US,22,1501
OUTLANDER 1000,2020-12-14,8,8,OH,US,16,1530
OUTLANDER 850,2020-12-14,9,4,OH,US,13,1542
OUTLANDER 450,2020-12-14,1,13,OH,US,14,1515
OUTLANDER 1000,2020-12-21,6,2,OH,US,8,1538
OUTLANDER 850,2020-12-21,7,8,OH,US,15,1557
OUTLANDER 450,2020-12-21,0,14,OH,US,14,1529
OUTLANDER 1000,2020-12-28,10,5,OH,US,15,1553
OUTLANDER 850,2020-12-28,4,10,OH,US,14,1571
OUTLANDER 450,2020-12-28,7,9,OH,US,16,1545
OUTLANDER 1000,2021-01-04,12,1,OH,US,13,1566
OUTLANDER 850,2021-01-04,12,5,OH,US,17,1588
OUTLANDER 450,2021-01-04,5,10,OH,US,15,1560
OUTLANDER 1000,2021-01-11,4,3,OH,US,7,1573
OUTLANDER 850,2021-01-11,4,11,OH,US,15,1603
OUTLANDER 450,2021-01-11,13,4,OH,US,17,1577
OUTLANDER 1000,2021-01-18,6,5,OH,US,11,1584
OUTLANDER 850,2021-01-18,11,6,OH,US,17,1620
OUTLANDER 450,2021-01-18,8,10,OH,US,18,1595
OUTLANDER 1000,2021-01-25,10,8,OH,US,18,1602
OUTLANDER 850,2021-01-25,9,14,OH,US,23,1643
OUTLANDER 450,2021-01-25,2,5,OH,US,7,1602
OUTLANDER 1000,2021-02-01,14,12,OH,US,26,1628
OUTLANDER 850,2021-02-01,10,11,OH,US,21,1664
OUTLANDER 450,2021-02-01,7,9,OH,US,16,1618
OUTLANDER 1000,2021-02-08,3,5,OH,US,8,1636
OUTLANDER 850,2021-02-08,9,12,OH,US,21,1685
OUTLANDER 450,2021-02-08,3,15,OH,US,18,1636
OUTLANDER 1000,2021-02-15,10,2,OH,US,12,1648
OUTLANDER 850,2021-02-15,6,12,OH,US,18,1703
OUTLANDER 450,2021-02-15,0,3,OH,US,3,1639
OUTLANDER 1000,2021-02-22,4,2,OH,US,6,1654
OUTLANDER 850,2021-02-22,7,10,OH,US,17,1720
OUTLANDER 450,2021-02-22,11,13,OH,US,24,1663
OUTLANDER 1000,2021-03-01,3,0,OH,US,3,1657
OUTLANDER 850,2021-03-01,12,7,OH,US,19,1739
OUTLANDER 450,2021-03-01,8,10,OH,US,18,1681
OUTLANDER 1000,2021-03-08,14,13,OH,US,27,1684
OUTLANDER 850,2021-03-08,2,7,OH,US,9,1748
OUTLANDER 450,2021-03-08,1,10,OH,US,11,1692
OUTLANDER 1000,2021-03-15,5,3,OH,US,8,1692
OUTLANDER 850,2021-03-15,0,9,OH,US,9,1757
OUTLANDER 450,2021-03-15,8,5,OH,US,13,1705
OUTLANDER 1000,2021-03-22,1,1,OH,US,2,1694
OUTLANDER 850,2021-03-22,6,15,OH,US,21,1778
OUTLANDER 450,2021-03-22,9,11,OH,US,20,1725
OUTLANDER 1000,2021-03-29,10,14,OH,US,24,1718
OUTLANDER 850,2021-03-29,2,12,OH,US,14,1792
OUTLANDER 450,2021-03-29,5,4,OH,US,9,1734
OUTLANDER 1000,2021-04-05,6,11,OH,US,17,1735
OUTLANDER 850,2021-04-05,12,10,OH,US,22,1814
OUTLANDER 450,2021-04-05,9,10,OH,US,19,1753
OUTLANDER 1000,2021-04-12,7,0,OH,US,7,1742
OUTLANDER 850,2021-04-12,10,10,OH,US,20,1834
OUTLANDER 450,2021-04-12,10,11,OH,US,21,1774
OUTLANDER 1000,2021-04-19,6,10,OH,US,16,1758
OUTLANDER 850,2021-04-19,13,10,OH,US,23,1857
OUTLANDER 450,2021-04-19,11,12,OH,US,23,1797
OUTLANDER 1000,2021-04-26,12,8,OH,US,20,1778
OUTLANDER 850,2021-04-26,7,12,OH,US,19,1876
OUTLANDER 450,2021-04-26,1,1,OH,US,2,1799
OUTLANDER 1000,2021-05-03,12,14,OH,US,26,1804
OUTLANDER 850,2021-05-03,1,9,OH,US,10,1886
OUTLANDER 450,2021-05-03,1,9,OH,US,10,1809
OUTLANDER 1000,2021-05-10,2,2,OH,US,4,1808
OUTLANDER 850,2021-05-10,2,14,OH,US,16,1902
OUTLANDER 450,2021-05-10,8,13,OH,US,21,1830
OUTLANDER 1000,2021-05-17,4,6,OH,US,10,1818
OUTLANDER 850,2021-05-17,7,15,OH,US,22,1924
OUTLANDER 450,2021-05-17,2,13,OH,US,15,1845
OUTLANDER 1000,2021-05-24,3,8,OH,US,11,1829
OUTLANDER 850,2021-05-24,6,6,OH,US,12,1936
OUTLANDER 450,2021-05-24,14,5,OH,US,19,1864
OUTLANDER 1000,2021-05-31,8,14,OH,US,22,1851
OUTLANDER 850,2021-05-31,10,0,OH,US,10,1946
OUTLANDER 450,2021-05-31,13,14,OH,US,27,1891
OUTLANDER 1000,2021-06-07,4,14,OH,US,18,1869
OUTLANDER 850,2021-06-07,11,6,OH,US,17,1963
OUTLANDER 450,2021-06-07,5,6,OH,US,11,1902
OUTLANDER 1000,2021-06-14,11,4,OH,US,15,1884
OUTLANDER 850,2021-06-14,10,6,OH,US,16,1979
OUTLANDER 450,2021-06-14,5,6,OH,US,11,1913
OUTLANDER 1000,2021-06-21,15,13,OH,US,28,1912
OUTLANDER 850,2021-06-21,6,8,OH,US,14,1993
OUTLANDER 450,2021-06-21,5,10,OH,US,15,1928
OUTLANDER 1000,2021-06-28,4,11,OH,US,15,1927
OUTLANDER 850,2021-06-28,14,14,OH,US,28,2021
OUTLANDER 450,2021-06-28,10,14,OH,US,24,1952
OUTLANDER 1000,2021-07-05,10,10,OH,US,20,1947
OUTLANDER 850,2021-07-05,6,12,OH,US,18,2039
OUTLANDER 450,2021-07-05,0,9,OH,US,9,1961
OUTLANDER 1000,2021-07-12,10,3,OH,US,13,1960
OUTLANDER 850,2021-07-12,13,3,OH,US,16,2055
OUTLANDER 450,2021-07-12,12,8,OH,US,20,1981
OUTLANDER 1000,2021-07-19,12,4,OH,US,16,1976
OUTLANDER 850,2021-07-19,3,8,OH,US,11,2066
OUTLANDER 450,2021-07-19,2,5,OH,US,7,1988
OUTLANDER 1000,2021-07-26,10,2,OH,US,12,1988
OUTLANDER 850,2021-07-26,6,12,OH,US,18,2084
OUTLANDER 450,2021-07-26,8,5,OH,US,13,2001
OUTLANDER 1000,2021-08-02,6,10,OH,US,16,2004
OUTLANDER 850,2021-08-02,15,0,OH,US,15,2099
OUTLANDER 450,2021-08-02,6,5,OH,US,11,2012
OUTLANDER 1000,2021-08-09,11,6,OH,US,17,2021
OUTLANDER 850,2021-08-09,1,3,OH,US,4,2103
OUTLANDER 450,2021-08-09,13,9,OH,US,22,2034
OUTLANDER 1000,2021-08-16,11,4,OH,US,15,2036
OUTLANDER 850,2021-08-16,6,14,OH,US,20,2123
OUTLANDER 450,2021-08-16,0,1,OH,US,1,2035
OUTLANDER 1000,2021-08-23,2,2,OH,US,4,2040
OUTLANDER 850,2021-08-23,10,8,OH,US,18,2141
OUTLANDER 450,2021-08-23,6,6,OH,US,12,2047
OUTLANDER 1000,2021-08-30,13,8,OH,US,21,2061
OUTLANDER 850,2021-08-30,3,1,OH,US,4,2145
OUTLANDER 450,2021-08-30,11,7,OH,US,18,2065
OUTLANDER 1000,2021-09-06,13,11,OH,US,24,2085
OUTLANDER 850,2021-09-06,9,7,OH,US,16,2161
OUTLANDER 450,2021-09-06,12,6,OH,US,18,2083
OUTLANDER 1000,2021-09-13,6,9,OH,US,15,2100
OUTLANDER 850,2021-09-13,10,14,OH,US,24,2185
OUTLANDER 450,2021-09-13,9,12,OH,US,21,2104
OUTLANDER 1000,2021-09-20,8,1,OH,US,9,2109
OUTLANDER 850,2021-09-20,2,5,OH,US,7,2192
OUTLANDER 450,2021-09-20,9,7,OH,US,16,2120
OUTLANDER 1000,2021-09-27,2,7,OH,US,9,2118
OUTLANDER 850,2021-09-27,5,4,OH,US,9,2201
OUTLANDER 450,2021-09-27,14,4,OH,US,18,2138
OUTLANDER 1000,2021-10-04,15,11,OH,US,26,2144
OUTLANDER 850,2021-10-04,5,8,OH,US,13,2214
OUTLANDER 450,2021-10-04,1,6,OH,US,7,2145
OUTLANDER 1000,2021-10-11,0,7,OH,US,7,2151
OUTLANDER 850,2021-10-11,5,14,OH,US,19,2233
OUTLANDER 450,2021-10-11,12,12,OH,US,24,2169
OUTLANDER 1000,2021-10-18,3,13,OH,US,16,2167
OUTLANDER 850,2021-10-18,7,2,OH,US,9,2242
OUTLANDER 450,2021-10-18,6,11,OH,US,17,2186
OUTLANDER 1000,2021-10-25,2,11,OH,US,13,2180
OUTLANDER 850,2021-10-25,0,11,OH,US,11,2253
OUTLANDER 450,2021-10-25,5,6,OH,US,11,2197
OUTLANDER 1000,2021-11-01,1,13,OH,US,14,2194
OUTLANDER 850,2021-11-01,9,5,OH,US,14,2267
OUTLANDER 450,2021-11-01,6,10,OH,US,16,2213
OUTLANDER 1000,2021-11-08,13,9,OH,US,22,2216
OUTLANDER 850,2021-11-08,13,11,OH,US,24,2291
OUTLANDER 450,2021-11-08,8,5,OH,US,13,2226
OUTLANDER 1000,2021-11-15,13,9,OH,US,22,2238
OUTLANDER 850,2021-11-15,7,2,OH,US,9,2300
OUTLANDER 450,2021-11-15,4,9,OH,US,13,2239
OUTLANDER 1000,2021-11-22,5,8,OH,US,13,2251
OUTLANDER 850,2021-11-22,9,4,OH,US,13,2313
OUTLANDER 450,2021-11-22,14,8,OH,US,22,2261
OUTLANDER 1000,2021-11-29,9,5,OH,US,14,2265
OUTLANDER 850,2021-11-29,3,9,OH,US,12,2325
OUTLANDER 450,2021-11-29,6,6,OH,US,12,2273
OUTLANDER 1000,2021-12-06,7,1,OH,US,8,2273
OUTLANDER 850,2021-12-06,6,8,OH,US,14,2339
OUTLANDER 450,2021-12-06,15,7,OH,US,22,2295
OUTLANDER 1000,2021-12-13,10,12,OH,US,22,2295
OUTLANDER 850,2021-12-13,12,0,OH,US,12,2351
OUTLANDER 450,2021-12-13,12,15,OH,US,27,2322
OUTLANDER 1000,2021-12-20,14,11,OH,US,25,2320
OUTLANDER 850,2021-12-20,9,12,OH,US,21,2372
OUTLANDER 450,2021-12-20,11,4,OH,US,15,2337
OUTLANDER 1000,2021-12-27,3,1,OH,US,4,2324
OUTLANDER 850,2021-12-27,4,2,OH,US,6,2378
OUTLANDER 450,2021-12-27,5,9,OH,US,14,2351
OUTLANDER 1000,2019-01-07,12,4,OK,US,16,16
OUTLANDER 850,2019-01-07,7,10,OK,US,17,17
OUTLANDER 450,2019-01-07,14,10,OK,US,24,24
OUTLANDER 1000,2019-01-14,15,14,OK,US,29,45
OUTLANDER 850,2019-01-14,2,7,OK,US,9,26
OUTLANDER 450,2019-01-14,6,13,OK,US,19,43
OUTLANDER 1000,2019-01-21,9,13,OK,US,22,67
OUTLANDER 850,2019-01-21,7,2,OK,US,9,35
OUTLANDER 450,2019-01-21,6,11,OK,US,17,60
OUTLANDER 1000,2019-01-28,12,6,OK,US,18,85
OUTLANDER 850,2019-01-28,3,6,OK,US,9,44
OUTLANDER 450,2019-01-28,1,4,OK,US,5,65
OUTLANDER 1000,2019-02-04,12,6,OK,US,18,103
OUTLANDER 850,2019-02-04,6,6,OK,US,12,56
OUTLANDER 450,2019-02-04,6,9,OK,US,15,80
OUTLANDER 1000,2019-02-11,14,10,OK,US,24,127
OUTLANDER 850,2019-02-11,9,6,OK,US,15,71
OUTLANDER 450,2019-02-11,3,2,OK,US,5,85
OUTLANDER 1000,2019-02-18,7,5,OK,US,12,139
OUTLANDER 850,2019-02-18,5,11,OK,US,16,87
OUTLANDER 450,2019-02-18,14,6,OK,US,20,105
OUTLANDER 1000,2019-02-25,14,11,OK,US,25,164
OUTLANDER 850,2019-02-25,9,8,OK,US,17,104
OUTLANDER 450,2019-02-25,1,8,OK,US,9,114
OUTLANDER 1000,2019-03-04,9,11,OK,US,20,184
OUTLANDER 850,2019-03-04,1,3,OK,US,4,108
OUTLANDER 450,2019-03-04,10,12,OK,US,22,136
OUTLANDER 1000,2019-03-11,1,2,OK,US,3,187
OUTLANDER 850,2019-03-11,12,8,OK,US,20,128
OUTLANDER 450,2019-03-11,1,14,OK,US,15,151
OUTLANDER 1000,2019-03-18,10,3,OK,US,13,200
OUTLANDER 850,2019-03-18,2,7,OK,US,9,137
OUTLANDER 450,2019-03-18,7,8,OK,US,15,166
OUTLANDER 1000,2019-03-25,13,1,OK,US,14,214
OUTLANDER 850,2019-03-25,4,1,OK,US,5,142
OUTLANDER 450,2019-03-25,6,12,OK,US,18,184
OUTLANDER 1000,2019-04-01,13,2,OK,US,15,229
OUTLANDER 850,2019-04-01,7,12,OK,US,19,161
OUTLANDER 450,2019-04-01,2,6,OK,US,8,192
OUTLANDER 1000,2019-04-08,1,13,OK,US,14,243
OUTLANDER 850,2019-04-08,12,13,OK,US,25,186
OUTLANDER 450,2019-04-08,5,12,OK,US,17,209
OUTLANDER 1000,2019-04-15,9,5,OK,US,14,257
OUTLANDER 850,2019-04-15,6,7,OK,US,13,199
OUTLANDER 450,2019-04-15,7,12,OK,US,19,228
OUTLANDER 1000,2019-04-22,1,14,OK,US,15,272
OUTLANDER 850,2019-04-22,14,11,OK,US,25,224
OUTLANDER 450,2019-04-22,9,14,OK,US,23,251
OUTLANDER 1000,2019-04-29,5,3,OK,US,8,280
OUTLANDER 850,2019-04-29,3,8,OK,US,11,235
OUTLANDER 450,2019-04-29,13,8,OK,US,21,272
OUTLANDER 1000,2019-05-06,4,12,OK,US,16,296
OUTLANDER 850,2019-05-06,2,8,OK,US,10,245
OUTLANDER 450,2019-05-06,4,11,OK,US,15,287
OUTLANDER 1000,2019-05-13,10,8,OK,US,18,314
OUTLANDER 850,2019-05-13,14,14,OK,US,28,273
OUTLANDER 450,2019-05-13,13,1,OK,US,14,301
OUTLANDER 1000,2019-05-20,9,1,OK,US,10,324
OUTLANDER 850,2019-05-20,12,8,OK,US,20,293
OUTLANDER 450,2019-05-20,9,9,OK,US,18,319
OUTLANDER 1000,2019-05-27,0,5,OK,US,5,329
OUTLANDER 850,2019-05-27,7,3,OK,US,10,303
OUTLANDER 450,2019-05-27,8,11,OK,US,19,338
OUTLANDER 1000,2019-06-03,4,6,OK,US,10,339
OUTLANDER 850,2019-06-03,4,8,OK,US,12,315
OUTLANDER 450,2019-06-03,11,9,OK,US,20,358
OUTLANDER 1000,2019-06-10,1,9,OK,US,10,349
OUTLANDER 850,2019-06-10,3,4,OK,US,7,322
OUTLANDER 450,2019-06-10,0,1,OK,US,1,359
OUTLANDER 1000,2019-06-17,13,7,OK,US,20,369
OUTLANDER 850,2019-06-17,2,7,OK,US,9,331
OUTLANDER 450,2019-06-17,3,3,OK,US,6,365
OUTLANDER 1000,2019-06-24,5,7,OK,US,12,381
OUTLANDER 850,2019-06-24,6,7,OK,US,13,344
OUTLANDER 450,2019-06-24,12,11,OK,US,23,388
OUTLANDER 1000,2019-07-01,14,14,OK,US,28,409
OUTLANDER 850,2019-07-01,13,8,OK,US,21,365
OUTLANDER 450,2019-07-01,2,10,OK,US,12,400
OUTLANDER 1000,2019-07-08,3,2,OK,US,5,414
OUTLANDER 850,2019-07-08,5,8,OK,US,13,378
OUTLANDER 450,2019-07-08,9,3,OK,US,12,412
OUTLANDER 1000,2019-07-15,5,9,OK,US,14,428
OUTLANDER 850,2019-07-15,5,9,OK,US,14,392
OUTLANDER 450,2019-07-15,5,5,OK,US,10,422
OUTLANDER 1000,2019-07-22,5,2,OK,US,7,435
OUTLANDER 850,2019-07-22,3,2,OK,US,5,397
OUTLANDER 450,2019-07-22,5,12,OK,US,17,439
OUTLANDER 1000,2019-07-29,7,6,OK,US,13,448
OUTLANDER 850,2019-07-29,4,9,OK,US,13,410
OUTLANDER 450,2019-07-29,8,2,OK,US,10,449
OUTLANDER 1000,2019-08-05,8,9,OK,US,17,465
OUTLANDER 850,2019-08-05,0,10,OK,US,10,420
OUTLANDER 450,2019-08-05,13,2,OK,US,15,464
OUTLANDER 1000,2019-08-12,11,10,OK,US,21,486
OUTLANDER 850,2019-08-12,8,7,OK,US,15,435
OUTLANDER 450,2019-08-12,12,3,OK,US,15,479
OUTLANDER 1000,2019-08-19,12,15,OK,US,27,513
OUTLANDER 850,2019-08-19,10,14,OK,US,24,459
OUTLANDER 450,2019-08-19,9,6,OK,US,15,494
OUTLANDER 1000,2019-08-26,2,2,OK,US,4,517
OUTLANDER 850,2019-08-26,11,3,OK,US,14,473
OUTLANDER 450,2019-08-26,12,13,OK,US,25,519
OUTLANDER 1000,2019-09-02,8,0,OK,US,8,525
OUTLANDER 850,2019-09-02,14,2,OK,US,16,489
OUTLANDER 450,2019-09-02,5,13,OK,US,18,537
OUTLANDER 1000,2019-09-09,8,11,OK,US,19,544
OUTLANDER 850,2019-09-09,13,9,OK,US,22,511
OUTLANDER 450,2019-09-09,0,5,OK,US,5,542
OUTLANDER 1000,2019-09-16,5,3,OK,US,8,552
OUTLANDER 850,2019-09-16,6,1,OK,US,7,518
OUTLANDER 450,2019-09-16,4,9,OK,US,13,555
OUTLANDER 1000,2019-09-23,2,2,OK,US,4,556
OUTLANDER 850,2019-09-23,13,3,OK,US,16,534
OUTLANDER 450,2019-09-23,10,6,OK,US,16,571
OUTLANDER 1000,2019-09-30,3,12,OK,US,15,571
OUTLANDER 850,2019-09-30,8,3,OK,US,11,545
OUTLANDER 450,2019-09-30,12,2,OK,US,14,585
OUTLANDER 1000,2019-10-07,3,11,OK,US,14,585
OUTLANDER 850,2019-10-07,3,3,OK,US,6,551
OUTLANDER 450,2019-10-07,10,13,OK,US,23,608
OUTLANDER 1000,2019-10-14,9,4,OK,US,13,598
OUTLANDER 850,2019-10-14,1,2,OK,US,3,554
OUTLANDER 450,2019-10-14,11,12,OK,US,23,631
OUTLANDER 1000,2019-10-21,4,0,OK,US,4,602
OUTLANDER 850,2019-10-21,7,6,OK,US,13,567
OUTLANDER 450,2019-10-21,12,2,OK,US,14,645
OUTLANDER 1000,2019-10-28,7,13,OK,US,20,622
OUTLANDER 850,2019-10-28,2,13,OK,US,15,582
OUTLANDER 450,2019-10-28,12,10,OK,US,22,667
OUTLANDER 1000,2019-11-04,12,12,OK,US,24,646
OUTLANDER 850,2019-11-04,11,8,OK,US,19,601
OUTLANDER 450,2019-11-04,12,13,OK,US,25,692
OUTLANDER 1000,2019-11-11,5,3,OK,US,8,654
OUTLANDER 850,2019-11-11,11,12,OK,US,23,624
OUTLANDER 450,2019-11-11,10,14,OK,US,24,716
OUTLANDER 1000,2019-11-18,12,3,OK,US,15,669
OUTLANDER 850,2019-11-18,5,3,OK,US,8,632
OUTLANDER 450,2019-11-18,6,3,OK,US,9,725
OUTLANDER 1000,2019-11-25,5,7,OK,US,12,681
OUTLANDER 850,2019-11-25,10,1,OK,US,11,643
OUTLANDER 450,2019-11-25,9,11,OK,US,20,745
OUTLANDER 1000,2019-12-02,13,5,OK,US,18,699
OUTLANDER 850,2019-12-02,9,9,OK,US,18,661
OUTLANDER 450,2019-12-02,4,11,OK,US,15,760
OUTLANDER 1000,2019-12-09,2,1,OK,US,3,702
OUTLANDER 850,2019-12-09,13,0,OK,US,13,674
OUTLANDER 450,2019-12-09,9,13,OK,US,22,782
OUTLANDER 1000,2019-12-16,9,6,OK,US,15,717
OUTLANDER 850,2019-12-16,10,7,OK,US,17,691
OUTLANDER 450,2019-12-16,2,8,OK,US,10,792
OUTLANDER 1000,2019-12-23,11,7,OK,US,18,735
OUTLANDER 850,2019-12-23,6,9,OK,US,15,706
OUTLANDER 450,2019-12-23,10,7,OK,US,17,809
OUTLANDER 1000,2019-12-30,9,7,OK,US,16,751
OUTLANDER 850,2019-12-30,2,6,OK,US,8,714
OUTLANDER 450,2019-12-30,12,3,OK,US,15,824
OUTLANDER 1000,2020-01-06,0,1,OK,US,1,752
OUTLANDER 850,2020-01-06,3,5,OK,US,8,722
OUTLANDER 450,2020-01-06,2,8,OK,US,10,834
OUTLANDER 1000,2020-01-13,7,9,OK,US,16,768
OUTLANDER 850,2020-01-13,6,11,OK,US,17,739
OUTLANDER 450,2020-01-13,12,10,OK,US,22,856
OUTLANDER 1000,2020-01-20,5,4,OK,US,9,777
OUTLANDER 850,2020-01-20,11,2,OK,US,13,752
OUTLANDER 450,2020-01-20,10,9,OK,US,19,875
OUTLANDER 1000,2020-01-27,12,13,OK,US,25,802
OUTLANDER 850,2020-01-27,9,10,OK,US,19,771
OUTLANDER 450,2020-01-27,15,3,OK,US,18,893
OUTLANDER 1000,2020-02-03,13,7,OK,US,20,822
OUTLANDER 850,2020-02-03,6,3,OK,US,9,780
OUTLANDER 450,2020-02-03,6,4,OK,US,10,903
OUTLANDER 1000,2020-02-10,3,8,OK,US,11,833
OUTLANDER 850,2020-02-10,11,7,OK,US,18,798
OUTLANDER 450,2020-02-10,8,14,OK,US,22,925
OUTLANDER 1000,2020-02-17,8,11,OK,US,19,852
OUTLANDER 850,2020-02-17,0,2,OK,US,2,800
OUTLANDER 450,2020-02-17,2,5,OK,US,7,932
OUTLANDER 1000,2020-02-24,4,13,OK,US,17,869
OUTLANDER 850,2020-02-24,6,4,OK,US,10,810
OUTLANDER 450,2020-02-24,13,14,OK,US,27,959
OUTLANDER 1000,2020-03-02,2,12,OK,US,14,883
OUTLANDER 850,2020-03-02,8,2,OK,US,10,820
OUTLANDER 450,2020-03-02,7,1,OK,US,8,967
OUTLANDER 1000,2020-03-09,3,8,OK,US,11,894
OUTLANDER 850,2020-03-09,12,11,OK,US,23,843
OUTLANDER 450,2020-03-09,6,11,OK,US,17,984
OUTLANDER 1000,2020-03-16,0,5,OK,US,5,899
OUTLANDER 850,2020-03-16,6,9,OK,US,15,858
OUTLANDER 450,2020-03-16,8,1,OK,US,9,993
OUTLANDER 1000,2020-03-23,3,15,OK,US,18,917
OUTLANDER 850,2020-03-23,5,4,OK,US,9,867
OUTLANDER 450,2020-03-23,13,15,OK,US,28,1021
OUTLANDER 1000,2020-03-30,10,1,OK,US,11,928
OUTLANDER 850,2020-03-30,10,7,OK,US,17,884
OUTLANDER 450,2020-03-30,3,14,OK,US,17,1038
OUTLANDER 1000,2020-04-06,2,2,OK,US,4,932
OUTLANDER 850,2020-04-06,5,9,OK,US,14,898
OUTLANDER 450,2020-04-06,11,14,OK,US,25,1063
OUTLANDER 1000,2020-04-13,6,7,OK,US,13,945
OUTLANDER 850,2020-04-13,10,6,OK,US,16,914
OUTLANDER 450,2020-04-13,8,11,OK,US,19,1082
OUTLANDER 1000,2020-04-20,14,0,OK,US,14,959
OUTLANDER 850,2020-04-20,5,0,OK,US,5,919
OUTLANDER 450,2020-04-20,14,5,OK,US,19,1101
OUTLANDER 1000,2020-04-27,2,1,OK,US,3,962
OUTLANDER 850,2020-04-27,8,12,OK,US,20,939
OUTLANDER 450,2020-04-27,0,4,OK,US,4,1105
OUTLANDER 1000,2020-05-04,6,4,OK,US,10,972
OUTLANDER 850,2020-05-04,8,14,OK,US,22,961
OUTLANDER 450,2020-05-04,9,2,OK,US,11,1116
OUTLANDER 1000,2020-05-11,14,10,OK,US,24,996
OUTLANDER 850,2020-05-11,1,0,OK,US,1,962
OUTLANDER 450,2020-05-11,6,14,OK,US,20,1136
OUTLANDER 1000,2020-05-18,8,10,OK,US,18,1014
OUTLANDER 850,2020-05-18,13,6,OK,US,19,981
OUTLANDER 450,2020-05-18,2,4,OK,US,6,1142
OUTLANDER 1000,2020-05-25,11,1,OK,US,12,1026
OUTLANDER 850,2020-05-25,14,10,OK,US,24,1005
OUTLANDER 450,2020-05-25,6,0,OK,US,6,1148
OUTLANDER 1000,2020-06-01,9,10,OK,US,19,1045
OUTLANDER 850,2020-06-01,12,15,OK,US,27,1032
OUTLANDER 450,2020-06-01,6,9,OK,US,15,1163
OUTLANDER 1000,2020-06-08,13,1,OK,US,14,1059
OUTLANDER 850,2020-06-08,2,12,OK,US,14,1046
OUTLANDER 450,2020-06-08,8,4,OK,US,12,1175
OUTLANDER 1000,2020-06-15,14,7,OK,US,21,1080
OUTLANDER 850,2020-06-15,10,6,OK,US,16,1062
OUTLANDER 450,2020-06-15,11,10,OK,US,21,1196
OUTLANDER 1000,2020-06-22,4,15,OK,US,19,1099
OUTLANDER 850,2020-06-22,0,3,OK,US,3,1065
OUTLANDER 450,2020-06-22,4,13,OK,US,17,1213
OUTLANDER 1000,2020-06-29,4,10,OK,US,14,1113
OUTLANDER 850,2020-06-29,10,11,OK,US,21,1086
OUTLANDER 450,2020-06-29,13,14,OK,US,27,1240
OUTLANDER 1000,2020-07-06,13,5,OK,US,18,1131
OUTLANDER 850,2020-07-06,13,8,OK,US,21,1107
OUTLANDER 450,2020-07-06,14,6,OK,US,20,1260
OUTLANDER 1000,2020-07-13,11,12,OK,US,23,1154
OUTLANDER 850,2020-07-13,6,6,OK,US,12,1119
OUTLANDER 450,2020-07-13,13,3,OK,US,16,1276
OUTLANDER 1000,2020-07-20,5,3,OK,US,8,1162
OUTLANDER 850,2020-07-20,6,10,OK,US,16,1135
OUTLANDER 450,2020-07-20,12,4,OK,US,16,1292
OUTLANDER 1000,2020-07-27,2,15,OK,US,17,1179
OUTLANDER 850,2020-07-27,9,8,OK,US,17,1152
OUTLANDER 450,2020-07-27,3,8,OK,US,11,1303
OUTLANDER 1000,2020-08-03,3,10,OK,US,13,1192
OUTLANDER 850,2020-08-03,9,11,OK,US,20,1172
OUTLANDER 450,2020-08-03,1,5,OK,US,6,1309
OUTLANDER 1000,2020-08-10,10,3,OK,US,13,1205
OUTLANDER 850,2020-08-10,13,13,OK,US,26,1198
OUTLANDER 450,2020-08-10,15,5,OK,US,20,1329
OUTLANDER 1000,2020-08-17,2,13,OK,US,15,1220
OUTLANDER 850,2020-08-17,6,8,OK,US,14,1212
OUTLANDER 450,2020-08-17,7,5,OK,US,12,1341
OUTLANDER 1000,2020-08-24,5,14,OK,US,19,1239
OUTLANDER 850,2020-08-24,6,5,OK,US,11,1223
OUTLANDER 450,2020-08-24,5,9,OK,US,14,1355
OUTLANDER 1000,2020-08-31,6,7,OK,US,13,1252
OUTLANDER 850,2020-08-31,9,13,OK,US,22,1245
OUTLANDER 450,2020-08-31,13,5,OK,US,18,1373
OUTLANDER 1000,2020-09-07,9,11,OK,US,20,1272
OUTLANDER 850,2020-09-07,2,8,OK,US,10,1255
OUTLANDER 450,2020-09-07,4,3,OK,US,7,1380
OUTLANDER 1000,2020-09-14,4,10,OK,US,14,1286
OUTLANDER 850,2020-09-14,6,11,OK,US,17,1272
OUTLANDER 450,2020-09-14,1,1,OK,US,2,1382
OUTLANDER 1000,2020-09-21,10,0,OK,US,10,1296
OUTLANDER 850,2020-09-21,2,10,OK,US,12,1284
OUTLANDER 450,2020-09-21,6,9,OK,US,15,1397
OUTLANDER 1000,2020-09-28,3,6,OK,US,9,1305
OUTLANDER 850,2020-09-28,7,0,OK,US,7,1291
OUTLANDER 450,2020-09-28,1,7,OK,US,8,1405
OUTLANDER 1000,2020-10-05,12,6,OK,US,18,1323
OUTLANDER 850,2020-10-05,1,1,OK,US,2,1293
OUTLANDER 450,2020-10-05,0,3,OK,US,3,1408
OUTLANDER 1000,2020-10-12,8,8,OK,US,16,1339
OUTLANDER 850,2020-10-12,12,14,OK,US,26,1319
OUTLANDER 450,2020-10-12,13,0,OK,US,13,1421
OUTLANDER 1000,2020-10-19,2,3,OK,US,5,1344
OUTLANDER 850,2020-10-19,8,12,OK,US,20,1339
OUTLANDER 450,2020-10-19,10,11,OK,US,21,1442
OUTLANDER 1000,2020-10-26,4,7,OK,US,11,1355
OUTLANDER 850,2020-10-26,7,2,OK,US,9,1348
OUTLANDER 450,2020-10-26,2,2,OK,US,4,1446
OUTLANDER 1000,2020-11-02,13,7,OK,US,20,1375
OUTLANDER 850,2020-11-02,14,7,OK,US,21,1369
OUTLANDER 450,2020-11-02,4,11,OK,US,15,1461
OUTLANDER 1000,2020-11-09,9,1,OK,US,10,1385
OUTLANDER 850,2020-11-09,5,11,OK,US,16,1385
OUTLANDER 450,2020-11-09,1,14,OK,US,15,1476
OUTLANDER 1000,2020-11-16,8,1,OK,US,9,1394
OUTLANDER 850,2020-11-16,15,8,OK,US,23,1408
OUTLANDER 450,2020-11-16,5,10,OK,US,15,1491
OUTLANDER 1000,2020-11-23,6,8,OK,US,14,1408
OUTLANDER 850,2020-11-23,4,1,OK,US,5,1413
OUTLANDER 450,2020-11-23,12,2,OK,US,14,1505
OUTLANDER 1000,2020-11-30,8,14,OK,US,22,1430
OUTLANDER 850,2020-11-30,1,7,OK,US,8,1421
OUTLANDER 450,2020-11-30,6,5,OK,US,11,1516
OUTLANDER 1000,2020-12-07,4,5,OK,US,9,1439
OUTLANDER 850,2020-12-07,12,9,OK,US,21,1442
OUTLANDER 450,2020-12-07,12,14,OK,US,26,1542
OUTLANDER 1000,2020-12-14,6,1,OK,US,7,1446
OUTLANDER 850,2020-12-14,5,7,OK,US,12,1454
OUTLANDER 450,2020-12-14,1,9,OK,US,10,1552
OUTLANDER 1000,2020-12-21,11,8,OK,US,19,1465
OUTLANDER 850,2020-12-21,14,9,OK,US,23,1477
OUTLANDER 450,2020-12-21,11,6,OK,US,17,1569
OUTLANDER 1000,2020-12-28,7,5,OK,US,12,1477
OUTLANDER 850,2020-12-28,11,8,OK,US,19,1496
OUTLANDER 450,2020-12-28,1,7,OK,US,8,1577
OUTLANDER 1000,2021-01-04,1,2,OK,US,3,1480
OUTLANDER 850,2021-01-04,13,8,OK,US,21,1517
OUTLANDER 450,2021-01-04,7,12,OK,US,19,1596
OUTLANDER 1000,2021-01-11,6,6,OK,US,12,1492
OUTLANDER 850,2021-01-11,5,6,OK,US,11,1528
OUTLANDER 450,2021-01-11,10,11,OK,US,21,1617
OUTLANDER 1000,2021-01-18,7,2,OK,US,9,1501
OUTLANDER 850,2021-01-18,9,6,OK,US,15,1543
OUTLANDER 450,2021-01-18,11,1,OK,US,12,1629
OUTLANDER 1000,2021-01-25,9,3,OK,US,12,1513
OUTLANDER 850,2021-01-25,6,12,OK,US,18,1561
OUTLANDER 450,2021-01-25,8,1,OK,US,9,1638
OUTLANDER 1000,2021-02-01,4,6,OK,US,10,1523
OUTLANDER 850,2021-02-01,9,5,OK,US,14,1575
OUTLANDER 450,2021-02-01,4,14,OK,US,18,1656
OUTLANDER 1000,2021-02-08,2,14,OK,US,16,1539
OUTLANDER 850,2021-02-08,7,6,OK,US,13,1588
OUTLANDER 450,2021-02-08,13,6,OK,US,19,1675
OUTLANDER 1000,2021-02-15,6,6,OK,US,12,1551
OUTLANDER 850,2021-02-15,0,10,OK,US,10,1598
OUTLANDER 450,2021-02-15,10,12,OK,US,22,1697
OUTLANDER 1000,2021-02-22,1,1,OK,US,2,1553
OUTLANDER 850,2021-02-22,13,6,OK,US,19,1617
OUTLANDER 450,2021-02-22,14,4,OK,US,18,1715
OUTLANDER 1000,2021-03-01,1,3,OK,US,4,1557
OUTLANDER 850,2021-03-01,12,7,OK,US,19,1636
OUTLANDER 450,2021-03-01,6,11,OK,US,17,1732
OUTLANDER 1000,2021-03-08,10,10,OK,US,20,1577
OUTLANDER 850,2021-03-08,1,9,OK,US,10,1646
OUTLANDER 450,2021-03-08,8,11,OK,US,19,1751
OUTLANDER 1000,2021-03-15,13,2,OK,US,15,1592
OUTLANDER 850,2021-03-15,12,10,OK,US,22,1668
OUTLANDER 450,2021-03-15,2,13,OK,US,15,1766
OUTLANDER 1000,2021-03-22,3,12,OK,US,15,1607
OUTLANDER 850,2021-03-22,0,10,OK,US,10,1678
OUTLANDER 450,2021-03-22,6,12,OK,US,18,1784
OUTLANDER 1000,2021-03-29,4,12,OK,US,16,1623
OUTLANDER 850,2021-03-29,12,9,OK,US,21,1699
OUTLANDER 450,2021-03-29,12,11,OK,US,23,1807
OUTLANDER 1000,2021-04-05,2,13,OK,US,15,1638
OUTLANDER 850,2021-04-05,2,10,OK,US,12,1711
OUTLANDER 450,2021-04-05,15,12,OK,US,27,1834
OUTLANDER 1000,2021-04-12,3,8,OK,US,11,1649
OUTLANDER 850,2021-04-12,13,8,OK,US,21,1732
OUTLANDER 450,2021-04-12,10,6,OK,US,16,1850
OUTLANDER 1000,2021-04-19,11,11,OK,US,22,1671
OUTLANDER 850,2021-04-19,12,3,OK,US,15,1747
OUTLANDER 450,2021-04-19,6,4,OK,US,10,1860
OUTLANDER 1000,2021-04-26,8,11,OK,US,19,1690
OUTLANDER 850,2021-04-26,15,11,OK,US,26,1773
OUTLANDER 450,2021-04-26,4,9,OK,US,13,1873
OUTLANDER 1000,2021-05-03,12,6,OK,US,18,1708
OUTLANDER 850,2021-05-03,9,7,OK,US,16,1789
OUTLANDER 450,2021-05-03,12,2,OK,US,14,1887
OUTLANDER 1000,2021-05-10,1,6,OK,US,7,1715
OUTLANDER 850,2021-05-10,2,9,OK,US,11,1800
OUTLANDER 450,2021-05-10,10,8,OK,US,18,1905
OUTLANDER 1000,2021-05-17,4,0,OK,US,4,1719
OUTLANDER 850,2021-05-17,11,7,OK,US,18,1818
OUTLANDER 450,2021-05-17,3,11,OK,US,14,1919
OUTLANDER 1000,2021-05-24,6,15,OK,US,21,1740
OUTLANDER 850,2021-05-24,2,1,OK,US,3,1821
OUTLANDER 450,2021-05-24,4,12,OK,US,16,1935
OUTLANDER 1000,2021-05-31,7,4,OK,US,11,1751
OUTLANDER 850,2021-05-31,2,5,OK,US,7,1828
OUTLANDER 450,2021-05-31,0,12,OK,US,12,1947
OUTLANDER 1000,2021-06-07,13,11,OK,US,24,1775
OUTLANDER 850,2021-06-07,9,11,OK,US,20,1848
OUTLANDER 450,2021-06-07,13,5,OK,US,18,1965
OUTLANDER 1000,2021-06-14,5,2,OK,US,7,1782
OUTLANDER 850,2021-06-14,10,8,OK,US,18,1866
OUTLANDER 450,2021-06-14,12,8,OK,US,20,1985
OUTLANDER 1000,2021-06-21,6,3,OK,US,9,1791
OUTLANDER 850,2021-06-21,7,9,OK,US,16,1882
OUTLANDER 450,2021-06-21,10,12,OK,US,22,2007
OUTLANDER 1000,2021-06-28,6,5,OK,US,11,1802
OUTLANDER 850,2021-06-28,12,3,OK,US,15,1897
OUTLANDER 450,2021-06-28,12,6,OK,US,18,2025
OUTLANDER 1000,2021-07-05,9,8,OK,US,17,1819
OUTLANDER 850,2021-07-05,11,12,OK,US,23,1920
OUTLANDER 450,2021-07-05,9,3,OK,US,12,2037
OUTLANDER 1000,2021-07-12,13,5,OK,US,18,1837
OUTLANDER 850,2021-07-12,5,15,OK,US,20,1940
OUTLANDER 450,2021-07-12,11,1,OK,US,12,2049
OUTLANDER 1000,2021-07-19,15,4,OK,US,19,1856
OUTLANDER 850,2021-07-19,5,2,OK,US,7,1947
OUTLANDER 450,2021-07-19,7,7,OK,US,14,2063
OUTLANDER 1000,2021-07-26,4,14,OK,US,18,1874
OUTLANDER 850,2021-07-26,15,14,OK,US,29,1976
OUTLANDER 450,2021-07-26,0,14,OK,US,14,2077
OUTLANDER 1000,2021-08-02,3,13,OK,US,16,1890
OUTLANDER 850,2021-08-02,8,13,OK,US,21,1997
OUTLANDER 450,2021-08-02,2,5,OK,US,7,2084
OUTLANDER 1000,2021-08-09,10,11,OK,US,21,1911
OUTLANDER 850,2021-08-09,12,1,OK,US,13,2010
OUTLANDER 450,2021-08-09,0,7,OK,US,7,2091
OUTLANDER 1000,2021-08-16,2,11,OK,US,13,1924
OUTLANDER 850,2021-08-16,9,15,OK,US,24,2034
OUTLANDER 450,2021-08-16,14,6,OK,US,20,2111
OUTLANDER 1000,2021-08-23,4,0,OK,US,4,1928
OUTLANDER 850,2021-08-23,10,12,OK,US,22,2056
OUTLANDER 450,2021-08-23,14,10,OK,US,24,2135
OUTLANDER 1000,2021-08-30,7,13,OK,US,20,1948
OUTLANDER 850,2021-08-30,6,4,OK,US,10,2066
OUTLANDER 450,2021-08-30,8,1,OK,US,9,2144
OUTLANDER 1000,2021-09-06,4,10,OK,US,14,1962
OUTLANDER 850,2021-09-06,3,1,OK,US,4,2070
OUTLANDER 450,2021-09-06,0,1,OK,US,1,2145
OUTLANDER 1000,2021-09-13,8,2,OK,US,10,1972
OUTLANDER 850,2021-09-13,7,10,OK,US,17,2087
OUTLANDER 450,2021-09-13,10,0,OK,US,10,2155
OUTLANDER 1000,2021-09-20,5,13,OK,US,18,1990
OUTLANDER 850,2021-09-20,15,9,OK,US,24,2111
OUTLANDER 450,2021-09-20,13,9,OK,US,22,2177
OUTLANDER 1000,2021-09-27,6,8,OK,US,14,2004
OUTLANDER 850,2021-09-27,12,7,OK,US,19,2130
OUTLANDER 450,2021-09-27,2,1,OK,US,3,2180
OUTLANDER 1000,2021-10-04,12,13,OK,US,25,2029
OUTLANDER 850,2021-10-04,2,9,OK,US,11,2141
OUTLANDER 450,2021-10-04,7,5,OK,US,12,2192
OUTLANDER 1000,2021-10-11,11,10,OK,US,21,2050
OUTLANDER 850,2021-10-11,8,3,OK,US,11,2152
OUTLANDER 450,2021-10-11,11,0,OK,US,11,2203
OUTLANDER 1000,2021-10-18,6,6,OK,US,12,2062
OUTLANDER 850,2021-10-18,11,11,OK,US,22,2174
OUTLANDER 450,2021-10-18,6,10,OK,US,16,2219
OUTLANDER 1000,2021-10-25,5,0,OK,US,5,2067
OUTLANDER 850,2021-10-25,7,12,OK,US,19,2193
OUTLANDER 450,2021-10-25,11,14,OK,US,25,2244
OUTLANDER 1000,2021-11-01,15,5,OK,US,20,2087
OUTLANDER 850,2021-11-01,7,1,OK,US,8,2201
OUTLANDER 450,2021-11-01,5,2,OK,US,7,2251
OUTLANDER 1000,2021-11-08,14,9,OK,US,23,2110
OUTLANDER 850,2021-11-08,4,5,OK,US,9,2210
OUTLANDER 450,2021-11-08,14,12,OK,US,26,2277
OUTLANDER 1000,2021-11-15,14,13,OK,US,27,2137
OUTLANDER 850,2021-11-15,11,5,OK,US,16,2226
OUTLANDER 450,2021-11-15,6,4,OK,US,10,2287
OUTLANDER 1000,2021-11-22,2,14,OK,US,16,2153
OUTLANDER 850,2021-11-22,7,12,OK,US,19,2245
OUTLANDER 450,2021-11-22,11,2,OK,US,13,2300
OUTLANDER 1000,2021-11-29,9,5,OK,US,14,2167
OUTLANDER 850,2021-11-29,4,10,OK,US,14,2259
OUTLANDER 450,2021-11-29,8,1,OK,US,9,2309
OUTLANDER 1000,2021-12-06,4,1,OK,US,5,2172
OUTLANDER 850,2021-12-06,12,4,OK,US,16,2275
OUTLANDER 450,2021-12-06,0,6,OK,US,6,2315
OUTLANDER 1000,2021-12-13,8,12,OK,US,20,2192
OUTLANDER 850,2021-12-13,6,13,OK,US,19,2294
OUTLANDER 450,2021-12-13,3,13,OK,US,16,2331
OUTLANDER 1000,2021-12-20,0,12,OK,US,12,2204
OUTLANDER 850,2021-12-20,1,1,OK,US,2,2296
OUTLANDER 450,2021-12-20,6,9,OK,US,15,2346
OUTLANDER 1000,2021-12-27,13,12,OK,US,25,2229
OUTLANDER 850,2021-12-27,6,5,OK,US,11,2307
OUTLANDER 450,2021-12-27,10,6,OK,US,16,2362
OUTLANDER 1000,2019-01-07,1,4,OR,US,5,5
OUTLANDER 850,2019-01-07,11,9,OR,US,20,20
OUTLANDER 450,2019-01-07,13,5,OR,US,18,18
OUTLANDER 1000,2019-01-14,12,2,OR,US,14,19
OUTLANDER 850,2019-01-14,1,11,OR,US,12,32
OUTLANDER 450,2019-01-14,2,9,OR,US,11,29
OUTLANDER 1000,2019-01-21,5,12,OR,US,17,36
OUTLANDER 850,2019-01-21,3,13,OR,US,16,48
OUTLANDER 450,2019-01-21,3,11,OR,US,14,43
OUTLANDER 1000,2019-01-28,6,5,OR,US,11,47
OUTLANDER 850,2019-01-28,6,14,OR,US,20,68
OUTLANDER 450,2019-01-28,5,8,OR,US,13,56
OUTLANDER 1000,2019-02-04,13,7,OR,US,20,67
OUTLANDER 850,2019-02-04,10,6,OR,US,16,84
OUTLANDER 450,2019-02-04,11,15,OR,US,26,82
OUTLANDER 1000,2019-02-11,14,11,OR,US,25,92
OUTLANDER 850,2019-02-11,4,14,OR,US,18,102
OUTLANDER 450,2019-02-11,12,6,OR,US,18,100
OUTLANDER 1000,2019-02-18,13,5,OR,US,18,110
OUTLANDER 850,2019-02-18,10,13,OR,US,23,125
OUTLANDER 450,2019-02-18,2,10,OR,US,12,112
OUTLANDER 1000,2019-02-25,11,3,OR,US,14,124
OUTLANDER 850,2019-02-25,4,1,OR,US,5,130
OUTLANDER 450,2019-02-25,8,3,OR,US,11,123
OUTLANDER 1000,2019-03-04,5,13,OR,US,18,142
OUTLANDER 850,2019-03-04,11,5,OR,US,16,146
OUTLANDER 450,2019-03-04,13,1,OR,US,14,137
OUTLANDER 1000,2019-03-11,10,4,OR,US,14,156
OUTLANDER 850,2019-03-11,3,0,OR,US,3,149
OUTLANDER 450,2019-03-11,15,2,OR,US,17,154
OUTLANDER 1000,2019-03-18,3,1,OR,US,4,160
OUTLANDER 850,2019-03-18,0,15,OR,US,15,164
OUTLANDER 450,2019-03-18,9,3,OR,US,12,166
OUTLANDER 1000,2019-03-25,3,5,OR,US,8,168
OUTLANDER 850,2019-03-25,8,11,OR,US,19,183
OUTLANDER 450,2019-03-25,0,4,OR,US,4,170
OUTLANDER 1000,2019-04-01,15,7,OR,US,22,190
OUTLANDER 850,2019-04-01,5,6,OR,US,11,194
OUTLANDER 450,2019-04-01,1,6,OR,US,7,177
OUTLANDER 1000,2019-04-08,1,1,OR,US,2,192
OUTLANDER 850,2019-04-08,1,6,OR,US,7,201
OUTLANDER 450,2019-04-08,9,14,OR,US,23,200
OUTLANDER 1000,2019-04-15,9,6,OR,US,15,207
OUTLANDER 850,2019-04-15,0,8,OR,US,8,209
OUTLANDER 450,2019-04-15,12,4,OR,US,16,216
OUTLANDER 1000,2019-04-22,7,4,OR,US,11,218
OUTLANDER 850,2019-04-22,8,10,OR,US,18,227
OUTLANDER 450,2019-04-22,5,6,OR,US,11,227
OUTLANDER 1000,2019-04-29,8,2,OR,US,10,228
OUTLANDER 850,2019-04-29,4,4,OR,US,8,235
OUTLANDER 450,2019-04-29,5,12,OR,US,17,244
OUTLANDER 1000,2019-05-06,8,5,OR,US,13,241
OUTLANDER 850,2019-05-06,10,2,OR,US,12,247
OUTLANDER 450,2019-05-06,13,3,OR,US,16,260
OUTLANDER 1000,2019-05-13,11,10,OR,US,21,262
OUTLANDER 850,2019-05-13,10,4,OR,US,14,261
OUTLANDER 450,2019-05-13,12,5,OR,US,17,277
OUTLANDER 1000,2019-05-20,11,5,OR,US,16,278
OUTLANDER 850,2019-05-20,9,2,OR,US,11,272
OUTLANDER 450,2019-05-20,6,1,OR,US,7,284
OUTLANDER 1000,2019-05-27,14,11,OR,US,25,303
OUTLANDER 850,2019-05-27,5,2,OR,US,7,279
OUTLANDER 450,2019-05-27,9,4,OR,US,13,297
OUTLANDER 1000,2019-06-03,7,9,OR,US,16,319
OUTLANDER 850,2019-06-03,6,7,OR,US,13,292
OUTLANDER 450,2019-06-03,2,5,OR,US,7,304
OUTLANDER 1000,2019-06-10,10,2,OR,US,12,331
OUTLANDER 850,2019-06-10,2,4,OR,US,6,298
OUTLANDER 450,2019-06-10,3,13,OR,US,16,320
OUTLANDER 1000,2019-06-17,0,1,OR,US,1,332
OUTLANDER 850,2019-06-17,5,13,OR,US,18,316
OUTLANDER 450,2019-06-17,13,1,OR,US,14,334
OUTLANDER 1000,2019-06-24,8,2,OR,US,10,342
OUTLANDER 850,2019-06-24,7,2,OR,US,9,325
OUTLANDER 450,2019-06-24,5,10,OR,US,15,349
OUTLANDER 1000,2019-07-01,5,15,OR,US,20,362
OUTLANDER 850,2019-07-01,4,10,OR,US,14,339
OUTLANDER 450,2019-07-01,14,9,OR,US,23,372
OUTLANDER 1000,2019-07-08,15,8,OR,US,23,385
OUTLANDER 850,2019-07-08,2,2,OR,US,4,343
OUTLANDER 450,2019-07-08,10,11,OR,US,21,393
OUTLANDER 1000,2019-07-15,15,13,OR,US,28,413
OUTLANDER 850,2019-07-15,13,5,OR,US,18,361
OUTLANDER 450,2019-07-15,12,13,OR,US,25,418
OUTLANDER 1000,2019-07-22,13,11,OR,US,24,437
OUTLANDER 850,2019-07-22,4,2,OR,US,6,367
OUTLANDER 450,2019-07-22,10,5,OR,US,15,433
OUTLANDER 1000,2019-07-29,0,12,OR,US,12,449
OUTLANDER 850,2019-07-29,13,1,OR,US,14,381
OUTLANDER 450,2019-07-29,15,15,OR,US,30,463
OUTLANDER 1000,2019-08-05,1,2,OR,US,3,452
OUTLANDER 850,2019-08-05,10,14,OR,US,24,405
OUTLANDER 450,2019-08-05,5,12,OR,US,17,480
OUTLANDER 1000,2019-08-12,7,13,OR,US,20,472
OUTLANDER 850,2019-08-12,15,8,OR,US,23,428
OUTLANDER 450,2019-08-12,5,3,OR,US,8,488
OUTLANDER 1000,2019-08-19,4,14,OR,US,18,490
OUTLANDER 850,2019-08-19,15,5,OR,US,20,448
OUTLANDER 450,2019-08-19,4,3,OR,US,7,495
OUTLANDER 1000,2019-08-26,7,12,OR,US,19,509
OUTLANDER 850,2019-08-26,4,8,OR,US,12,460
OUTLANDER 450,2019-08-26,10,2,OR,US,12,507
OUTLANDER 1000,2019-09-02,5,2,OR,US,7,516
OUTLANDER 850,2019-09-02,1,6,OR,US,7,467
OUTLANDER 450,2019-09-02,12,10,OR,US,22,529
OUTLANDER 1000,2019-09-09,6,2,OR,US,8,524
OUTLANDER 850,2019-09-09,3,1,OR,US,4,471
OUTLANDER 450,2019-09-09,2,1,OR,US,3,532
OUTLANDER 1000,2019-09-16,8,0,OR,US,8,532
OUTLANDER 850,2019-09-16,10,7,OR,US,17,488
OUTLANDER 450,2019-09-16,3,14,OR,US,17,549
OUTLANDER 1000,2019-09-23,14,8,OR,US,22,554
OUTLANDER 850,2019-09-23,6,3,OR,US,9,497
OUTLANDER 450,2019-09-23,6,2,OR,US,8,557
OUTLANDER 1000,2019-09-30,6,14,OR,US,20,574
OUTLANDER 850,2019-09-30,14,11,OR,US,25,522
OUTLANDER 450,2019-09-30,8,6,OR,US,14,571
OUTLANDER 1000,2019-10-07,15,5,OR,US,20,594
OUTLANDER 850,2019-10-07,9,14,OR,US,23,545
OUTLANDER 450,2019-10-07,2,14,OR,US,16,587
OUTLANDER 1000,2019-10-14,11,15,OR,US,26,620
OUTLANDER 850,2019-10-14,8,5,OR,US,13,558
OUTLANDER 450,2019-10-14,12,1,OR,US,13,600
OUTLANDER 1000,2019-10-21,10,12,OR,US,22,642
OUTLANDER 850,2019-10-21,10,11,OR,US,21,579
OUTLANDER 450,2019-10-21,2,11,OR,US,13,613
OUTLANDER 1000,2019-10-28,8,6,OR,US,14,656
OUTLANDER 850,2019-10-28,4,11,OR,US,15,594
OUTLANDER 450,2019-10-28,3,5,OR,US,8,621
OUTLANDER 1000,2019-11-04,10,6,OR,US,16,672
OUTLANDER 850,2019-11-04,7,12,OR,US,19,613
OUTLANDER 450,2019-11-04,9,3,OR,US,12,633
OUTLANDER 1000,2019-11-11,2,10,OR,US,12,684
OUTLANDER 850,2019-11-11,13,2,OR,US,15,628
OUTLANDER 450,2019-11-11,14,11,OR,US,25,658
OUTLANDER 1000,2019-11-18,0,9,OR,US,9,693
OUTLANDER 850,2019-11-18,3,4,OR,US,7,635
OUTLANDER 450,2019-11-18,6,3,OR,US,9,667
OUTLANDER 1000,2019-11-25,12,5,OR,US,17,710
OUTLANDER 850,2019-11-25,8,6,OR,US,14,649
OUTLANDER 450,2019-11-25,4,4,OR,US,8,675
OUTLANDER 1000,2019-12-02,13,0,OR,US,13,723
OUTLANDER 850,2019-12-02,1,0,OR,US,1,650
OUTLANDER 450,2019-12-02,2,6,OR,US,8,683
OUTLANDER 1000,2019-12-09,6,14,OR,US,20,743
OUTLANDER 850,2019-12-09,5,8,OR,US,13,663
OUTLANDER 450,2019-12-09,9,7,OR,US,16,699
OUTLANDER 1000,2019-12-16,1,8,OR,US,9,752
OUTLANDER 850,2019-12-16,7,4,OR,US,11,674
OUTLANDER 450,2019-12-16,2,5,OR,US,7,706
OUTLANDER 1000,2019-12-23,12,3,OR,US,15,767
OUTLANDER 850,2019-12-23,5,7,OR,US,12,686
OUTLANDER 450,2019-12-23,4,9,OR,US,13,719
OUTLANDER 1000,2019-12-30,15,2,OR,US,17,784
OUTLANDER 850,2019-12-30,9,5,OR,US,14,700
OUTLANDER 450,2019-12-30,3,11,OR,US,14,733
OUTLANDER 1000,2020-01-06,8,7,OR,US,15,799
OUTLANDER 850,2020-01-06,5,9,OR,US,14,714
OUTLANDER 450,2020-01-06,12,9,OR,US,21,754
OUTLANDER 1000,2020-01-13,14,1,OR,US,15,814
OUTLANDER 850,2020-01-13,13,8,OR,US,21,735
OUTLANDER 450,2020-01-13,9,10,OR,US,19,773
OUTLANDER 1000,2020-01-20,9,11,OR,US,20,834
OUTLANDER 850,2020-01-20,1,13,OR,US,14,749
OUTLANDER 450,2020-01-20,12,9,OR,US,21,794
OUTLANDER 1000,2020-01-27,3,3,OR,US,6,840
OUTLANDER 850,2020-01-27,12,7,OR,US,19,768
OUTLANDER 450,2020-01-27,7,8,OR,US,15,809
OUTLANDER 1000,2020-02-03,9,9,OR,US,18,858
OUTLANDER 850,2020-02-03,2,6,OR,US,8,776
OUTLANDER 450,2020-02-03,3,14,OR,US,17,826
OUTLANDER 1000,2020-02-10,10,7,OR,US,17,875
OUTLANDER 850,2020-02-10,12,7,OR,US,19,795
OUTLANDER 450,2020-02-10,9,2,OR,US,11,837
OUTLANDER 1000,2020-02-17,8,11,OR,US,19,894
OUTLANDER 850,2020-02-17,3,4,OR,US,7,802
OUTLANDER 450,2020-02-17,0,1,OR,US,1,838
OUTLANDER 1000,2020-02-24,3,0,OR,US,3,897
OUTLANDER 850,2020-02-24,5,6,OR,US,11,813
OUTLANDER 450,2020-02-24,2,1,OR,US,3,841
OUTLANDER 1000,2020-03-02,13,15,OR,US,28,925
OUTLANDER 850,2020-03-02,3,5,OR,US,8,821
OUTLANDER 450,2020-03-02,2,13,OR,US,15,856
OUTLANDER 1000,2020-03-09,8,5,OR,US,13,938
OUTLANDER 850,2020-03-09,13,10,OR,US,23,844
OUTLANDER 450,2020-03-09,14,12,OR,US,26,882
OUTLANDER 1000,2020-03-16,2,3,OR,US,5,943
OUTLANDER 850,2020-03-16,7,6,OR,US,13,857
OUTLANDER 450,2020-03-16,7,10,OR,US,17,899
OUTLANDER 1000,2020-03-23,12,3,OR,US,15,958
OUTLANDER 850,2020-03-23,1,9,OR,US,10,867
OUTLANDER 450,2020-03-23,4,4,OR,US,8,907
OUTLANDER 1000,2020-03-30,11,12,OR,US,23,981
OUTLANDER 850,2020-03-30,6,10,OR,US,16,883
OUTLANDER 450,2020-03-30,1,13,OR,US,14,921
OUTLANDER 1000,2020-04-06,5,3,OR,US,8,989
OUTLANDER 850,2020-04-06,5,13,OR,US,18,901
OUTLANDER 450,2020-04-06,8,4,OR,US,12,933
OUTLANDER 1000,2020-04-13,0,14,OR,US,14,1003
OUTLANDER 850,2020-04-13,1,1,OR,US,2,903
OUTLANDER 450,2020-04-13,12,1,OR,US,13,946
OUTLANDER 1000,2020-04-20,12,7,OR,US,19,1022
OUTLANDER 850,2020-04-20,13,12,OR,US,25,928
OUTLANDER 450,2020-04-20,14,9,OR,US,23,969
OUTLANDER 1000,2020-04-27,2,6,OR,US,8,1030
OUTLANDER 850,2020-04-27,10,3,OR,US,13,941
OUTLANDER 450,2020-04-27,1,14,OR,US,15,984
OUTLANDER 1000,2020-05-04,2,12,OR,US,14,1044
OUTLANDER 850,2020-05-04,4,15,OR,US,19,960
OUTLANDER 450,2020-05-04,2,12,OR,US,14,998
OUTLANDER 1000,2020-05-11,13,10,OR,US,23,1067
OUTLANDER 850,2020-05-11,1,5,OR,US,6,966
OUTLANDER 450,2020-05-11,15,7,OR,US,22,1020
OUTLANDER 1000,2020-05-18,10,3,OR,US,13,1080
OUTLANDER 850,2020-05-18,7,8,OR,US,15,981
OUTLANDER 450,2020-05-18,10,3,OR,US,13,1033
OUTLANDER 1000,2020-05-25,5,5,OR,US,10,1090
OUTLANDER 850,2020-05-25,1,5,OR,US,6,987
OUTLANDER 450,2020-05-25,12,14,OR,US,26,1059
OUTLANDER 1000,2020-06-01,13,7,OR,US,20,1110
OUTLANDER 850,2020-06-01,12,10,OR,US,22,1009
OUTLANDER 450,2020-06-01,8,10,OR,US,18,1077
OUTLANDER 1000,2020-06-08,7,7,OR,US,14,1124
OUTLANDER 850,2020-06-08,8,7,OR,US,15,1024
OUTLANDER 450,2020-06-08,8,13,OR,US,21,1098
OUTLANDER 1000,2020-06-15,2,12,OR,US,14,1138
OUTLANDER 850,2020-06-15,7,13,OR,US,20,1044
OUTLANDER 450,2020-06-15,1,5,OR,US,6,1104
OUTLANDER 1000,2020-06-22,11,2,OR,US,13,1151
OUTLANDER 850,2020-06-22,1,4,OR,US,5,1049
OUTLANDER 450,2020-06-22,3,7,OR,US,10,1114
OUTLANDER 1000,2020-06-29,5,11,OR,US,16,1167
OUTLANDER 850,2020-06-29,7,13,OR,US,20,1069
OUTLANDER 450,2020-06-29,14,4,OR,US,18,1132
OUTLANDER 1000,2020-07-06,13,2,OR,US,15,1182
OUTLANDER 850,2020-07-06,7,0,OR,US,7,1076
OUTLANDER 450,2020-07-06,11,12,OR,US,23,1155
OUTLANDER 1000,2020-07-13,14,4,OR,US,18,1200
OUTLANDER 850,2020-07-13,9,3,OR,US,12,1088
OUTLANDER 450,2020-07-13,8,2,OR,US,10,1165
OUTLANDER 1000,2020-07-20,1,5,OR,US,6,1206
OUTLANDER 850,2020-07-20,2,9,OR,US,11,1099
OUTLANDER 450,2020-07-20,15,1,OR,US,16,1181
OUTLANDER 1000,2020-07-27,2,11,OR,US,13,1219
OUTLANDER 850,2020-07-27,13,11,OR,US,24,1123
OUTLANDER 450,2020-07-27,5,6,OR,US,11,1192
OUTLANDER 1000,2020-08-03,10,9,OR,US,19,1238
OUTLANDER 850,2020-08-03,2,11,OR,US,13,1136
OUTLANDER 450,2020-08-03,7,1,OR,US,8,1200
OUTLANDER 1000,2020-08-10,10,12,OR,US,22,1260
OUTLANDER 850,2020-08-10,8,9,OR,US,17,1153
OUTLANDER 450,2020-08-10,8,4,OR,US,12,1212
OUTLANDER 1000,2020-08-17,6,4,OR,US,10,1270
OUTLANDER 850,2020-08-17,1,9,OR,US,10,1163
OUTLANDER 450,2020-08-17,3,10,OR,US,13,1225
OUTLANDER 1000,2020-08-24,6,12,OR,US,18,1288
OUTLANDER 850,2020-08-24,6,11,OR,US,17,1180
OUTLANDER 450,2020-08-24,2,8,OR,US,10,1235
OUTLANDER 1000,2020-08-31,7,12,OR,US,19,1307
OUTLANDER 850,2020-08-31,8,4,OR,US,12,1192
OUTLANDER 450,2020-08-31,12,1,OR,US,13,1248
OUTLANDER 1000,2020-09-07,5,9,OR,US,14,1321
OUTLANDER 850,2020-09-07,11,12,OR,US,23,1215
OUTLANDER 450,2020-09-07,4,11,OR,US,15,1263
OUTLANDER 1000,2020-09-14,2,5,OR,US,7,1328
OUTLANDER 850,2020-09-14,13,11,OR,US,24,1239
OUTLANDER 450,2020-09-14,11,10,OR,US,21,1284
OUTLANDER 1000,2020-09-21,12,5,OR,US,17,1345
OUTLANDER 850,2020-09-21,7,1,OR,US,8,1247
OUTLANDER 450,2020-09-21,7,11,OR,US,18,1302
OUTLANDER 1000,2020-09-28,5,4,OR,US,9,1354
OUTLANDER 850,2020-09-28,15,8,OR,US,23,1270
OUTLANDER 450,2020-09-28,1,1,OR,US,2,1304
OUTLANDER 1000,2020-10-05,6,9,OR,US,15,1369
OUTLANDER 850,2020-10-05,13,11,OR,US,24,1294
OUTLANDER 450,2020-10-05,3,3,OR,US,6,1310
OUTLANDER 1000,2020-10-12,8,11,OR,US,19,1388
OUTLANDER 850,2020-10-12,2,8,OR,US,10,1304
OUTLANDER 450,2020-10-12,9,14,OR,US,23,1333
OUTLANDER 1000,2020-10-19,14,6,OR,US,20,1408
OUTLANDER 850,2020-10-19,5,11,OR,US,16,1320
OUTLANDER 450,2020-10-19,6,4,OR,US,10,1343
OUTLANDER 1000,2020-10-26,12,13,OR,US,25,1433
OUTLANDER 850,2020-10-26,13,7,OR,US,20,1340
OUTLANDER 450,2020-10-26,2,14,OR,US,16,1359
OUTLANDER 1000,2020-11-02,4,14,OR,US,18,1451
OUTLANDER 850,2020-11-02,12,10,OR,US,22,1362
OUTLANDER 450,2020-11-02,1,13,OR,US,14,1373
OUTLANDER 1000,2020-11-09,8,11,OR,US,19,1470
OUTLANDER 850,2020-11-09,9,4,OR,US,13,1375
OUTLANDER 450,2020-11-09,0,15,OR,US,15,1388
OUTLANDER 1000,2020-11-16,0,13,OR,US,13,1483
OUTLANDER 850,2020-11-16,2,8,OR,US,10,1385
OUTLANDER 450,2020-11-16,11,5,OR,US,16,1404
OUTLANDER 1000,2020-11-23,8,3,OR,US,11,1494
OUTLANDER 850,2020-11-23,3,5,OR,US,8,1393
OUTLANDER 450,2020-11-23,7,2,OR,US,9,1413
OUTLANDER 1000,2020-11-30,1,2,OR,US,3,1497
OUTLANDER 850,2020-11-30,5,2,OR,US,7,1400
OUTLANDER 450,2020-11-30,10,6,OR,US,16,1429
OUTLANDER 1000,2020-12-07,13,13,OR,US,26,1523
OUTLANDER 850,2020-12-07,9,14,OR,US,23,1423
OUTLANDER 450,2020-12-07,1,7,OR,US,8,1437
OUTLANDER 1000,2020-12-14,1,10,OR,US,11,1534
OUTLANDER 850,2020-12-14,7,8,OR,US,15,1438
OUTLANDER 450,2020-12-14,6,7,OR,US,13,1450
OUTLANDER 1000,2020-12-21,9,1,OR,US,10,1544
OUTLANDER 850,2020-12-21,13,3,OR,US,16,1454
OUTLANDER 450,2020-12-21,3,7,OR,US,10,1460
OUTLANDER 1000,2020-12-28,5,5,OR,US,10,1554
OUTLANDER 850,2020-12-28,8,2,OR,US,10,1464
OUTLANDER 450,2020-12-28,9,2,OR,US,11,1471
OUTLANDER 1000,2021-01-04,2,5,OR,US,7,1561
OUTLANDER 850,2021-01-04,15,6,OR,US,21,1485
OUTLANDER 450,2021-01-04,3,12,OR,US,15,1486
OUTLANDER 1000,2021-01-11,7,3,OR,US,10,1571
OUTLANDER 850,2021-01-11,11,12,OR,US,23,1508
OUTLANDER 450,2021-01-11,9,3,OR,US,12,1498
OUTLANDER 1000,2021-01-18,2,14,OR,US,16,1587
OUTLANDER 850,2021-01-18,4,0,OR,US,4,1512
OUTLANDER 450,2021-01-18,15,4,OR,US,19,1517
OUTLANDER 1000,2021-01-25,0,1,OR,US,1,1588
OUTLANDER 850,2021-01-25,11,9,OR,US,20,1532
OUTLANDER 450,2021-01-25,9,7,OR,US,16,1533
OUTLANDER 1000,2021-02-01,10,4,OR,US,14,1602
OUTLANDER 850,2021-02-01,10,14,OR,US,24,1556
OUTLANDER 450,2021-02-01,4,1,OR,US,5,1538
OUTLANDER 1000,2021-02-08,5,14,OR,US,19,1621
OUTLANDER 850,2021-02-08,13,15,OR,US,28,1584
OUTLANDER 450,2021-02-08,8,1,OR,US,9,1547
OUTLANDER 1000,2021-02-15,10,6,OR,US,16,1637
OUTLANDER 850,2021-02-15,12,13,OR,US,25,1609
OUTLANDER 450,2021-02-15,2,3,OR,US,5,1552
OUTLANDER 1000,2021-02-22,6,11,OR,US,17,1654
OUTLANDER 850,2021-02-22,14,11,OR,US,25,1634
OUTLANDER 450,2021-02-22,1,7,OR,US,8,1560
OUTLANDER 1000,2021-03-01,3,1,OR,US,4,1658
OUTLANDER 850,2021-03-01,14,12,OR,US,26,1660
OUTLANDER 450,2021-03-01,9,12,OR,US,21,1581
OUTLANDER 1000,2021-03-08,12,12,OR,US,24,1682
OUTLANDER 850,2021-03-08,11,6,OR,US,17,1677
OUTLANDER 450,2021-03-08,8,14,OR,US,22,1603
OUTLANDER 1000,2021-03-15,10,2,OR,US,12,1694
OUTLANDER 850,2021-03-15,8,5,OR,US,13,1690
OUTLANDER 450,2021-03-15,13,14,OR,US,27,1630
OUTLANDER 1000,2021-03-22,3,13,OR,US,16,1710
OUTLANDER 850,2021-03-22,2,4,OR,US,6,1696
OUTLANDER 450,2021-03-22,0,7,OR,US,7,1637
OUTLANDER 1000,2021-03-29,3,14,OR,US,17,1727
OUTLANDER 850,2021-03-29,12,2,OR,US,14,1710
OUTLANDER 450,2021-03-29,10,10,OR,US,20,1657
OUTLANDER 1000,2021-04-05,14,2,OR,US,16,1743
OUTLANDER 850,2021-04-05,12,11,OR,US,23,1733
OUTLANDER 450,2021-04-05,3,2,OR,US,5,1662
OUTLANDER 1000,2021-04-12,9,15,OR,US,24,1767
OUTLANDER 850,2021-04-12,5,8,OR,US,13,1746
OUTLANDER 450,2021-04-12,6,1,OR,US,7,1669
OUTLANDER 1000,2021-04-19,15,5,OR,US,20,1787
OUTLANDER 850,2021-04-19,13,13,OR,US,26,1772
OUTLANDER 450,2021-04-19,5,11,OR,US,16,1685
OUTLANDER 1000,2021-04-26,8,3,OR,US,11,1798
OUTLANDER 850,2021-04-26,15,1,OR,US,16,1788
OUTLANDER 450,2021-04-26,15,13,OR,US,28,1713
OUTLANDER 1000,2021-05-03,11,10,OR,US,21,1819
OUTLANDER 850,2021-05-03,10,4,OR,US,14,1802
OUTLANDER 450,2021-05-03,14,15,OR,US,29,1742
OUTLANDER 1000,2021-05-10,5,3,OR,US,8,1827
OUTLANDER 850,2021-05-10,1,10,OR,US,11,1813
OUTLANDER 450,2021-05-10,4,11,OR,US,15,1757
OUTLANDER 1000,2021-05-17,11,8,OR,US,19,1846
OUTLANDER 850,2021-05-17,13,11,OR,US,24,1837
OUTLANDER 450,2021-05-17,1,12,OR,US,13,1770
OUTLANDER 1000,2021-05-24,9,14,OR,US,23,1869
OUTLANDER 850,2021-05-24,2,7,OR,US,9,1846
OUTLANDER 450,2021-05-24,3,9,OR,US,12,1782
OUTLANDER 1000,2021-05-31,11,12,OR,US,23,1892
OUTLANDER 850,2021-05-31,10,1,OR,US,11,1857
OUTLANDER 450,2021-05-31,6,2,OR,US,8,1790
OUTLANDER 1000,2021-06-07,9,10,OR,US,19,1911
OUTLANDER 850,2021-06-07,13,7,OR,US,20,1877
OUTLANDER 450,2021-06-07,1,5,OR,US,6,1796
OUTLANDER 1000,2021-06-14,15,12,OR,US,27,1938
OUTLANDER 850,2021-06-14,3,2,OR,US,5,1882
OUTLANDER 450,2021-06-14,5,10,OR,US,15,1811
OUTLANDER 1000,2021-06-21,11,14,OR,US,25,1963
OUTLANDER 850,2021-06-21,7,5,OR,US,12,1894
OUTLANDER 450,2021-06-21,1,9,OR,US,10,1821
OUTLANDER 1000,2021-06-28,5,1,OR,US,6,1969
OUTLANDER 850,2021-06-28,11,1,OR,US,12,1906
OUTLANDER 450,2021-06-28,14,11,OR,US,25,1846
OUTLANDER 1000,2021-07-05,2,11,OR,US,13,1982
OUTLANDER 850,2021-07-05,10,13,OR,US,23,1929
OUTLANDER 450,2021-07-05,8,13,OR,US,21,1867
OUTLANDER 1000,2021-07-12,4,2,OR,US,6,1988
OUTLANDER 850,2021-07-12,3,6,OR,US,9,1938
OUTLANDER 450,2021-07-12,1,9,OR,US,10,1877
OUTLANDER 1000,2021-07-19,13,12,OR,US,25,2013
OUTLANDER 850,2021-07-19,0,4,OR,US,4,1942
OUTLANDER 450,2021-07-19,10,9,OR,US,19,1896
OUTLANDER 1000,2021-07-26,13,9,OR,US,22,2035
OUTLANDER 850,2021-07-26,3,5,OR,US,8,1950
OUTLANDER 450,2021-07-26,1,11,OR,US,12,1908
OUTLANDER 1000,2021-08-02,7,7,OR,US,14,2049
OUTLANDER 850,2021-08-02,10,11,OR,US,21,1971
OUTLANDER 450,2021-08-02,2,8,OR,US,10,1918
OUTLANDER 1000,2021-08-09,14,10,OR,US,24,2073
OUTLANDER 850,2021-08-09,6,5,OR,US,11,1982
OUTLANDER 450,2021-08-09,9,14,OR,US,23,1941
OUTLANDER 1000,2021-08-16,4,6,OR,US,10,2083
OUTLANDER 850,2021-08-16,6,8,OR,US,14,1996
OUTLANDER 450,2021-08-16,12,5,OR,US,17,1958
OUTLANDER 1000,2021-08-23,10,10,OR,US,20,2103
OUTLANDER 850,2021-08-23,9,4,OR,US,13,2009
OUTLANDER 450,2021-08-23,2,3,OR,US,5,1963
OUTLANDER 1000,2021-08-30,3,8,OR,US,11,2114
OUTLANDER 850,2021-08-30,11,2,OR,US,13,2022
OUTLANDER 450,2021-08-30,9,1,OR,US,10,1973
OUTLANDER 1000,2021-09-06,8,7,OR,US,15,2129
OUTLANDER 850,2021-09-06,7,12,OR,US,19,2041
OUTLANDER 450,2021-09-06,2,13,OR,US,15,1988
OUTLANDER 1000,2021-09-13,7,2,OR,US,9,2138
OUTLANDER 850,2021-09-13,9,7,OR,US,16,2057
OUTLANDER 450,2021-09-13,15,13,OR,US,28,2016
OUTLANDER 1000,2021-09-20,4,10,OR,US,14,2152
OUTLANDER 850,2021-09-20,13,0,OR,US,13,2070
OUTLANDER 450,2021-09-20,2,12,OR,US,14,2030
OUTLANDER 1000,2021-09-27,2,2,OR,US,4,2156
OUTLANDER 850,2021-09-27,3,2,OR,US,5,2075
OUTLANDER 450,2021-09-27,13,7,OR,US,20,2050
OUTLANDER 1000,2021-10-04,5,5,OR,US,10,2166
OUTLANDER 850,2021-10-04,4,9,OR,US,13,2088
OUTLANDER 450,2021-10-04,1,6,OR,US,7,2057
OUTLANDER 1000,2021-10-11,12,13,OR,US,25,2191
OUTLANDER 850,2021-10-11,2,3,OR,US,5,2093
OUTLANDER 450,2021-10-11,11,7,OR,US,18,2075
OUTLANDER 1000,2021-10-18,1,10,OR,US,11,2202
OUTLANDER 850,2021-10-18,2,12,OR,US,14,2107
OUTLANDER 450,2021-10-18,2,3,OR,US,5,2080
OUTLANDER 1000,2021-10-25,13,14,OR,US,27,2229
OUTLANDER 850,2021-10-25,13,6,OR,US,19,2126
OUTLANDER 450,2021-10-25,13,12,OR,US,25,2105
OUTLANDER 1000,2021-11-01,0,1,OR,US,1,2230
OUTLANDER 850,2021-11-01,5,3,OR,US,8,2134
OUTLANDER 450,2021-11-01,10,9,OR,US,19,2124
OUTLANDER 1000,2021-11-08,9,2,OR,US,11,2241
OUTLANDER 850,2021-11-08,13,13,OR,US,26,2160
OUTLANDER 450,2021-11-08,2,6,OR,US,8,2132
OUTLANDER 1000,2021-11-15,12,3,OR,US,15,2256
OUTLANDER 850,2021-11-15,2,11,OR,US,13,2173
OUTLANDER 450,2021-11-15,6,4,OR,US,10,2142
OUTLANDER 1000,2021-11-22,5,13,OR,US,18,2274
OUTLANDER 850,2021-11-22,9,4,OR,US,13,2186
OUTLANDER 450,2021-11-22,1,6,OR,US,7,2149
OUTLANDER 1000,2021-11-29,7,10,OR,US,17,2291
OUTLANDER 850,2021-11-29,7,2,OR,US,9,2195
OUTLANDER 450,2021-11-29,5,10,OR,US,15,2164
OUTLANDER 1000,2021-12-06,12,2,OR,US,14,2305
OUTLANDER 850,2021-12-06,14,5,OR,US,19,2214
OUTLANDER 450,2021-12-06,6,3,OR,US,9,2173
OUTLANDER 1000,2021-12-13,1,14,OR,US,15,2320
OUTLANDER 850,2021-12-13,12,6,OR,US,18,2232
OUTLANDER 450,2021-12-13,14,13,OR,US,27,2200
OUTLANDER 1000,2021-12-20,14,6,OR,US,20,2340
OUTLANDER 850,2021-12-20,1,3,OR,US,4,2236
OUTLANDER 450,2021-12-20,2,13,OR,US,15,2215
OUTLANDER 1000,2021-12-27,10,13,OR,US,23,2363
OUTLANDER 850,2021-12-27,6,12,OR,US,18,2254
OUTLANDER 450,2021-12-27,13,13,OR,US,26,2241
OUTLANDER 1000,2019-01-07,6,5,PA,US,11,11
OUTLANDER 850,2019-01-07,11,4,PA,US,15,15
OUTLANDER 450,2019-01-07,15,9,PA,US,24,24
OUTLANDER 1000,2019-01-14,15,5,PA,US,20,31
OUTLANDER 850,2019-01-14,5,2,PA,US,7,22
OUTLANDER 450,2019-01-14,10,11,PA,US,21,45
OUTLANDER 1000,2019-01-21,4,3,PA,US,7,38
OUTLANDER 850,2019-01-21,7,4,PA,US,11,33
OUTLANDER 450,2019-01-21,6,0,PA,US,6,51
OUTLANDER 1000,2019-01-28,9,7,PA,US,16,54
OUTLANDER 850,2019-01-28,15,12,PA,US,27,60
OUTLANDER 450,2019-01-28,7,6,PA,US,13,64
OUTLANDER 1000,2019-02-04,11,12,PA,US,23,77
OUTLANDER 850,2019-02-04,4,14,PA,US,18,78
OUTLANDER 450,2019-02-04,3,0,PA,US,3,67
OUTLANDER 1000,2019-02-11,2,14,PA,US,16,93
OUTLANDER 850,2019-02-11,12,13,PA,US,25,103
OUTLANDER 450,2019-02-11,8,6,PA,US,14,81
OUTLANDER 1000,2019-02-18,0,8,PA,US,8,101
OUTLANDER 850,2019-02-18,6,7,PA,US,13,116
OUTLANDER 450,2019-02-18,12,10,PA,US,22,103
OUTLANDER 1000,2019-02-25,12,7,PA,US,19,120
OUTLANDER 850,2019-02-25,13,11,PA,US,24,140
OUTLANDER 450,2019-02-25,12,4,PA,US,16,119
OUTLANDER 1000,2019-03-04,13,10,PA,US,23,143
OUTLANDER 850,2019-03-04,9,11,PA,US,20,160
OUTLANDER 450,2019-03-04,11,1,PA,US,12,131
OUTLANDER 1000,2019-03-11,4,4,PA,US,8,151
OUTLANDER 850,2019-03-11,2,14,PA,US,16,176
OUTLANDER 450,2019-03-11,3,12,PA,US,15,146
OUTLANDER 1000,2019-03-18,15,8,PA,US,23,174
OUTLANDER 850,2019-03-18,13,5,PA,US,18,194
OUTLANDER 450,2019-03-18,0,1,PA,US,1,147
OUTLANDER 1000,2019-03-25,13,8,PA,US,21,195
OUTLANDER 850,2019-03-25,1,1,PA,US,2,196
OUTLANDER 450,2019-03-25,12,6,PA,US,18,165
OUTLANDER 1000,2019-04-01,14,0,PA,US,14,209
OUTLANDER 850,2019-04-01,3,10,PA,US,13,209
OUTLANDER 450,2019-04-01,6,14,PA,US,20,185
OUTLANDER 1000,2019-04-08,4,5,PA,US,9,218
OUTLANDER 850,2019-04-08,3,11,PA,US,14,223
OUTLANDER 450,2019-04-08,9,8,PA,US,17,202
OUTLANDER 1000,2019-04-15,1,14,PA,US,15,233
OUTLANDER 850,2019-04-15,4,10,PA,US,14,237
OUTLANDER 450,2019-04-15,13,7,PA,US,20,222
OUTLANDER 1000,2019-04-22,14,14,PA,US,28,261
OUTLANDER 850,2019-04-22,10,4,PA,US,14,251
OUTLANDER 450,2019-04-22,8,3,PA,US,11,233
OUTLANDER 1000,2019-04-29,11,6,PA,US,17,278
OUTLANDER 850,2019-04-29,15,8,PA,US,23,274
OUTLANDER 450,2019-04-29,13,5,PA,US,18,251
OUTLANDER 1000,2019-05-06,2,1,PA,US,3,281
OUTLANDER 850,2019-05-06,10,3,PA,US,13,287
OUTLANDER 450,2019-05-06,6,10,PA,US,16,267
OUTLANDER 1000,2019-05-13,14,15,PA,US,29,310
OUTLANDER 850,2019-05-13,14,2,PA,US,16,303
OUTLANDER 450,2019-05-13,9,14,PA,US,23,290
OUTLANDER 1000,2019-05-20,4,1,PA,US,5,315
OUTLANDER 850,2019-05-20,14,13,PA,US,27,330
OUTLANDER 450,2019-05-20,5,0,PA,US,5,295
OUTLANDER 1000,2019-05-27,9,4,PA,US,13,328
OUTLANDER 850,2019-05-27,9,14,PA,US,23,353
OUTLANDER 450,2019-05-27,10,7,PA,US,17,312
OUTLANDER 1000,2019-06-03,14,11,PA,US,25,353
OUTLANDER 850,2019-06-03,2,11,PA,US,13,366
OUTLANDER 450,2019-06-03,2,1,PA,US,3,315
OUTLANDER 1000,2019-06-10,5,13,PA,US,18,371
OUTLANDER 850,2019-06-10,12,13,PA,US,25,391
OUTLANDER 450,2019-06-10,1,9,PA,US,10,325
OUTLANDER 1000,2019-06-17,8,1,PA,US,9,380
OUTLANDER 850,2019-06-17,5,7,PA,US,12,403
OUTLANDER 450,2019-06-17,2,13,PA,US,15,340
OUTLANDER 1000,2019-06-24,9,14,PA,US,23,403
OUTLANDER 850,2019-06-24,5,5,PA,US,10,413
OUTLANDER 450,2019-06-24,11,5,PA,US,16,356
OUTLANDER 1000,2019-07-01,1,10,PA,US,11,414
OUTLANDER 850,2019-07-01,2,13,PA,US,15,428
OUTLANDER 450,2019-07-01,10,8,PA,US,18,374
OUTLANDER 1000,2019-07-08,8,6,PA,US,14,428
OUTLANDER 850,2019-07-08,13,9,PA,US,22,450
OUTLANDER 450,2019-07-08,14,10,PA,US,24,398
OUTLANDER 1000,2019-07-15,12,6,PA,US,18,446
OUTLANDER 850,2019-07-15,0,7,PA,US,7,457
OUTLANDER 450,2019-07-15,14,3,PA,US,17,415
OUTLANDER 1000,2019-07-22,2,10,PA,US,12,458
OUTLANDER 850,2019-07-22,12,10,PA,US,22,479
OUTLANDER 450,2019-07-22,11,10,PA,US,21,436
OUTLANDER 1000,2019-07-29,2,7,PA,US,9,467
OUTLANDER 850,2019-07-29,8,12,PA,US,20,499
OUTLANDER 450,2019-07-29,4,2,PA,US,6,442
OUTLANDER 1000,2019-08-05,2,11,PA,US,13,480
OUTLANDER 850,2019-08-05,10,0,PA,US,10,509
OUTLANDER 450,2019-08-05,4,14,PA,US,18,460
OUTLANDER 1000,2019-08-12,12,8,PA,US,20,500
OUTLANDER 850,2019-08-12,3,5,PA,US,8,517
OUTLANDER 450,2019-08-12,5,0,PA,US,5,465
OUTLANDER 1000,2019-08-19,10,8,PA,US,18,518
OUTLANDER 850,2019-08-19,6,14,PA,US,20,537
OUTLANDER 450,2019-08-19,10,9,PA,US,19,484
OUTLANDER 1000,2019-08-26,2,9,PA,US,11,529
OUTLANDER 850,2019-08-26,8,3,PA,US,11,548
OUTLANDER 450,2019-08-26,11,3,PA,US,14,498
OUTLANDER 1000,2019-09-02,1,14,PA,US,15,544
OUTLANDER 850,2019-09-02,6,9,PA,US,15,563
OUTLANDER 450,2019-09-02,6,6,PA,US,12,510
OUTLANDER 1000,2019-09-09,13,5,PA,US,18,562
OUTLANDER 850,2019-09-09,9,13,PA,US,22,585
OUTLANDER 450,2019-09-09,8,13,PA,US,21,531
OUTLANDER 1000,2019-09-16,1,3,PA,US,4,566
OUTLANDER 850,2019-09-16,3,7,PA,US,10,595
OUTLANDER 450,2019-09-16,13,3,PA,US,16,547
OUTLANDER 1000,2019-09-23,11,12,PA,US,23,589
OUTLANDER 850,2019-09-23,14,1,PA,US,15,610
OUTLANDER 450,2019-09-23,12,6,PA,US,18,565
OUTLANDER 1000,2019-09-30,6,5,PA,US,11,600
OUTLANDER 850,2019-09-30,3,9,PA,US,12,622
OUTLANDER 450,2019-09-30,1,5,PA,US,6,571
OUTLANDER 1000,2019-10-07,10,3,PA,US,13,613
OUTLANDER 850,2019-10-07,5,0,PA,US,5,627
OUTLANDER 450,2019-10-07,10,3,PA,US,13,584
OUTLANDER 1000,2019-10-14,12,8,PA,US,20,633
OUTLANDER 850,2019-10-14,10,3,PA,US,13,640
OUTLANDER 450,2019-10-14,0,1,PA,US,1,585
OUTLANDER 1000,2019-10-21,9,12,PA,US,21,654
OUTLANDER 850,2019-10-21,11,2,PA,US,13,653
OUTLANDER 450,2019-10-21,10,2,PA,US,12,597
OUTLANDER 1000,2019-10-28,10,2,PA,US,12,666
OUTLANDER 850,2019-10-28,9,10,PA,US,19,672
OUTLANDER 450,2019-10-28,12,11,PA,US,23,620
OUTLANDER 1000,2019-11-04,2,5,PA,US,7,673
OUTLANDER 850,2019-11-04,3,1,PA,US,4,676
OUTLANDER 450,2019-11-04,9,12,PA,US,21,641
OUTLANDER 1000,2019-11-11,6,3,PA,US,9,682
OUTLANDER 850,2019-11-11,14,14,PA,US,28,704
OUTLANDER 450,2019-11-11,14,4,PA,US,18,659
OUTLANDER 1000,2019-11-18,3,10,PA,US,13,695
OUTLANDER 850,2019-11-18,11,4,PA,US,15,719
OUTLANDER 450,2019-11-18,13,11,PA,US,24,683
OUTLANDER 1000,2019-11-25,10,1,PA,US,11,706
OUTLANDER 850,2019-11-25,6,2,PA,US,8,727
OUTLANDER 450,2019-11-25,7,7,PA,US,14,697
OUTLANDER 1000,2019-12-02,10,11,PA,US,21,727
OUTLANDER 850,2019-12-02,14,9,PA,US,23,750
OUTLANDER 450,2019-12-02,5,12,PA,US,17,714
OUTLANDER 1000,2019-12-09,4,9,PA,US,13,740
OUTLANDER 850,2019-12-09,6,13,PA,US,19,769
OUTLANDER 450,2019-12-09,10,11,PA,US,21,735
OUTLANDER 1000,2019-12-16,11,6,PA,US,17,757
OUTLANDER 850,2019-12-16,3,6,PA,US,9,778
OUTLANDER 450,2019-12-16,4,1,PA,US,5,740
OUTLANDER 1000,2019-12-23,13,3,PA,US,16,773
OUTLANDER 850,2019-12-23,4,14,PA,US,18,796
OUTLANDER 450,2019-12-23,13,6,PA,US,19,759
OUTLANDER 1000,2019-12-30,13,13,PA,US,26,799
OUTLANDER 850,2019-12-30,12,4,PA,US,16,812
OUTLANDER 450,2019-12-30,9,4,PA,US,13,772
OUTLANDER 1000,2020-01-06,3,15,PA,US,18,817
OUTLANDER 850,2020-01-06,11,5,PA,US,16,828
OUTLANDER 450,2020-01-06,8,2,PA,US,10,782
OUTLANDER 1000,2020-01-13,12,2,PA,US,14,831
OUTLANDER 850,2020-01-13,14,8,PA,US,22,850
OUTLANDER 450,2020-01-13,3,0,PA,US,3,785
OUTLANDER 1000,2020-01-20,6,14,PA,US,20,851
OUTLANDER 850,2020-01-20,3,0,PA,US,3,853
OUTLANDER 450,2020-01-20,12,6,PA,US,18,803
OUTLANDER 1000,2020-01-27,4,6,PA,US,10,861
OUTLANDER 850,2020-01-27,8,9,PA,US,17,870
OUTLANDER 450,2020-01-27,1,0,PA,US,1,804
OUTLANDER 1000,2020-02-03,1,13,PA,US,14,875
OUTLANDER 850,2020-02-03,1,13,PA,US,14,884
OUTLANDER 450,2020-02-03,12,6,PA,US,18,822
OUTLANDER 1000,2020-02-10,1,11,PA,US,12,887
OUTLANDER 850,2020-02-10,1,10,PA,US,11,895
OUTLANDER 450,2020-02-10,4,10,PA,US,14,836
OUTLANDER 1000,2020-02-17,14,4,PA,US,18,905
OUTLANDER 850,2020-02-17,0,12,PA,US,12,907
OUTLANDER 450,2020-02-17,9,15,PA,US,24,860
OUTLANDER 1000,2020-02-24,12,5,PA,US,17,922
OUTLANDER 850,2020-02-24,8,2,PA,US,10,917
OUTLANDER 450,2020-02-24,2,12,PA,US,14,874
OUTLANDER 1000,2020-03-02,15,10,PA,US,25,947
OUTLANDER 850,2020-03-02,9,6,PA,US,15,932
OUTLANDER 450,2020-03-02,5,4,PA,US,9,883
OUTLANDER 1000,2020-03-09,5,12,PA,US,17,964
OUTLANDER 850,2020-03-09,6,2,PA,US,8,940
OUTLANDER 450,2020-03-09,4,10,PA,US,14,897
OUTLANDER 1000,2020-03-16,2,3,PA,US,5,969
OUTLANDER 850,2020-03-16,9,9,PA,US,18,958
OUTLANDER 450,2020-03-16,2,7,PA,US,9,906
OUTLANDER 1000,2020-03-23,8,11,PA,US,19,988
OUTLANDER 850,2020-03-23,0,3,PA,US,3,961
OUTLANDER 450,2020-03-23,4,13,PA,US,17,923
OUTLANDER 1000,2020-03-30,7,12,PA,US,19,1007
OUTLANDER 850,2020-03-30,9,13,PA,US,22,983
OUTLANDER 450,2020-03-30,2,14,PA,US,16,939
OUTLANDER 1000,2020-04-06,0,2,PA,US,2,1009
OUTLANDER 850,2020-04-06,14,7,PA,US,21,1004
OUTLANDER 450,2020-04-06,11,3,PA,US,14,953
OUTLANDER 1000,2020-04-13,6,5,PA,US,11,1020
OUTLANDER 850,2020-04-13,2,5,PA,US,7,1011
OUTLANDER 450,2020-04-13,0,15,PA,US,15,968
OUTLANDER 1000,2020-04-20,15,13,PA,US,28,1048
OUTLANDER 850,2020-04-20,10,4,PA,US,14,1025
OUTLANDER 450,2020-04-20,9,12,PA,US,21,989
OUTLANDER 1000,2020-04-27,0,11,PA,US,11,1059
OUTLANDER 850,2020-04-27,2,14,PA,US,16,1041
OUTLANDER 450,2020-04-27,1,13,PA,US,14,1003
OUTLANDER 1000,2020-05-04,0,7,PA,US,7,1066
OUTLANDER 850,2020-05-04,2,10,PA,US,12,1053
OUTLANDER 450,2020-05-04,1,14,PA,US,15,1018
OUTLANDER 1000,2020-05-11,4,6,PA,US,10,1076
OUTLANDER 850,2020-05-11,5,3,PA,US,8,1061
OUTLANDER 450,2020-05-11,2,1,PA,US,3,1021
OUTLANDER 1000,2020-05-18,6,11,PA,US,17,1093
OUTLANDER 850,2020-05-18,15,1,PA,US,16,1077
OUTLANDER 450,2020-05-18,11,12,PA,US,23,1044
OUTLANDER 1000,2020-05-25,3,4,PA,US,7,1100
OUTLANDER 850,2020-05-25,9,4,PA,US,13,1090
OUTLANDER 450,2020-05-25,10,8,PA,US,18,1062
OUTLANDER 1000,2020-06-01,8,5,PA,US,13,1113
OUTLANDER 850,2020-06-01,15,4,PA,US,19,1109
OUTLANDER 450,2020-06-01,11,2,PA,US,13,1075
OUTLANDER 1000,2020-06-08,5,6,PA,US,11,1124
OUTLANDER 850,2020-06-08,9,9,PA,US,18,1127
OUTLANDER 450,2020-06-08,3,3,PA,US,6,1081
OUTLANDER 1000,2020-06-15,11,3,PA,US,14,1138
OUTLANDER 850,2020-06-15,4,1,PA,US,5,1132
OUTLANDER 450,2020-06-15,14,12,PA,US,26,1107
OUTLANDER 1000,2020-06-22,4,13,PA,US,17,1155
OUTLANDER 850,2020-06-22,9,0,PA,US,9,1141
OUTLANDER 450,2020-06-22,1,3,PA,US,4,1111
OUTLANDER 1000,2020-06-29,2,2,PA,US,4,1159
OUTLANDER 850,2020-06-29,2,7,PA,US,9,1150
OUTLANDER 450,2020-06-29,9,4,PA,US,13,1124
OUTLANDER 1000,2020-07-06,4,0,PA,US,4,1163
OUTLANDER 850,2020-07-06,6,7,PA,US,13,1163
OUTLANDER 450,2020-07-06,0,5,PA,US,5,1129
OUTLANDER 1000,2020-07-13,13,11,PA,US,24,1187
OUTLANDER 850,2020-07-13,14,9,PA,US,23,1186
OUTLANDER 450,2020-07-13,15,10,PA,US,25,1154
OUTLANDER 1000,2020-07-20,12,5,PA,US,17,1204
OUTLANDER 850,2020-07-20,6,2,PA,US,8,1194
OUTLANDER 450,2020-07-20,9,6,PA,US,15,1169
OUTLANDER 1000,2020-07-27,10,1,PA,US,11,1215
OUTLANDER 850,2020-07-27,15,12,PA,US,27,1221
OUTLANDER 450,2020-07-27,12,9,PA,US,21,1190
OUTLANDER 1000,2020-08-03,13,1,PA,US,14,1229
OUTLANDER 850,2020-08-03,8,11,PA,US,19,1240
OUTLANDER 450,2020-08-03,9,4,PA,US,13,1203
OUTLANDER 1000,2020-08-10,5,10,PA,US,15,1244
OUTLANDER 850,2020-08-10,11,7,PA,US,18,1258
OUTLANDER 450,2020-08-10,9,3,PA,US,12,1215
OUTLANDER 1000,2020-08-17,5,14,PA,US,19,1263
OUTLANDER 850,2020-08-17,15,13,PA,US,28,1286
OUTLANDER 450,2020-08-17,12,3,PA,US,15,1230
OUTLANDER 1000,2020-08-24,7,12,PA,US,19,1282
OUTLANDER 850,2020-08-24,10,3,PA,US,13,1299
OUTLANDER 450,2020-08-24,2,4,PA,US,6,1236
OUTLANDER 1000,2020-08-31,15,4,PA,US,19,1301
OUTLANDER 850,2020-08-31,7,7,PA,US,14,1313
OUTLANDER 450,2020-08-31,12,10,PA,US,22,1258
OUTLANDER 1000,2020-09-07,9,11,PA,US,20,1321
OUTLANDER 850,2020-09-07,5,3,PA,US,8,1321
OUTLANDER 450,2020-09-07,12,9,PA,US,21,1279
OUTLANDER 1000,2020-09-14,6,6,PA,US,12,1333
OUTLANDER 850,2020-09-14,6,2,PA,US,8,1329
OUTLANDER 450,2020-09-14,1,8,PA,US,9,1288
OUTLANDER 1000,2020-09-21,8,1,PA,US,9,1342
OUTLANDER 850,2020-09-21,13,5,PA,US,18,1347
OUTLANDER 450,2020-09-21,5,15,PA,US,20,1308
OUTLANDER 1000,2020-09-28,1,2,PA,US,3,1345
OUTLANDER 850,2020-09-28,4,0,PA,US,4,1351
OUTLANDER 450,2020-09-28,7,5,PA,US,12,1320
OUTLANDER 1000,2020-10-05,5,13,PA,US,18,1363
OUTLANDER 850,2020-10-05,10,10,PA,US,20,1371
OUTLANDER 450,2020-10-05,5,14,PA,US,19,1339
OUTLANDER 1000,2020-10-12,1,7,PA,US,8,1371
OUTLANDER 850,2020-10-12,9,9,PA,US,18,1389
OUTLANDER 450,2020-10-12,3,3,PA,US,6,1345
OUTLANDER 1000,2020-10-19,2,9,PA,US,11,1382
OUTLANDER 850,2020-10-19,9,9,PA,US,18,1407
OUTLANDER 450,2020-10-19,1,11,PA,US,12,1357
OUTLANDER 1000,2020-10-26,6,1,PA,US,7,1389
OUTLANDER 850,2020-10-26,9,13,PA,US,22,1429
OUTLANDER 450,2020-10-26,9,9,PA,US,18,1375
OUTLANDER 1000,2020-11-02,1,7,PA,US,8,1397
OUTLANDER 850,2020-11-02,13,1,PA,US,14,1443
OUTLANDER 450,2020-11-02,3,6,PA,US,9,1384
OUTLANDER 1000,2020-11-09,11,2,PA,US,13,1410
OUTLANDER 850,2020-11-09,1,1,PA,US,2,1445
OUTLANDER 450,2020-11-09,9,1,PA,US,10,1394
OUTLANDER 1000,2020-11-16,2,10,PA,US,12,1422
OUTLANDER 850,2020-11-16,4,7,PA,US,11,1456
OUTLANDER 450,2020-11-16,2,13,PA,US,15,1409
OUTLANDER 1000,2020-11-23,5,8,PA,US,13,1435
OUTLANDER 850,2020-11-23,1,14,PA,US,15,1471
OUTLANDER 450,2020-11-23,9,9,PA,US,18,1427
OUTLANDER 1000,2020-11-30,3,3,PA,US,6,1441
OUTLANDER 850,2020-11-30,8,8,PA,US,16,1487
OUTLANDER 450,2020-11-30,5,10,PA,US,15,1442
OUTLANDER 1000,2020-12-07,12,10,PA,US,22,1463
OUTLANDER 850,2020-12-07,5,0,PA,US,5,1492
OUTLANDER 450,2020-12-07,4,3,PA,US,7,1449
OUTLANDER 1000,2020-12-14,6,3,PA,US,9,1472
OUTLANDER 850,2020-12-14,5,9,PA,US,14,1506
OUTLANDER 450,2020-12-14,11,0,PA,US,11,1460
OUTLANDER 1000,2020-12-21,8,3,PA,US,11,1483
OUTLANDER 850,2020-12-21,13,10,PA,US,23,1529
OUTLANDER 450,2020-12-21,3,5,PA,US,8,1468
OUTLANDER 1000,2020-12-28,1,8,PA,US,9,1492
OUTLANDER 850,2020-12-28,8,6,PA,US,14,1543
OUTLANDER 450,2020-12-28,7,9,PA,US,16,1484
OUTLANDER 1000,2021-01-04,15,0,PA,US,15,1507
OUTLANDER 850,2021-01-04,9,0,PA,US,9,1552
OUTLANDER 450,2021-01-04,5,12,PA,US,17,1501
OUTLANDER 1000,2021-01-11,12,13,PA,US,25,1532
OUTLANDER 850,2021-01-11,8,6,PA,US,14,1566
OUTLANDER 450,2021-01-11,14,14,PA,US,28,1529
OUTLANDER 1000,2021-01-18,10,14,PA,US,24,1556
OUTLANDER 850,2021-01-18,3,5,PA,US,8,1574
OUTLANDER 450,2021-01-18,3,3,PA,US,6,1535
OUTLANDER 1000,2021-01-25,6,12,PA,US,18,1574
OUTLANDER 850,2021-01-25,13,8,PA,US,21,1595
OUTLANDER 450,2021-01-25,9,3,PA,US,12,1547
OUTLANDER 1000,2021-02-01,6,9,PA,US,15,1589
OUTLANDER 850,2021-02-01,9,13,PA,US,22,1617
OUTLANDER 450,2021-02-01,7,7,PA,US,14,1561
OUTLANDER 1000,2021-02-08,14,1,PA,US,15,1604
OUTLANDER 850,2021-02-08,14,2,PA,US,16,1633
OUTLANDER 450,2021-02-08,4,2,PA,US,6,1567
OUTLANDER 1000,2021-02-15,14,3,PA,US,17,1621
OUTLANDER 850,2021-02-15,3,4,PA,US,7,1640
OUTLANDER 450,2021-02-15,1,9,PA,US,10,1577
OUTLANDER 1000,2021-02-22,5,11,PA,US,16,1637
OUTLANDER 850,2021-02-22,6,9,PA,US,15,1655
OUTLANDER 450,2021-02-22,13,7,PA,US,20,1597
OUTLANDER 1000,2021-03-01,14,8,PA,US,22,1659
OUTLANDER 850,2021-03-01,12,13,PA,US,25,1680
OUTLANDER 450,2021-03-01,1,14,PA,US,15,1612
OUTLANDER 1000,2021-03-08,2,5,PA,US,7,1666
OUTLANDER 850,2021-03-08,7,9,PA,US,16,1696
OUTLANDER 450,2021-03-08,2,15,PA,US,17,1629
OUTLANDER 1000,2021-03-15,3,4,PA,US,7,1673
OUTLANDER 850,2021-03-15,7,2,PA,US,9,1705
OUTLANDER 450,2021-03-15,4,15,PA,US,19,1648
OUTLANDER 1000,2021-03-22,5,5,PA,US,10,1683
OUTLANDER 850,2021-03-22,4,14,PA,US,18,1723
OUTLANDER 450,2021-03-22,7,5,PA,US,12,1660
OUTLANDER 1000,2021-03-29,9,9,PA,US,18,1701
OUTLANDER 850,2021-03-29,6,12,PA,US,18,1741
OUTLANDER 450,2021-03-29,9,12,PA,US,21,1681
OUTLANDER 1000,2021-04-05,9,14,PA,US,23,1724
OUTLANDER 850,2021-04-05,4,11,PA,US,15,1756
OUTLANDER 450,2021-04-05,9,5,PA,US,14,1695
OUTLANDER 1000,2021-04-12,8,4,PA,US,12,1736
OUTLANDER 850,2021-04-12,15,9,PA,US,24,1780
OUTLANDER 450,2021-04-12,5,0,PA,US,5,1700
OUTLANDER 1000,2021-04-19,13,5,PA,US,18,1754
OUTLANDER 850,2021-04-19,1,9,PA,US,10,1790
OUTLANDER 450,2021-04-19,14,12,PA,US,26,1726
OUTLANDER 1000,2021-04-26,11,12,PA,US,23,1777
OUTLANDER 850,2021-04-26,7,5,PA,US,12,1802
OUTLANDER 450,2021-04-26,1,4,PA,US,5,1731
OUTLANDER 1000,2021-05-03,2,12,PA,US,14,1791
OUTLANDER 850,2021-05-03,9,4,PA,US,13,1815
OUTLANDER 450,2021-05-03,10,9,PA,US,19,1750
OUTLANDER 1000,2021-05-10,4,8,PA,US,12,1803
OUTLANDER 850,2021-05-10,12,1,PA,US,13,1828
OUTLANDER 450,2021-05-10,12,1,PA,US,13,1763
OUTLANDER 1000,2021-05-17,2,9,PA,US,11,1814
OUTLANDER 850,2021-05-17,6,5,PA,US,11,1839
OUTLANDER 450,2021-05-17,9,6,PA,US,15,1778
OUTLANDER 1000,2021-05-24,7,7,PA,US,14,1828
OUTLANDER 850,2021-05-24,12,13,PA,US,25,1864
OUTLANDER 450,2021-05-24,7,9,PA,US,16,1794
OUTLANDER 1000,2021-05-31,0,1,PA,US,1,1829
OUTLANDER 850,2021-05-31,8,14,PA,US,22,1886
OUTLANDER 450,2021-05-31,15,0,PA,US,15,1809
OUTLANDER 1000,2021-06-07,1,14,PA,US,15,1844
OUTLANDER 850,2021-06-07,0,10,PA,US,10,1896
OUTLANDER 450,2021-06-07,2,3,PA,US,5,1814
OUTLANDER 1000,2021-06-14,11,3,PA,US,14,1858
OUTLANDER 850,2021-06-14,6,12,PA,US,18,1914
OUTLANDER 450,2021-06-14,2,2,PA,US,4,1818
OUTLANDER 1000,2021-06-21,4,9,PA,US,13,1871
OUTLANDER 850,2021-06-21,3,10,PA,US,13,1927
OUTLANDER 450,2021-06-21,12,10,PA,US,22,1840
OUTLANDER 1000,2021-06-28,5,11,PA,US,16,1887
OUTLANDER 850,2021-06-28,13,14,PA,US,27,1954
OUTLANDER 450,2021-06-28,10,14,PA,US,24,1864
OUTLANDER 1000,2021-07-05,9,14,PA,US,23,1910
OUTLANDER 850,2021-07-05,8,2,PA,US,10,1964
OUTLANDER 450,2021-07-05,10,10,PA,US,20,1884
OUTLANDER 1000,2021-07-12,2,14,PA,US,16,1926
OUTLANDER 850,2021-07-12,14,12,PA,US,26,1990
OUTLANDER 450,2021-07-12,3,7,PA,US,10,1894
OUTLANDER 1000,2021-07-19,15,10,PA,US,25,1951
OUTLANDER 850,2021-07-19,2,12,PA,US,14,2004
OUTLANDER 450,2021-07-19,3,5,PA,US,8,1902
OUTLANDER 1000,2021-07-26,13,8,PA,US,21,1972
OUTLANDER 850,2021-07-26,9,1,PA,US,10,2014
OUTLANDER 450,2021-07-26,11,7,PA,US,18,1920
OUTLANDER 1000,2021-08-02,13,7,PA,US,20,1992
OUTLANDER 850,2021-08-02,10,13,PA,US,23,2037
OUTLANDER 450,2021-08-02,13,14,PA,US,27,1947
OUTLANDER 1000,2021-08-09,13,2,PA,US,15,2007
OUTLANDER 850,2021-08-09,3,4,PA,US,7,2044
OUTLANDER 450,2021-08-09,8,3,PA,US,11,1958
OUTLANDER 1000,2021-08-16,3,7,PA,US,10,2017
OUTLANDER 850,2021-08-16,5,6,PA,US,11,2055
OUTLANDER 450,2021-08-16,7,0,PA,US,7,1965
OUTLANDER 1000,2021-08-23,1,2,PA,US,3,2020
OUTLANDER 850,2021-08-23,7,5,PA,US,12,2067
OUTLANDER 450,2021-08-23,5,1,PA,US,6,1971
OUTLANDER 1000,2021-08-30,10,10,PA,US,20,2040
OUTLANDER 850,2021-08-30,12,13,PA,US,25,2092
OUTLANDER 450,2021-08-30,9,7,PA,US,16,1987
OUTLANDER 1000,2021-09-06,9,9,PA,US,18,2058
OUTLANDER 850,2021-09-06,9,5,PA,US,14,2106
OUTLANDER 450,2021-09-06,13,14,PA,US,27,2014
OUTLANDER 1000,2021-09-13,11,12,PA,US,23,2081
OUTLANDER 850,2021-09-13,2,0,PA,US,2,2108
OUTLANDER 450,2021-09-13,11,10,PA,US,21,2035
OUTLANDER 1000,2021-09-20,7,11,PA,US,18,2099
OUTLANDER 850,2021-09-20,12,9,PA,US,21,2129
OUTLANDER 450,2021-09-20,2,13,PA,US,15,2050
OUTLANDER 1000,2021-09-27,14,8,PA,US,22,2121
OUTLANDER 850,2021-09-27,6,3,PA,US,9,2138
OUTLANDER 450,2021-09-27,8,12,PA,US,20,2070
OUTLANDER 1000,2021-10-04,4,2,PA,US,6,2127
OUTLANDER 850,2021-10-04,14,5,PA,US,19,2157
OUTLANDER 450,2021-10-04,12,14,PA,US,26,2096
OUTLANDER 1000,2021-10-11,7,11,PA,US,18,2145
OUTLANDER 850,2021-10-11,9,2,PA,US,11,2168
OUTLANDER 450,2021-10-11,5,14,PA,US,19,2115
OUTLANDER 1000,2021-10-18,3,1,PA,US,4,2149
OUTLANDER 850,2021-10-18,10,9,PA,US,19,2187
OUTLANDER 450,2021-10-18,10,1,PA,US,11,2126
OUTLANDER 1000,2021-10-25,11,6,PA,US,17,2166
OUTLANDER 850,2021-10-25,5,8,PA,US,13,2200
OUTLANDER 450,2021-10-25,7,15,PA,US,22,2148
OUTLANDER 1000,2021-11-01,11,9,PA,US,20,2186
OUTLANDER 850,2021-11-01,2,4,PA,US,6,2206
OUTLANDER 450,2021-11-01,1,12,PA,US,13,2161
OUTLANDER 1000,2021-11-08,6,6,PA,US,12,2198
OUTLANDER 850,2021-11-08,12,13,PA,US,25,2231
OUTLANDER 450,2021-11-08,8,0,PA,US,8,2169
OUTLANDER 1000,2021-11-15,9,12,PA,US,21,2219
OUTLANDER 850,2021-11-15,2,1,PA,US,3,2234
OUTLANDER 450,2021-11-15,8,7,PA,US,15,2184
OUTLANDER 1000,2021-11-22,5,5,PA,US,10,2229
OUTLANDER 850,2021-11-22,9,13,PA,US,22,2256
OUTLANDER 450,2021-11-22,10,11,PA,US,21,2205
OUTLANDER 1000,2021-11-29,11,1,PA,US,12,2241
OUTLANDER 850,2021-11-29,13,3,PA,US,16,2272
OUTLANDER 450,2021-11-29,14,7,PA,US,21,2226
OUTLANDER 1000,2021-12-06,13,12,PA,US,25,2266
OUTLANDER 850,2021-12-06,2,2,PA,US,4,2276
OUTLANDER 450,2021-12-06,10,9,PA,US,19,2245
OUTLANDER 1000,2021-12-13,9,1,PA,US,10,2276
OUTLANDER 850,2021-12-13,8,2,PA,US,10,2286
OUTLANDER 450,2021-12-13,10,0,PA,US,10,2255
OUTLANDER 1000,2021-12-20,13,12,PA,US,25,2301
OUTLANDER 850,2021-12-20,2,10,PA,US,12,2298
OUTLANDER 450,2021-12-20,2,13,PA,US,15,2270
OUTLANDER 1000,2021-12-27,11,12,PA,US,23,2324
OUTLANDER 850,2021-12-27,14,7,PA,US,21,2319
OUTLANDER 450,2021-12-27,9,9,PA,US,18,2288
OUTLANDER 1000,2019-01-07,5,5,RI,US,10,10
OUTLANDER 850,2019-01-07,12,13,RI,US,25,25
OUTLANDER 450,2019-01-07,6,1,RI,US,7,7
OUTLANDER 1000,2019-01-14,2,6,RI,US,8,18
OUTLANDER 850,2019-01-14,6,15,RI,US,21,46
OUTLANDER 450,2019-01-14,0,4,RI,US,4,11
OUTLANDER 1000,2019-01-21,13,11,RI,US,24,42
OUTLANDER 850,2019-01-21,1,14,RI,US,15,61
OUTLANDER 450,2019-01-21,9,1,RI,US,10,21
OUTLANDER 1000,2019-01-28,6,4,RI,US,10,52
OUTLANDER 850,2019-01-28,7,7,RI,US,14,75
OUTLANDER 450,2019-01-28,15,6,RI,US,21,42
OUTLANDER 1000,2019-02-04,10,9,RI,US,19,71
OUTLANDER 850,2019-02-04,0,6,RI,US,6,81
OUTLANDER 450,2019-02-04,4,13,RI,US,17,59
OUTLANDER 1000,2019-02-11,10,15,RI,US,25,96
OUTLANDER 850,2019-02-11,8,0,RI,US,8,89
OUTLANDER 450,2019-02-11,8,1,RI,US,9,68
OUTLANDER 1000,2019-02-18,6,10,RI,US,16,112
OUTLANDER 850,2019-02-18,6,3,RI,US,9,98
OUTLANDER 450,2019-02-18,12,10,RI,US,22,90
OUTLANDER 1000,2019-02-25,1,3,RI,US,4,116
OUTLANDER 850,2019-02-25,14,11,RI,US,25,123
OUTLANDER 450,2019-02-25,14,12,RI,US,26,116
OUTLANDER 1000,2019-03-04,10,7,RI,US,17,133
OUTLANDER 850,2019-03-04,7,10,RI,US,17,140
OUTLANDER 450,2019-03-04,9,2,RI,US,11,127
OUTLANDER 1000,2019-03-11,6,7,RI,US,13,146
OUTLANDER 850,2019-03-11,5,7,RI,US,12,152
OUTLANDER 450,2019-03-11,4,0,RI,US,4,131
OUTLANDER 1000,2019-03-18,12,10,RI,US,22,168
OUTLANDER 850,2019-03-18,14,1,RI,US,15,167
OUTLANDER 450,2019-03-18,7,12,RI,US,19,150
OUTLANDER 1000,2019-03-25,15,1,RI,US,16,184
OUTLANDER 850,2019-03-25,5,6,RI,US,11,178
OUTLANDER 450,2019-03-25,2,5,RI,US,7,157
OUTLANDER 1000,2019-04-01,6,5,RI,US,11,195
OUTLANDER 850,2019-04-01,14,11,RI,US,25,203
OUTLANDER 450,2019-04-01,1,13,RI,US,14,171
OUTLANDER 1000,2019-04-08,1,14,RI,US,15,210
OUTLANDER 850,2019-04-08,3,1,RI,US,4,207
OUTLANDER 450,2019-04-08,15,7,RI,US,22,193
OUTLANDER 1000,2019-04-15,2,2,RI,US,4,214
OUTLANDER 850,2019-04-15,14,11,RI,US,25,232
OUTLANDER 450,2019-04-15,11,10,RI,US,21,214
OUTLANDER 1000,2019-04-22,6,5,RI,US,11,225
OUTLANDER 850,2019-04-22,1,2,RI,US,3,235
OUTLANDER 450,2019-04-22,10,1,RI,US,11,225
OUTLANDER 1000,2019-04-29,13,4,RI,US,17,242
OUTLANDER 850,2019-04-29,14,8,RI,US,22,257
OUTLANDER 450,2019-04-29,13,14,RI,US,27,252
OUTLANDER 1000,2019-05-06,3,8,RI,US,11,253
OUTLANDER 850,2019-05-06,4,5,RI,US,9,266
OUTLANDER 450,2019-05-06,5,8,RI,US,13,265
OUTLANDER 1000,2019-05-13,9,3,RI,US,12,265
OUTLANDER 850,2019-05-13,7,2,RI,US,9,275
OUTLANDER 450,2019-05-13,1,1,RI,US,2,267
OUTLANDER 1000,2019-05-20,15,10,RI,US,25,290
OUTLANDER 850,2019-05-20,13,4,RI,US,17,292
OUTLANDER 450,2019-05-20,6,9,RI,US,15,282
OUTLANDER 1000,2019-05-27,1,6,RI,US,7,297
OUTLANDER 850,2019-05-27,7,1,RI,US,8,300
OUTLANDER 450,2019-05-27,5,4,RI,US,9,291
OUTLANDER 1000,2019-06-03,9,14,RI,US,23,320
OUTLANDER 850,2019-06-03,3,3,RI,US,6,306
OUTLANDER 450,2019-06-03,13,10,RI,US,23,314
OUTLANDER 1000,2019-06-10,13,10,RI,US,23,343
OUTLANDER 850,2019-06-10,12,7,RI,US,19,325
OUTLANDER 450,2019-06-10,15,12,RI,US,27,341
OUTLANDER 1000,2019-06-17,9,10,RI,US,19,362
OUTLANDER 850,2019-06-17,10,5,RI,US,15,340
OUTLANDER 450,2019-06-17,1,2,RI,US,3,344
OUTLANDER 1000,2019-06-24,2,4,RI,US,6,368
OUTLANDER 850,2019-06-24,9,11,RI,US,20,360
OUTLANDER 450,2019-06-24,11,3,RI,US,14,358
OUTLANDER 1000,2019-07-01,3,13,RI,US,16,384
OUTLANDER 850,2019-07-01,4,5,RI,US,9,369
OUTLANDER 450,2019-07-01,13,3,RI,US,16,374
OUTLANDER 1000,2019-07-08,10,2,RI,US,12,396
OUTLANDER 850,2019-07-08,11,5,RI,US,16,385
OUTLANDER 450,2019-07-08,9,12,RI,US,21,395
OUTLANDER 1000,2019-07-15,6,12,RI,US,18,414
OUTLANDER 850,2019-07-15,13,8,RI,US,21,406
OUTLANDER 450,2019-07-15,0,8,RI,US,8,403
OUTLANDER 1000,2019-07-22,3,14,RI,US,17,431
OUTLANDER 850,2019-07-22,2,9,RI,US,11,417
OUTLANDER 450,2019-07-22,13,14,RI,US,27,430
OUTLANDER 1000,2019-07-29,4,9,RI,US,13,444
OUTLANDER 850,2019-07-29,4,13,RI,US,17,434
OUTLANDER 450,2019-07-29,12,4,RI,US,16,446
OUTLANDER 1000,2019-08-05,8,14,RI,US,22,466
OUTLANDER 850,2019-08-05,9,9,RI,US,18,452
OUTLANDER 450,2019-08-05,11,10,RI,US,21,467
OUTLANDER 1000,2019-08-12,13,13,RI,US,26,492
OUTLANDER 850,2019-08-12,9,1,RI,US,10,462
OUTLANDER 450,2019-08-12,5,15,RI,US,20,487
OUTLANDER 1000,2019-08-19,4,8,RI,US,12,504
OUTLANDER 850,2019-08-19,11,10,RI,US,21,483
OUTLANDER 450,2019-08-19,6,2,RI,US,8,495
OUTLANDER 1000,2019-08-26,6,15,RI,US,21,525
OUTLANDER 850,2019-08-26,7,8,RI,US,15,498
OUTLANDER 450,2019-08-26,4,12,RI,US,16,511
OUTLANDER 1000,2019-09-02,3,8,RI,US,11,536
OUTLANDER 850,2019-09-02,5,2,RI,US,7,505
OUTLANDER 450,2019-09-02,1,8,RI,US,9,520
OUTLANDER 1000,2019-09-09,2,4,RI,US,6,542
OUTLANDER 850,2019-09-09,13,5,RI,US,18,523
OUTLANDER 450,2019-09-09,0,9,RI,US,9,529
OUTLANDER 1000,2019-09-16,4,14,RI,US,18,560
OUTLANDER 850,2019-09-16,15,6,RI,US,21,544
OUTLANDER 450,2019-09-16,10,13,RI,US,23,552
OUTLANDER 1000,2019-09-23,10,3,RI,US,13,573
OUTLANDER 850,2019-09-23,3,4,RI,US,7,551
OUTLANDER 450,2019-09-23,4,1,RI,US,5,557
OUTLANDER 1000,2019-09-30,4,7,RI,US,11,584
OUTLANDER 850,2019-09-30,14,13,RI,US,27,578
OUTLANDER 450,2019-09-30,5,7,RI,US,12,569
OUTLANDER 1000,2019-10-07,5,15,RI,US,20,604
OUTLANDER 850,2019-10-07,3,3,RI,US,6,584
OUTLANDER 450,2019-10-07,9,15,RI,US,24,593
OUTLANDER 1000,2019-10-14,10,9,RI,US,19,623
OUTLANDER 850,2019-10-14,12,11,RI,US,23,607
OUTLANDER 450,2019-10-14,13,0,RI,US,13,606
OUTLANDER 1000,2019-10-21,10,4,RI,US,14,637
OUTLANDER 850,2019-10-21,1,1,RI,US,2,609
OUTLANDER 450,2019-10-21,12,3,RI,US,15,621
OUTLANDER 1000,2019-10-28,8,3,RI,US,11,648
OUTLANDER 850,2019-10-28,6,8,RI,US,14,623
OUTLANDER 450,2019-10-28,2,6,RI,US,8,629
OUTLANDER 1000,2019-11-04,9,14,RI,US,23,671
OUTLANDER 850,2019-11-04,9,9,RI,US,18,641
OUTLANDER 450,2019-11-04,3,11,RI,US,14,643
OUTLANDER 1000,2019-11-11,11,4,RI,US,15,686
OUTLANDER 850,2019-11-11,3,3,RI,US,6,647
OUTLANDER 450,2019-11-11,10,10,RI,US,20,663
OUTLANDER 1000,2019-11-18,0,3,RI,US,3,689
OUTLANDER 850,2019-11-18,2,6,RI,US,8,655
OUTLANDER 450,2019-11-18,13,4,RI,US,17,680
OUTLANDER 1000,2019-11-25,12,4,RI,US,16,705
OUTLANDER 850,2019-11-25,2,13,RI,US,15,670
OUTLANDER 450,2019-11-25,4,1,RI,US,5,685
OUTLANDER 1000,2019-12-02,3,7,RI,US,10,715
OUTLANDER 850,2019-12-02,11,7,RI,US,18,688
OUTLANDER 450,2019-12-02,13,4,RI,US,17,702
OUTLANDER 1000,2019-12-09,13,4,RI,US,17,732
OUTLANDER 850,2019-12-09,14,7,RI,US,21,709
OUTLANDER 450,2019-12-09,10,9,RI,US,19,721
OUTLANDER 1000,2019-12-16,9,13,RI,US,22,754
OUTLANDER 850,2019-12-16,8,11,RI,US,19,728
OUTLANDER 450,2019-12-16,8,8,RI,US,16,737
OUTLANDER 1000,2019-12-23,7,7,RI,US,14,768
OUTLANDER 850,2019-12-23,4,9,RI,US,13,741
OUTLANDER 450,2019-12-23,3,4,RI,US,7,744
OUTLANDER 1000,2019-12-30,5,3,RI,US,8,776
OUTLANDER 850,2019-12-30,8,14,RI,US,22,763
OUTLANDER 450,2019-12-30,4,14,RI,US,18,762
OUTLANDER 1000,2020-01-06,2,0,RI,US,2,778
OUTLANDER 850,2020-01-06,4,10,RI,US,14,777
OUTLANDER 450,2020-01-06,2,6,RI,US,8,770
OUTLANDER 1000,2020-01-13,13,10,RI,US,23,801
OUTLANDER 850,2020-01-13,14,3,RI,US,17,794
OUTLANDER 450,2020-01-13,9,6,RI,US,15,785
OUTLANDER 1000,2020-01-20,6,5,RI,US,11,812
OUTLANDER 850,2020-01-20,6,6,RI,US,12,806
OUTLANDER 450,2020-01-20,5,11,RI,US,16,801
OUTLANDER 1000,2020-01-27,4,11,RI,US,15,827
OUTLANDER 850,2020-01-27,2,11,RI,US,13,819
OUTLANDER 450,2020-01-27,4,2,RI,US,6,807
OUTLANDER 1000,2020-02-03,8,8,RI,US,16,843
OUTLANDER 850,2020-02-03,9,14,RI,US,23,842
OUTLANDER 450,2020-02-03,2,7,RI,US,9,816
OUTLANDER 1000,2020-02-10,2,13,RI,US,15,858
OUTLANDER 850,2020-02-10,5,5,RI,US,10,852
OUTLANDER 450,2020-02-10,8,8,RI,US,16,832
OUTLANDER 1000,2020-02-17,5,15,RI,US,20,878
OUTLANDER 850,2020-02-17,12,9,RI,US,21,873
OUTLANDER 450,2020-02-17,6,5,RI,US,11,843
OUTLANDER 1000,2020-02-24,0,4,RI,US,4,882
OUTLANDER 850,2020-02-24,3,2,RI,US,5,878
OUTLANDER 450,2020-02-24,8,4,RI,US,12,855
OUTLANDER 1000,2020-03-02,2,2,RI,US,4,886
OUTLANDER 850,2020-03-02,11,1,RI,US,12,890
OUTLANDER 450,2020-03-02,13,7,RI,US,20,875
OUTLANDER 1000,2020-03-09,14,7,RI,US,21,907
OUTLANDER 850,2020-03-09,1,12,RI,US,13,903
OUTLANDER 450,2020-03-09,10,0,RI,US,10,885
OUTLANDER 1000,2020-03-16,3,2,RI,US,5,912
OUTLANDER 850,2020-03-16,5,11,RI,US,16,919
OUTLANDER 450,2020-03-16,12,11,RI,US,23,908
OUTLANDER 1000,2020-03-23,14,3,RI,US,17,929
OUTLANDER 850,2020-03-23,2,7,RI,US,9,928
OUTLANDER 450,2020-03-23,13,12,RI,US,25,933
OUTLANDER 1000,2020-03-30,5,2,RI,US,7,936
OUTLANDER 850,2020-03-30,4,10,RI,US,14,942
OUTLANDER 450,2020-03-30,6,10,RI,US,16,949
OUTLANDER 1000,2020-04-06,8,13,RI,US,21,957
OUTLANDER 850,2020-04-06,7,1,RI,US,8,950
OUTLANDER 450,2020-04-06,7,1,RI,US,8,957
OUTLANDER 1000,2020-04-13,10,14,RI,US,24,981
OUTLANDER 850,2020-04-13,9,8,RI,US,17,967
OUTLANDER 450,2020-04-13,7,10,RI,US,17,974
OUTLANDER 1000,2020-04-20,5,0,RI,US,5,986
OUTLANDER 850,2020-04-20,0,9,RI,US,9,976
OUTLANDER 450,2020-04-20,14,4,RI,US,18,992
OUTLANDER 1000,2020-04-27,2,5,RI,US,7,993
OUTLANDER 850,2020-04-27,10,12,RI,US,22,998
OUTLANDER 450,2020-04-27,8,10,RI,US,18,1010
OUTLANDER 1000,2020-05-04,3,10,RI,US,13,1006
OUTLANDER 850,2020-05-04,1,2,RI,US,3,1001
OUTLANDER 450,2020-05-04,10,12,RI,US,22,1032
OUTLANDER 1000,2020-05-11,11,6,RI,US,17,1023
OUTLANDER 850,2020-05-11,12,1,RI,US,13,1014
OUTLANDER 450,2020-05-11,0,3,RI,US,3,1035
OUTLANDER 1000,2020-05-18,3,11,RI,US,14,1037
OUTLANDER 850,2020-05-18,9,7,RI,US,16,1030
OUTLANDER 450,2020-05-18,6,14,RI,US,20,1055
OUTLANDER 1000,2020-05-25,10,1,RI,US,11,1048
OUTLANDER 850,2020-05-25,9,0,RI,US,9,1039
OUTLANDER 450,2020-05-25,8,13,RI,US,21,1076
OUTLANDER 1000,2020-06-01,2,3,RI,US,5,1053
OUTLANDER 850,2020-06-01,1,3,RI,US,4,1043
OUTLANDER 450,2020-06-01,8,6,RI,US,14,1090
OUTLANDER 1000,2020-06-08,2,12,RI,US,14,1067
OUTLANDER 850,2020-06-08,9,6,RI,US,15,1058
OUTLANDER 450,2020-06-08,5,9,RI,US,14,1104
OUTLANDER 1000,2020-06-15,6,2,RI,US,8,1075
OUTLANDER 850,2020-06-15,15,7,RI,US,22,1080
OUTLANDER 450,2020-06-15,1,10,RI,US,11,1115
OUTLANDER 1000,2020-06-22,9,12,RI,US,21,1096
OUTLANDER 850,2020-06-22,2,2,RI,US,4,1084
OUTLANDER 450,2020-06-22,7,10,RI,US,17,1132
OUTLANDER 1000,2020-06-29,4,15,RI,US,19,1115
OUTLANDER 850,2020-06-29,15,13,RI,US,28,1112
OUTLANDER 450,2020-06-29,5,3,RI,US,8,1140
OUTLANDER 1000,2020-07-06,14,1,RI,US,15,1130
OUTLANDER 850,2020-07-06,14,13,RI,US,27,1139
OUTLANDER 450,2020-07-06,10,13,RI,US,23,1163
OUTLANDER 1000,2020-07-13,9,2,RI,US,11,1141
OUTLANDER 850,2020-07-13,9,6,RI,US,15,1154
OUTLANDER 450,2020-07-13,8,14,RI,US,22,1185
OUTLANDER 1000,2020-07-20,4,6,RI,US,10,1151
OUTLANDER 850,2020-07-20,13,2,RI,US,15,1169
OUTLANDER 450,2020-07-20,13,12,RI,US,25,1210
OUTLANDER 1000,2020-07-27,3,7,RI,US,10,1161
OUTLANDER 850,2020-07-27,5,9,RI,US,14,1183
OUTLANDER 450,2020-07-27,7,2,RI,US,9,1219
OUTLANDER 1000,2020-08-03,3,4,RI,US,7,1168
OUTLANDER 850,2020-08-03,2,0,RI,US,2,1185
OUTLANDER 450,2020-08-03,1,8,RI,US,9,1228
OUTLANDER 1000,2020-08-10,15,9,RI,US,24,1192
OUTLANDER 850,2020-08-10,14,10,RI,US,24,1209
OUTLANDER 450,2020-08-10,14,3,RI,US,17,1245
OUTLANDER 1000,2020-08-17,9,1,RI,US,10,1202
OUTLANDER 850,2020-08-17,6,6,RI,US,12,1221
OUTLANDER 450,2020-08-17,10,6,RI,US,16,1261
OUTLANDER 1000,2020-08-24,7,2,RI,US,9,1211
OUTLANDER 850,2020-08-24,0,8,RI,US,8,1229
OUTLANDER 450,2020-08-24,7,4,RI,US,11,1272
OUTLANDER 1000,2020-08-31,2,15,RI,US,17,1228
OUTLANDER 850,2020-08-31,1,11,RI,US,12,1241
OUTLANDER 450,2020-08-31,10,14,RI,US,24,1296
OUTLANDER 1000,2020-09-07,13,4,RI,US,17,1245
OUTLANDER 850,2020-09-07,4,7,RI,US,11,1252
OUTLANDER 450,2020-09-07,9,7,RI,US,16,1312
OUTLANDER 1000,2020-09-14,6,11,RI,US,17,1262
OUTLANDER 850,2020-09-14,13,4,RI,US,17,1269
OUTLANDER 450,2020-09-14,4,10,RI,US,14,1326
OUTLANDER 1000,2020-09-21,4,2,RI,US,6,1268
OUTLANDER 850,2020-09-21,13,13,RI,US,26,1295
OUTLANDER 450,2020-09-21,0,5,RI,US,5,1331
OUTLANDER 1000,2020-09-28,11,12,RI,US,23,1291
OUTLANDER 850,2020-09-28,4,12,RI,US,16,1311
OUTLANDER 450,2020-09-28,2,2,RI,US,4,1335
OUTLANDER 1000,2020-10-05,6,13,RI,US,19,1310
OUTLANDER 850,2020-10-05,8,10,RI,US,18,1329
OUTLANDER 450,2020-10-05,9,14,RI,US,23,1358
OUTLANDER 1000,2020-10-12,15,14,RI,US,29,1339
OUTLANDER 850,2020-10-12,10,5,RI,US,15,1344
OUTLANDER 450,2020-10-12,3,1,RI,US,4,1362
OUTLANDER 1000,2020-10-19,6,10,RI,US,16,1355
OUTLANDER 850,2020-10-19,3,12,RI,US,15,1359
OUTLANDER 450,2020-10-19,11,3,RI,US,14,1376
OUTLANDER 1000,2020-10-26,3,9,RI,US,12,1367
OUTLANDER 850,2020-10-26,8,2,RI,US,10,1369
OUTLANDER 450,2020-10-26,6,5,RI,US,11,1387
OUTLANDER 1000,2020-11-02,14,1,RI,US,15,1382
OUTLANDER 850,2020-11-02,0,12,RI,US,12,1381
OUTLANDER 450,2020-11-02,15,13,RI,US,28,1415
OUTLANDER 1000,2020-11-09,14,5,RI,US,19,1401
OUTLANDER 850,2020-11-09,12,5,RI,US,17,1398
OUTLANDER 450,2020-11-09,12,9,RI,US,21,1436
OUTLANDER 1000,2020-11-16,5,11,RI,US,16,1417
OUTLANDER 850,2020-11-16,1,2,RI,US,3,1401
OUTLANDER 450,2020-11-16,10,7,RI,US,17,1453
OUTLANDER 1000,2020-11-23,1,8,RI,US,9,1426
OUTLANDER 850,2020-11-23,10,15,RI,US,25,1426
OUTLANDER 450,2020-11-23,4,0,RI,US,4,1457
OUTLANDER 1000,2020-11-30,8,15,RI,US,23,1449
OUTLANDER 850,2020-11-30,13,11,RI,US,24,1450
OUTLANDER 450,2020-11-30,1,15,RI,US,16,1473
OUTLANDER 1000,2020-12-07,14,15,RI,US,29,1478
OUTLANDER 850,2020-12-07,4,1,RI,US,5,1455
OUTLANDER 450,2020-12-07,9,11,RI,US,20,1493
OUTLANDER 1000,2020-12-14,9,6,RI,US,15,1493
OUTLANDER 850,2020-12-14,10,9,RI,US,19,1474
OUTLANDER 450,2020-12-14,11,1,RI,US,12,1505
OUTLANDER 1000,2020-12-21,2,14,RI,US,16,1509
OUTLANDER 850,2020-12-21,1,6,RI,US,7,1481
OUTLANDER 450,2020-12-21,7,14,RI,US,21,1526
OUTLANDER 1000,2020-12-28,8,5,RI,US,13,1522
OUTLANDER 850,2020-12-28,8,2,RI,US,10,1491
OUTLANDER 450,2020-12-28,12,10,RI,US,22,1548
OUTLANDER 1000,2021-01-04,10,4,RI,US,14,1536
OUTLANDER 850,2021-01-04,4,2,RI,US,6,1497
OUTLANDER 450,2021-01-04,2,7,RI,US,9,1557
OUTLANDER 1000,2021-01-11,3,1,RI,US,4,1540
OUTLANDER 850,2021-01-11,2,8,RI,US,10,1507
OUTLANDER 450,2021-01-11,14,10,RI,US,24,1581
OUTLANDER 1000,2021-01-18,11,3,RI,US,14,1554
OUTLANDER 850,2021-01-18,6,6,RI,US,12,1519
OUTLANDER 450,2021-01-18,5,12,RI,US,17,1598
OUTLANDER 1000,2021-01-25,11,15,RI,US,26,1580
OUTLANDER 850,2021-01-25,5,7,RI,US,12,1531
OUTLANDER 450,2021-01-25,6,6,RI,US,12,1610
OUTLANDER 1000,2021-02-01,13,6,RI,US,19,1599
OUTLANDER 850,2021-02-01,9,15,RI,US,24,1555
OUTLANDER 450,2021-02-01,8,13,RI,US,21,1631
OUTLANDER 1000,2021-02-08,13,5,RI,US,18,1617
OUTLANDER 850,2021-02-08,4,12,RI,US,16,1571
OUTLANDER 450,2021-02-08,13,4,RI,US,17,1648
OUTLANDER 1000,2021-02-15,3,11,RI,US,14,1631
OUTLANDER 850,2021-02-15,6,10,RI,US,16,1587
OUTLANDER 450,2021-02-15,4,14,RI,US,18,1666
OUTLANDER 1000,2021-02-22,8,10,RI,US,18,1649
OUTLANDER 850,2021-02-22,8,11,RI,US,19,1606
OUTLANDER 450,2021-02-22,13,0,RI,US,13,1679
OUTLANDER 1000,2021-03-01,1,14,RI,US,15,1664
OUTLANDER 850,2021-03-01,8,15,RI,US,23,1629
OUTLANDER 450,2021-03-01,3,12,RI,US,15,1694
OUTLANDER 1000,2021-03-08,10,5,RI,US,15,1679
OUTLANDER 850,2021-03-08,5,5,RI,US,10,1639
OUTLANDER 450,2021-03-08,4,7,RI,US,11,1705
OUTLANDER 1000,2021-03-15,12,11,RI,US,23,1702
OUTLANDER 850,2021-03-15,3,4,RI,US,7,1646
OUTLANDER 450,2021-03-15,7,4,RI,US,11,1716
OUTLANDER 1000,2021-03-22,0,10,RI,US,10,1712
OUTLANDER 850,2021-03-22,1,1,RI,US,2,1648
OUTLANDER 450,2021-03-22,12,10,RI,US,22,1738
OUTLANDER 1000,2021-03-29,14,14,RI,US,28,1740
OUTLANDER 850,2021-03-29,5,11,RI,US,16,1664
OUTLANDER 450,2021-03-29,15,9,RI,US,24,1762
OUTLANDER 1000,2021-04-05,2,2,RI,US,4,1744
OUTLANDER 850,2021-04-05,10,2,RI,US,12,1676
OUTLANDER 450,2021-04-05,8,2,RI,US,10,1772
OUTLANDER 1000,2021-04-12,0,0,RI,US,0,1744
OUTLANDER 850,2021-04-12,7,2,RI,US,9,1685
OUTLANDER 450,2021-04-12,7,12,RI,US,19,1791
OUTLANDER 1000,2021-04-19,14,8,RI,US,22,1766
OUTLANDER 850,2021-04-19,11,4,RI,US,15,1700
OUTLANDER 450,2021-04-19,7,14,RI,US,21,1812
OUTLANDER 1000,2021-04-26,8,14,RI,US,22,1788
OUTLANDER 850,2021-04-26,12,2,RI,US,14,1714
OUTLANDER 450,2021-04-26,1,7,RI,US,8,1820
OUTLANDER 1000,2021-05-03,11,5,RI,US,16,1804
OUTLANDER 850,2021-05-03,14,14,RI,US,28,1742
OUTLANDER 450,2021-05-03,11,5,RI,US,16,1836
OUTLANDER 1000,2021-05-10,3,6,RI,US,9,1813
OUTLANDER 850,2021-05-10,11,2,RI,US,13,1755
OUTLANDER 450,2021-05-10,15,6,RI,US,21,1857
OUTLANDER 1000,2021-05-17,10,12,RI,US,22,1835
OUTLANDER 850,2021-05-17,5,6,RI,US,11,1766
OUTLANDER 450,2021-05-17,15,12,RI,US,27,1884
OUTLANDER 1000,2021-05-24,4,5,RI,US,9,1844
OUTLANDER 850,2021-05-24,10,7,RI,US,17,1783
OUTLANDER 450,2021-05-24,9,0,RI,US,9,1893
OUTLANDER 1000,2021-05-31,10,3,RI,US,13,1857
OUTLANDER 850,2021-05-31,13,15,RI,US,28,1811
OUTLANDER 450,2021-05-31,14,7,RI,US,21,1914
OUTLANDER 1000,2021-06-07,3,3,RI,US,6,1863
OUTLANDER 850,2021-06-07,1,4,RI,US,5,1816
OUTLANDER 450,2021-06-07,15,12,RI,US,27,1941
OUTLANDER 1000,2021-06-14,14,4,RI,US,18,1881
OUTLANDER 850,2021-06-14,12,13,RI,US,25,1841
OUTLANDER 450,2021-06-14,9,4,RI,US,13,1954
OUTLANDER 1000,2021-06-21,8,11,RI,US,19,1900
OUTLANDER 850,2021-06-21,8,10,RI,US,18,1859
OUTLANDER 450,2021-06-21,1,6,RI,US,7,1961
OUTLANDER 1000,2021-06-28,14,14,RI,US,28,1928
OUTLANDER 850,2021-06-28,8,9,RI,US,17,1876
OUTLANDER 450,2021-06-28,15,3,RI,US,18,1979
OUTLANDER 1000,2021-07-05,2,1,RI,US,3,1931
OUTLANDER 850,2021-07-05,3,13,RI,US,16,1892
OUTLANDER 450,2021-07-05,4,3,RI,US,7,1986
OUTLANDER 1000,2021-07-12,12,14,RI,US,26,1957
OUTLANDER 850,2021-07-12,9,5,RI,US,14,1906
OUTLANDER 450,2021-07-12,1,2,RI,US,3,1989
OUTLANDER 1000,2021-07-19,2,11,RI,US,13,1970
OUTLANDER 850,2021-07-19,2,8,RI,US,10,1916
OUTLANDER 450,2021-07-19,5,14,RI,US,19,2008
OUTLANDER 1000,2021-07-26,7,1,RI,US,8,1978
OUTLANDER 850,2021-07-26,14,1,RI,US,15,1931
OUTLANDER 450,2021-07-26,2,1,RI,US,3,2011
OUTLANDER 1000,2021-08-02,8,14,RI,US,22,2000
OUTLANDER 850,2021-08-02,7,7,RI,US,14,1945
OUTLANDER 450,2021-08-02,10,2,RI,US,12,2023
OUTLANDER 1000,2021-08-09,9,5,RI,US,14,2014
OUTLANDER 850,2021-08-09,1,1,RI,US,2,1947
OUTLANDER 450,2021-08-09,8,15,RI,US,23,2046
OUTLANDER 1000,2021-08-16,10,3,RI,US,13,2027
OUTLANDER 850,2021-08-16,3,6,RI,US,9,1956
OUTLANDER 450,2021-08-16,9,2,RI,US,11,2057
OUTLANDER 1000,2021-08-23,8,7,RI,US,15,2042
OUTLANDER 850,2021-08-23,2,5,RI,US,7,1963
OUTLANDER 450,2021-08-23,9,6,RI,US,15,2072
OUTLANDER 1000,2021-08-30,5,9,RI,US,14,2056
OUTLANDER 850,2021-08-30,11,5,RI,US,16,1979
OUTLANDER 450,2021-08-30,3,12,RI,US,15,2087
OUTLANDER 1000,2021-09-06,11,9,RI,US,20,2076
OUTLANDER 850,2021-09-06,3,8,RI,US,11,1990
OUTLANDER 450,2021-09-06,1,12,RI,US,13,2100
OUTLANDER 1000,2021-09-13,12,3,RI,US,15,2091
OUTLANDER 850,2021-09-13,0,5,RI,US,5,1995
OUTLANDER 450,2021-09-13,14,12,RI,US,26,2126
OUTLANDER 1000,2021-09-20,1,15,RI,US,16,2107
OUTLANDER 850,2021-09-20,11,1,RI,US,12,2007
OUTLANDER 450,2021-09-20,7,2,RI,US,9,2135
OUTLANDER 1000,2021-09-27,1,13,RI,US,14,2121
OUTLANDER 850,2021-09-27,5,11,RI,US,16,2023
OUTLANDER 450,2021-09-27,8,13,RI,US,21,2156
OUTLANDER 1000,2021-10-04,6,1,RI,US,7,2128
OUTLANDER 850,2021-10-04,3,9,RI,US,12,2035
OUTLANDER 450,2021-10-04,12,7,RI,US,19,2175
OUTLANDER 1000,2021-10-11,3,4,RI,US,7,2135
OUTLANDER 850,2021-10-11,5,0,RI,US,5,2040
OUTLANDER 450,2021-10-11,1,13,RI,US,14,2189
OUTLANDER 1000,2021-10-18,3,6,RI,US,9,2144
OUTLANDER 850,2021-10-18,11,6,RI,US,17,2057
OUTLANDER 450,2021-10-18,8,0,RI,US,8,2197
OUTLANDER 1000,2021-10-25,14,2,RI,US,16,2160
OUTLANDER 850,2021-10-25,6,14,RI,US,20,2077
OUTLANDER 450,2021-10-25,5,6,RI,US,11,2208
OUTLANDER 1000,2021-11-01,6,13,RI,US,19,2179
OUTLANDER 850,2021-11-01,9,6,RI,US,15,2092
OUTLANDER 450,2021-11-01,3,12,RI,US,15,2223
OUTLANDER 1000,2021-11-08,8,6,RI,US,14,2193
OUTLANDER 850,2021-11-08,3,13,RI,US,16,2108
OUTLANDER 450,2021-11-08,2,13,RI,US,15,2238
OUTLANDER 1000,2021-11-15,11,5,RI,US,16,2209
OUTLANDER 850,2021-11-15,3,13,RI,US,16,2124
OUTLANDER 450,2021-11-15,14,5,RI,US,19,2257
OUTLANDER 1000,2021-11-22,0,8,RI,US,8,2217
OUTLANDER 850,2021-11-22,11,11,RI,US,22,2146
OUTLANDER 450,2021-11-22,0,4,RI,US,4,2261
OUTLANDER 1000,2021-11-29,8,14,RI,US,22,2239
OUTLANDER 850,2021-11-29,3,14,RI,US,17,2163
OUTLANDER 450,2021-11-29,13,3,RI,US,16,2277
OUTLANDER 1000,2021-12-06,7,14,RI,US,21,2260
OUTLANDER 850,2021-12-06,3,14,RI,US,17,2180
OUTLANDER 450,2021-12-06,14,2,RI,US,16,2293
OUTLANDER 1000,2021-12-13,7,7,RI,US,14,2274
OUTLANDER 850,2021-12-13,9,8,RI,US,17,2197
OUTLANDER 450,2021-12-13,11,2,RI,US,13,2306
OUTLANDER 1000,2021-12-20,11,9,RI,US,20,2294
OUTLANDER 850,2021-12-20,15,14,RI,US,29,2226
OUTLANDER 450,2021-12-20,11,8,RI,US,19,2325
OUTLANDER 1000,2021-12-27,12,8,RI,US,20,2314
OUTLANDER 850,2021-12-27,4,7,RI,US,11,2237
OUTLANDER 450,2021-12-27,11,0,RI,US,11,2336
OUTLANDER 1000,2019-01-07,13,6,SC,US,19,19
OUTLANDER 850,2019-01-07,9,11,SC,US,20,20
OUTLANDER 450,2019-01-07,3,9,SC,US,12,12
OUTLANDER 1000,2019-01-14,6,12,SC,US,18,37
OUTLANDER 850,2019-01-14,4,6,SC,US,10,30
OUTLANDER 450,2019-01-14,9,1,SC,US,10,22
OUTLANDER 1000,2019-01-21,3,5,SC,US,8,45
OUTLANDER 850,2019-01-21,8,1,SC,US,9,39
OUTLANDER 450,2019-01-21,7,3,SC,US,10,32
OUTLANDER 1000,2019-01-28,9,11,SC,US,20,65
OUTLANDER 850,2019-01-28,2,10,SC,US,12,51
OUTLANDER 450,2019-01-28,14,8,SC,US,22,54
OUTLANDER 1000,2019-02-04,12,1,SC,US,13,78
OUTLANDER 850,2019-02-04,7,10,SC,US,17,68
OUTLANDER 450,2019-02-04,14,3,SC,US,17,71
OUTLANDER 1000,2019-02-11,10,5,SC,US,15,93
OUTLANDER 850,2019-02-11,13,7,SC,US,20,88
OUTLANDER 450,2019-02-11,14,9,SC,US,23,94
OUTLANDER 1000,2019-02-18,6,11,SC,US,17,110
OUTLANDER 850,2019-02-18,12,9,SC,US,21,109
OUTLANDER 450,2019-02-18,4,2,SC,US,6,100
OUTLANDER 1000,2019-02-25,2,7,SC,US,9,119
OUTLANDER 850,2019-02-25,5,9,SC,US,14,123
OUTLANDER 450,2019-02-25,8,4,SC,US,12,112
OUTLANDER 1000,2019-03-04,0,7,SC,US,7,126
OUTLANDER 850,2019-03-04,13,10,SC,US,23,146
OUTLANDER 450,2019-03-04,11,13,SC,US,24,136
OUTLANDER 1000,2019-03-11,12,10,SC,US,22,148
OUTLANDER 850,2019-03-11,11,0,SC,US,11,157
OUTLANDER 450,2019-03-11,14,12,SC,US,26,162
OUTLANDER 1000,2019-03-18,9,4,SC,US,13,161
OUTLANDER 850,2019-03-18,5,2,SC,US,7,164
OUTLANDER 450,2019-03-18,14,14,SC,US,28,190
OUTLANDER 1000,2019-03-25,8,0,SC,US,8,169
OUTLANDER 850,2019-03-25,11,14,SC,US,25,189
OUTLANDER 450,2019-03-25,11,14,SC,US,25,215
OUTLANDER 1000,2019-04-01,4,13,SC,US,17,186
OUTLANDER 850,2019-04-01,13,9,SC,US,22,211
OUTLANDER 450,2019-04-01,3,12,SC,US,15,230
OUTLANDER 1000,2019-04-08,14,7,SC,US,21,207
OUTLANDER 850,2019-04-08,14,6,SC,US,20,231
OUTLANDER 450,2019-04-08,4,8,SC,US,12,242
OUTLANDER 1000,2019-04-15,7,6,SC,US,13,220
OUTLANDER 850,2019-04-15,2,11,SC,US,13,244
OUTLANDER 450,2019-04-15,10,8,SC,US,18,260
OUTLANDER 1000,2019-04-22,10,11,SC,US,21,241
OUTLANDER 850,2019-04-22,11,7,SC,US,18,262
OUTLANDER 450,2019-04-22,9,1,SC,US,10,270
OUTLANDER 1000,2019-04-29,1,8,SC,US,9,250
OUTLANDER 850,2019-04-29,9,12,SC,US,21,283
OUTLANDER 450,2019-04-29,9,8,SC,US,17,287
OUTLANDER 1000,2019-05-06,5,7,SC,US,12,262
OUTLANDER 850,2019-05-06,4,12,SC,US,16,299
OUTLANDER 450,2019-05-06,8,4,SC,US,12,299
OUTLANDER 1000,2019-05-13,0,12,SC,US,12,274
OUTLANDER 850,2019-05-13,13,7,SC,US,20,319
OUTLANDER 450,2019-05-13,0,6,SC,US,6,305
OUTLANDER 1000,2019-05-20,12,3,SC,US,15,289
OUTLANDER 850,2019-05-20,2,3,SC,US,5,324
OUTLANDER 450,2019-05-20,7,12,SC,US,19,324
OUTLANDER 1000,2019-05-27,1,14,SC,US,15,304
OUTLANDER 850,2019-05-27,13,7,SC,US,20,344
OUTLANDER 450,2019-05-27,5,4,SC,US,9,333
OUTLANDER 1000,2019-06-03,6,9,SC,US,15,319
OUTLANDER 850,2019-06-03,14,3,SC,US,17,361
OUTLANDER 450,2019-06-03,14,11,SC,US,25,358
OUTLANDER 1000,2019-06-10,11,2,SC,US,13,332
OUTLANDER 850,2019-06-10,11,12,SC,US,23,384
OUTLANDER 450,2019-06-10,3,10,SC,US,13,371
OUTLANDER 1000,2019-06-17,13,7,SC,US,20,352
OUTLANDER 850,2019-06-17,12,9,SC,US,21,405
OUTLANDER 450,2019-06-17,6,15,SC,US,21,392
OUTLANDER 1000,2019-06-24,5,10,SC,US,15,367
OUTLANDER 850,2019-06-24,5,14,SC,US,19,424
OUTLANDER 450,2019-06-24,12,6,SC,US,18,410
OUTLANDER 1000,2019-07-01,8,6,SC,US,14,381
OUTLANDER 850,2019-07-01,2,10,SC,US,12,436
OUTLANDER 450,2019-07-01,5,9,SC,US,14,424
OUTLANDER 1000,2019-07-08,12,5,SC,US,17,398
OUTLANDER 850,2019-07-08,11,14,SC,US,25,461
OUTLANDER 450,2019-07-08,2,10,SC,US,12,436
OUTLANDER 1000,2019-07-15,7,10,SC,US,17,415
OUTLANDER 850,2019-07-15,4,9,SC,US,13,474
OUTLANDER 450,2019-07-15,12,11,SC,US,23,459
OUTLANDER 1000,2019-07-22,4,12,SC,US,16,431
OUTLANDER 850,2019-07-22,1,6,SC,US,7,481
OUTLANDER 450,2019-07-22,2,4,SC,US,6,465
OUTLANDER 1000,2019-07-29,3,1,SC,US,4,435
OUTLANDER 850,2019-07-29,11,1,SC,US,12,493
OUTLANDER 450,2019-07-29,6,7,SC,US,13,478
OUTLANDER 1000,2019-08-05,6,7,SC,US,13,448
OUTLANDER 850,2019-08-05,13,13,SC,US,26,519
OUTLANDER 450,2019-08-05,14,5,SC,US,19,497
OUTLANDER 1000,2019-08-12,12,13,SC,US,25,473
OUTLANDER 850,2019-08-12,4,9,SC,US,13,532
OUTLANDER 450,2019-08-12,5,6,SC,US,11,508
OUTLANDER 1000,2019-08-19,3,11,SC,US,14,487
OUTLANDER 850,2019-08-19,12,7,SC,US,19,551
OUTLANDER 450,2019-08-19,4,5,SC,US,9,517
OUTLANDER 1000,2019-08-26,11,10,SC,US,21,508
OUTLANDER 850,2019-08-26,5,7,SC,US,12,563
OUTLANDER 450,2019-08-26,14,7,SC,US,21,538
OUTLANDER 1000,2019-09-02,2,2,SC,US,4,512
OUTLANDER 850,2019-09-02,0,11,SC,US,11,574
OUTLANDER 450,2019-09-02,3,9,SC,US,12,550
OUTLANDER 1000,2019-09-09,5,4,SC,US,9,521
OUTLANDER 850,2019-09-09,6,8,SC,US,14,588
OUTLANDER 450,2019-09-09,3,9,SC,US,12,562
OUTLANDER 1000,2019-09-16,11,8,SC,US,19,540
OUTLANDER 850,2019-09-16,14,3,SC,US,17,605
OUTLANDER 450,2019-09-16,14,8,SC,US,22,584
OUTLANDER 1000,2019-09-23,3,2,SC,US,5,545
OUTLANDER 850,2019-09-23,15,11,SC,US,26,631
OUTLANDER 450,2019-09-23,9,11,SC,US,20,604
OUTLANDER 1000,2019-09-30,1,3,SC,US,4,549
OUTLANDER 850,2019-09-30,5,2,SC,US,7,638
OUTLANDER 450,2019-09-30,3,9,SC,US,12,616
OUTLANDER 1000,2019-10-07,2,3,SC,US,5,554
OUTLANDER 850,2019-10-07,11,10,SC,US,21,659
OUTLANDER 450,2019-10-07,14,7,SC,US,21,637
OUTLANDER 1000,2019-10-14,4,3,SC,US,7,561
OUTLANDER 850,2019-10-14,9,4,SC,US,13,672
OUTLANDER 450,2019-10-14,13,12,SC,US,25,662
OUTLANDER 1000,2019-10-21,7,5,SC,US,12,573
OUTLANDER 850,2019-10-21,7,6,SC,US,13,685
OUTLANDER 450,2019-10-21,12,4,SC,US,16,678
OUTLANDER 1000,2019-10-28,10,12,SC,US,22,595
OUTLANDER 850,2019-10-28,12,13,SC,US,25,710
OUTLANDER 450,2019-10-28,10,13,SC,US,23,701
OUTLANDER 1000,2019-11-04,1,7,SC,US,8,603
OUTLANDER 850,2019-11-04,9,14,SC,US,23,733
OUTLANDER 450,2019-11-04,9,8,SC,US,17,718
OUTLANDER 1000,2019-11-11,5,7,SC,US,12,615
OUTLANDER 850,2019-11-11,3,8,SC,US,11,744
OUTLANDER 450,2019-11-11,10,5,SC,US,15,733
OUTLANDER 1000,2019-11-18,9,9,SC,US,18,633
OUTLANDER 850,2019-11-18,13,11,SC,US,24,768
OUTLANDER 450,2019-11-18,13,4,SC,US,17,750
OUTLANDER 1000,2019-11-25,7,13,SC,US,20,653
OUTLANDER 850,2019-11-25,8,7,SC,US,15,783
OUTLANDER 450,2019-11-25,13,14,SC,US,27,777
OUTLANDER 1000,2019-12-02,14,8,SC,US,22,675
OUTLANDER 850,2019-12-02,5,1,SC,US,6,789
OUTLANDER 450,2019-12-02,5,11,SC,US,16,793
OUTLANDER 1000,2019-12-09,8,2,SC,US,10,685
OUTLANDER 850,2019-12-09,4,10,SC,US,14,803
OUTLANDER 450,2019-12-09,1,15,SC,US,16,809
OUTLANDER 1000,2019-12-16,13,14,SC,US,27,712
OUTLANDER 850,2019-12-16,10,11,SC,US,21,824
OUTLANDER 450,2019-12-16,14,6,SC,US,20,829
OUTLANDER 1000,2019-12-23,7,4,SC,US,11,723
OUTLANDER 850,2019-12-23,13,7,SC,US,20,844
OUTLANDER 450,2019-12-23,9,10,SC,US,19,848
OUTLANDER 1000,2019-12-30,4,13,SC,US,17,740
OUTLANDER 850,2019-12-30,4,11,SC,US,15,859
OUTLANDER 450,2019-12-30,3,11,SC,US,14,862
OUTLANDER 1000,2020-01-06,8,5,SC,US,13,753
OUTLANDER 850,2020-01-06,6,5,SC,US,11,870
OUTLANDER 450,2020-01-06,3,4,SC,US,7,869
OUTLANDER 1000,2020-01-13,3,0,SC,US,3,756
OUTLANDER 850,2020-01-13,6,3,SC,US,9,879
OUTLANDER 450,2020-01-13,10,9,SC,US,19,888
OUTLANDER 1000,2020-01-20,6,4,SC,US,10,766
OUTLANDER 850,2020-01-20,14,5,SC,US,19,898
OUTLANDER 450,2020-01-20,3,15,SC,US,18,906
OUTLANDER 1000,2020-01-27,10,13,SC,US,23,789
OUTLANDER 850,2020-01-27,14,13,SC,US,27,925
OUTLANDER 450,2020-01-27,14,0,SC,US,14,920
OUTLANDER 1000,2020-02-03,1,6,SC,US,7,796
OUTLANDER 850,2020-02-03,3,11,SC,US,14,939
OUTLANDER 450,2020-02-03,0,9,SC,US,9,929
OUTLANDER 1000,2020-02-10,6,4,SC,US,10,806
OUTLANDER 850,2020-02-10,13,8,SC,US,21,960
OUTLANDER 450,2020-02-10,6,12,SC,US,18,947
OUTLANDER 1000,2020-02-17,3,1,SC,US,4,810
OUTLANDER 850,2020-02-17,7,8,SC,US,15,975
OUTLANDER 450,2020-02-17,9,14,SC,US,23,970
OUTLANDER 1000,2020-02-24,2,14,SC,US,16,826
OUTLANDER 850,2020-02-24,9,2,SC,US,11,986
OUTLANDER 450,2020-02-24,12,4,SC,US,16,986
OUTLANDER 1000,2020-03-02,8,6,SC,US,14,840
OUTLANDER 850,2020-03-02,10,2,SC,US,12,998
OUTLANDER 450,2020-03-02,12,12,SC,US,24,1010
OUTLANDER 1000,2020-03-09,6,3,SC,US,9,849
OUTLANDER 850,2020-03-09,14,6,SC,US,20,1018
OUTLANDER 450,2020-03-09,3,11,SC,US,14,1024
OUTLANDER 1000,2020-03-16,13,1,SC,US,14,863
OUTLANDER 850,2020-03-16,7,11,SC,US,18,1036
OUTLANDER 450,2020-03-16,4,8,SC,US,12,1036
OUTLANDER 1000,2020-03-23,14,9,SC,US,23,886
OUTLANDER 850,2020-03-23,13,2,SC,US,15,1051
OUTLANDER 450,2020-03-23,9,10,SC,US,19,1055
OUTLANDER 1000,2020-03-30,2,6,SC,US,8,894
OUTLANDER 850,2020-03-30,5,12,SC,US,17,1068
OUTLANDER 450,2020-03-30,8,7,SC,US,15,1070
OUTLANDER 1000,2020-04-06,1,7,SC,US,8,902
OUTLANDER 850,2020-04-06,11,2,SC,US,13,1081
OUTLANDER 450,2020-04-06,12,7,SC,US,19,1089
OUTLANDER 1000,2020-04-13,4,12,SC,US,16,918
OUTLANDER 850,2020-04-13,12,8,SC,US,20,1101
OUTLANDER 450,2020-04-13,11,4,SC,US,15,1104
OUTLANDER 1000,2020-04-20,9,9,SC,US,18,936
OUTLANDER 850,2020-04-20,1,0,SC,US,1,1102
OUTLANDER 450,2020-04-20,4,12,SC,US,16,1120
OUTLANDER 1000,2020-04-27,2,5,SC,US,7,943
OUTLANDER 850,2020-04-27,2,8,SC,US,10,1112
OUTLANDER 450,2020-04-27,7,4,SC,US,11,1131
OUTLANDER 1000,2020-05-04,5,7,SC,US,12,955
OUTLANDER 850,2020-05-04,1,7,SC,US,8,1120
OUTLANDER 450,2020-05-04,15,9,SC,US,24,1155
OUTLANDER 1000,2020-05-11,15,15,SC,US,30,985
OUTLANDER 850,2020-05-11,10,13,SC,US,23,1143
OUTLANDER 450,2020-05-11,8,3,SC,US,11,1166
OUTLANDER 1000,2020-05-18,7,11,SC,US,18,1003
OUTLANDER 850,2020-05-18,6,7,SC,US,13,1156
OUTLANDER 450,2020-05-18,5,10,SC,US,15,1181
OUTLANDER 1000,2020-05-25,3,5,SC,US,8,1011
OUTLANDER 850,2020-05-25,2,11,SC,US,13,1169
OUTLANDER 450,2020-05-25,2,7,SC,US,9,1190
OUTLANDER 1000,2020-06-01,7,14,SC,US,21,1032
OUTLANDER 850,2020-06-01,7,0,SC,US,7,1176
OUTLANDER 450,2020-06-01,11,5,SC,US,16,1206
OUTLANDER 1000,2020-06-08,9,8,SC,US,17,1049
OUTLANDER 850,2020-06-08,0,7,SC,US,7,1183
OUTLANDER 450,2020-06-08,15,0,SC,US,15,1221
OUTLANDER 1000,2020-06-15,7,6,SC,US,13,1062
OUTLANDER 850,2020-06-15,0,9,SC,US,9,1192
OUTLANDER 450,2020-06-15,14,5,SC,US,19,1240
OUTLANDER 1000,2020-06-22,2,1,SC,US,3,1065
OUTLANDER 850,2020-06-22,12,5,SC,US,17,1209
OUTLANDER 450,2020-06-22,13,15,SC,US,28,1268
OUTLANDER 1000,2020-06-29,8,4,SC,US,12,1077
OUTLANDER 850,2020-06-29,9,3,SC,US,12,1221
OUTLANDER 450,2020-06-29,2,10,SC,US,12,1280
OUTLANDER 1000,2020-07-06,12,2,SC,US,14,1091
OUTLANDER 850,2020-07-06,4,2,SC,US,6,1227
OUTLANDER 450,2020-07-06,12,13,SC,US,25,1305
OUTLANDER 1000,2020-07-13,7,5,SC,US,12,1103
OUTLANDER 850,2020-07-13,3,3,SC,US,6,1233
OUTLANDER 450,2020-07-13,6,15,SC,US,21,1326
OUTLANDER 1000,2020-07-20,2,11,SC,US,13,1116
OUTLANDER 850,2020-07-20,9,4,SC,US,13,1246
OUTLANDER 450,2020-07-20,11,5,SC,US,16,1342
OUTLANDER 1000,2020-07-27,9,15,SC,US,24,1140
OUTLANDER 850,2020-07-27,3,1,SC,US,4,1250
OUTLANDER 450,2020-07-27,7,9,SC,US,16,1358
OUTLANDER 1000,2020-08-03,15,8,SC,US,23,1163
OUTLANDER 850,2020-08-03,10,10,SC,US,20,1270
OUTLANDER 450,2020-08-03,14,3,SC,US,17,1375
OUTLANDER 1000,2020-08-10,8,9,SC,US,17,1180
OUTLANDER 850,2020-08-10,6,10,SC,US,16,1286
OUTLANDER 450,2020-08-10,4,1,SC,US,5,1380
OUTLANDER 1000,2020-08-17,2,14,SC,US,16,1196
OUTLANDER 850,2020-08-17,3,5,SC,US,8,1294
OUTLANDER 450,2020-08-17,12,7,SC,US,19,1399
OUTLANDER 1000,2020-08-24,9,12,SC,US,21,1217
OUTLANDER 850,2020-08-24,12,10,SC,US,22,1316
OUTLANDER 450,2020-08-24,10,1,SC,US,11,1410
OUTLANDER 1000,2020-08-31,9,9,SC,US,18,1235
OUTLANDER 850,2020-08-31,15,11,SC,US,26,1342
OUTLANDER 450,2020-08-31,3,13,SC,US,16,1426
OUTLANDER 1000,2020-09-07,11,8,SC,US,19,1254
OUTLANDER 850,2020-09-07,3,2,SC,US,5,1347
OUTLANDER 450,2020-09-07,11,14,SC,US,25,1451
OUTLANDER 1000,2020-09-14,11,4,SC,US,15,1269
OUTLANDER 850,2020-09-14,1,3,SC,US,4,1351
OUTLANDER 450,2020-09-14,13,13,SC,US,26,1477
OUTLANDER 1000,2020-09-21,15,5,SC,US,20,1289
OUTLANDER 850,2020-09-21,6,15,SC,US,21,1372
OUTLANDER 450,2020-09-21,11,14,SC,US,25,1502
OUTLANDER 1000,2020-09-28,8,14,SC,US,22,1311
OUTLANDER 850,2020-09-28,14,6,SC,US,20,1392
OUTLANDER 450,2020-09-28,4,14,SC,US,18,1520
OUTLANDER 1000,2020-10-05,2,12,SC,US,14,1325
OUTLANDER 850,2020-10-05,2,13,SC,US,15,1407
OUTLANDER 450,2020-10-05,9,14,SC,US,23,1543
OUTLANDER 1000,2020-10-12,12,8,SC,US,20,1345
OUTLANDER 850,2020-10-12,6,3,SC,US,9,1416
OUTLANDER 450,2020-10-12,2,11,SC,US,13,1556
OUTLANDER 1000,2020-10-19,4,4,SC,US,8,1353
OUTLANDER 850,2020-10-19,12,10,SC,US,22,1438
OUTLANDER 450,2020-10-19,5,12,SC,US,17,1573
OUTLANDER 1000,2020-10-26,9,13,SC,US,22,1375
OUTLANDER 850,2020-10-26,14,13,SC,US,27,1465
OUTLANDER 450,2020-10-26,3,0,SC,US,3,1576
OUTLANDER 1000,2020-11-02,15,14,SC,US,29,1404
OUTLANDER 850,2020-11-02,12,12,SC,US,24,1489
OUTLANDER 450,2020-11-02,9,2,SC,US,11,1587
OUTLANDER 1000,2020-11-09,2,13,SC,US,15,1419
OUTLANDER 850,2020-11-09,9,10,SC,US,19,1508
OUTLANDER 450,2020-11-09,7,3,SC,US,10,1597
OUTLANDER 1000,2020-11-16,2,6,SC,US,8,1427
OUTLANDER 850,2020-11-16,5,12,SC,US,17,1525
OUTLANDER 450,2020-11-16,12,4,SC,US,16,1613
OUTLANDER 1000,2020-11-23,5,11,SC,US,16,1443
OUTLANDER 850,2020-11-23,3,1,SC,US,4,1529
OUTLANDER 450,2020-11-23,1,13,SC,US,14,1627
OUTLANDER 1000,2020-11-30,14,6,SC,US,20,1463
OUTLANDER 850,2020-11-30,13,13,SC,US,26,1555
OUTLANDER 450,2020-11-30,11,9,SC,US,20,1647
OUTLANDER 1000,2020-12-07,13,1,SC,US,14,1477
OUTLANDER 850,2020-12-07,6,7,SC,US,13,1568
OUTLANDER 450,2020-12-07,13,4,SC,US,17,1664
OUTLANDER 1000,2020-12-14,14,13,SC,US,27,1504
OUTLANDER 850,2020-12-14,11,14,SC,US,25,1593
OUTLANDER 450,2020-12-14,3,15,SC,US,18,1682
OUTLANDER 1000,2020-12-21,7,14,SC,US,21,1525
OUTLANDER 850,2020-12-21,13,9,SC,US,22,1615
OUTLANDER 450,2020-12-21,13,15,SC,US,28,1710
OUTLANDER 1000,2020-12-28,5,7,SC,US,12,1537
OUTLANDER 850,2020-12-28,15,13,SC,US,28,1643
OUTLANDER 450,2020-12-28,3,6,SC,US,9,1719
OUTLANDER 1000,2021-01-04,14,7,SC,US,21,1558
OUTLANDER 850,2021-01-04,14,6,SC,US,20,1663
OUTLANDER 450,2021-01-04,8,11,SC,US,19,1738
OUTLANDER 1000,2021-01-11,4,9,SC,US,13,1571
OUTLANDER 850,2021-01-11,4,13,SC,US,17,1680
OUTLANDER 450,2021-01-11,15,9,SC,US,24,1762
OUTLANDER 1000,2021-01-18,14,4,SC,US,18,1589
OUTLANDER 850,2021-01-18,7,8,SC,US,15,1695
OUTLANDER 450,2021-01-18,7,4,SC,US,11,1773
OUTLANDER 1000,2021-01-25,3,15,SC,US,18,1607
OUTLANDER 850,2021-01-25,2,2,SC,US,4,1699
OUTLANDER 450,2021-01-25,4,5,SC,US,9,1782
OUTLANDER 1000,2021-02-01,12,6,SC,US,18,1625
OUTLANDER 850,2021-02-01,11,12,SC,US,23,1722
OUTLANDER 450,2021-02-01,7,13,SC,US,20,1802
OUTLANDER 1000,2021-02-08,7,13,SC,US,20,1645
OUTLANDER 850,2021-02-08,11,9,SC,US,20,1742
OUTLANDER 450,2021-02-08,12,4,SC,US,16,1818
OUTLANDER 1000,2021-02-15,0,1,SC,US,1,1646
OUTLANDER 850,2021-02-15,14,11,SC,US,25,1767
OUTLANDER 450,2021-02-15,2,13,SC,US,15,1833
OUTLANDER 1000,2021-02-22,1,13,SC,US,14,1660
OUTLANDER 850,2021-02-22,14,10,SC,US,24,1791
OUTLANDER 450,2021-02-22,4,6,SC,US,10,1843
OUTLANDER 1000,2021-03-01,13,9,SC,US,22,1682
OUTLANDER 850,2021-03-01,11,13,SC,US,24,1815
OUTLANDER 450,2021-03-01,8,1,SC,US,9,1852
OUTLANDER 1000,2021-03-08,9,3,SC,US,12,1694
OUTLANDER 850,2021-03-08,2,13,SC,US,15,1830
OUTLANDER 450,2021-03-08,3,14,SC,US,17,1869
OUTLANDER 1000,2021-03-15,11,10,SC,US,21,1715
OUTLANDER 850,2021-03-15,5,12,SC,US,17,1847
OUTLANDER 450,2021-03-15,13,4,SC,US,17,1886
OUTLANDER 1000,2021-03-22,6,9,SC,US,15,1730
OUTLANDER 850,2021-03-22,5,7,SC,US,12,1859
OUTLANDER 450,2021-03-22,11,11,SC,US,22,1908
OUTLANDER 1000,2021-03-29,13,11,SC,US,24,1754
OUTLANDER 850,2021-03-29,2,11,SC,US,13,1872
OUTLANDER 450,2021-03-29,14,8,SC,US,22,1930
OUTLANDER 1000,2021-04-05,8,13,SC,US,21,1775
OUTLANDER 850,2021-04-05,10,0,SC,US,10,1882
OUTLANDER 450,2021-04-05,12,8,SC,US,20,1950
OUTLANDER 1000,2021-04-12,12,9,SC,US,21,1796
OUTLANDER 850,2021-04-12,13,11,SC,US,24,1906
OUTLANDER 450,2021-04-12,5,14,SC,US,19,1969
OUTLANDER 1000,2021-04-19,2,2,SC,US,4,1800
OUTLANDER 850,2021-04-19,9,8,SC,US,17,1923
OUTLANDER 450,2021-04-19,7,12,SC,US,19,1988
OUTLANDER 1000,2021-04-26,14,15,SC,US,29,1829
OUTLANDER 850,2021-04-26,10,6,SC,US,16,1939
OUTLANDER 450,2021-04-26,12,10,SC,US,22,2010
OUTLANDER 1000,2021-05-03,3,14,SC,US,17,1846
OUTLANDER 850,2021-05-03,1,6,SC,US,7,1946
OUTLANDER 450,2021-05-03,7,9,SC,US,16,2026
OUTLANDER 1000,2021-05-10,3,12,SC,US,15,1861
OUTLANDER 850,2021-05-10,4,13,SC,US,17,1963
OUTLANDER 450,2021-05-10,3,14,SC,US,17,2043
OUTLANDER 1000,2021-05-17,7,2,SC,US,9,1870
OUTLANDER 850,2021-05-17,5,10,SC,US,15,1978
OUTLANDER 450,2021-05-17,2,10,SC,US,12,2055
OUTLANDER 1000,2021-05-24,10,8,SC,US,18,1888
OUTLANDER 850,2021-05-24,11,13,SC,US,24,2002
OUTLANDER 450,2021-05-24,5,8,SC,US,13,2068
OUTLANDER 1000,2021-05-31,1,13,SC,US,14,1902
OUTLANDER 850,2021-05-31,13,7,SC,US,20,2022
OUTLANDER 450,2021-05-31,5,5,SC,US,10,2078
OUTLANDER 1000,2021-06-07,2,14,SC,US,16,1918
OUTLANDER 850,2021-06-07,8,0,SC,US,8,2030
OUTLANDER 450,2021-06-07,15,8,SC,US,23,2101
OUTLANDER 1000,2021-06-14,0,7,SC,US,7,1925
OUTLANDER 850,2021-06-14,11,5,SC,US,16,2046
OUTLANDER 450,2021-06-14,11,14,SC,US,25,2126
OUTLANDER 1000,2021-06-21,2,12,SC,US,14,1939
OUTLANDER 850,2021-06-21,6,4,SC,US,10,2056
OUTLANDER 450,2021-06-21,10,8,SC,US,18,2144
OUTLANDER 1000,2021-06-28,13,2,SC,US,15,1954
OUTLANDER 850,2021-06-28,13,15,SC,US,28,2084
OUTLANDER 450,2021-06-28,11,9,SC,US,20,2164
OUTLANDER 1000,2021-07-05,7,14,SC,US,21,1975
OUTLANDER 850,2021-07-05,10,4,SC,US,14,2098
OUTLANDER 450,2021-07-05,11,7,SC,US,18,2182
OUTLANDER 1000,2021-07-12,13,7,SC,US,20,1995
OUTLANDER 850,2021-07-12,7,6,SC,US,13,2111
OUTLANDER 450,2021-07-12,11,13,SC,US,24,2206
OUTLANDER 1000,2021-07-19,6,11,SC,US,17,2012
OUTLANDER 850,2021-07-19,2,9,SC,US,11,2122
OUTLANDER 450,2021-07-19,7,8,SC,US,15,2221
OUTLANDER 1000,2021-07-26,3,8,SC,US,11,2023
OUTLANDER 850,2021-07-26,11,1,SC,US,12,2134
OUTLANDER 450,2021-07-26,7,14,SC,US,21,2242
OUTLANDER 1000,2021-08-02,11,7,SC,US,18,2041
OUTLANDER 850,2021-08-02,9,7,SC,US,16,2150
OUTLANDER 450,2021-08-02,11,4,SC,US,15,2257
OUTLANDER 1000,2021-08-09,1,13,SC,US,14,2055
OUTLANDER 850,2021-08-09,5,4,SC,US,9,2159
OUTLANDER 450,2021-08-09,5,14,SC,US,19,2276
OUTLANDER 1000,2021-08-16,2,2,SC,US,4,2059
OUTLANDER 850,2021-08-16,10,4,SC,US,14,2173
OUTLANDER 450,2021-08-16,3,15,SC,US,18,2294
OUTLANDER 1000,2021-08-23,6,5,SC,US,11,2070
OUTLANDER 850,2021-08-23,8,12,SC,US,20,2193
OUTLANDER 450,2021-08-23,11,7,SC,US,18,2312
OUTLANDER 1000,2021-08-30,7,9,SC,US,16,2086
OUTLANDER 850,2021-08-30,7,14,SC,US,21,2214
OUTLANDER 450,2021-08-30,2,13,SC,US,15,2327
OUTLANDER 1000,2021-09-06,4,5,SC,US,9,2095
OUTLANDER 850,2021-09-06,4,4,SC,US,8,2222
OUTLANDER 450,2021-09-06,1,12,SC,US,13,2340
OUTLANDER 1000,2021-09-13,9,9,SC,US,18,2113
OUTLANDER 850,2021-09-13,6,14,SC,US,20,2242
OUTLANDER 450,2021-09-13,5,4,SC,US,9,2349
OUTLANDER 1000,2021-09-20,9,2,SC,US,11,2124
OUTLANDER 850,2021-09-20,13,9,SC,US,22,2264
OUTLANDER 450,2021-09-20,3,14,SC,US,17,2366
OUTLANDER 1000,2021-09-27,7,9,SC,US,16,2140
OUTLANDER 850,2021-09-27,1,9,SC,US,10,2274
OUTLANDER 450,2021-09-27,13,9,SC,US,22,2388
OUTLANDER 1000,2021-10-04,5,10,SC,US,15,2155
OUTLANDER 850,2021-10-04,12,1,SC,US,13,2287
OUTLANDER 450,2021-10-04,2,8,SC,US,10,2398
OUTLANDER 1000,2021-10-11,15,9,SC,US,24,2179
OUTLANDER 850,2021-10-11,7,5,SC,US,12,2299
OUTLANDER 450,2021-10-11,3,0,SC,US,3,2401
OUTLANDER 1000,2021-10-18,2,9,SC,US,11,2190
OUTLANDER 850,2021-10-18,4,9,SC,US,13,2312
OUTLANDER 450,2021-10-18,7,4,SC,US,11,2412
OUTLANDER 1000,2021-10-25,13,9,SC,US,22,2212
OUTLANDER 850,2021-10-25,12,7,SC,US,19,2331
OUTLANDER 450,2021-10-25,0,3,SC,US,3,2415
OUTLANDER 1000,2021-11-01,14,7,SC,US,21,2233
OUTLANDER 850,2021-11-01,12,2,SC,US,14,2345
OUTLANDER 450,2021-11-01,8,9,SC,US,17,2432
OUTLANDER 1000,2021-11-08,1,4,SC,US,5,2238
OUTLANDER 850,2021-11-08,14,0,SC,US,14,2359
OUTLANDER 450,2021-11-08,5,4,SC,US,9,2441
OUTLANDER 1000,2021-11-15,10,2,SC,US,12,2250
OUTLANDER 850,2021-11-15,4,2,SC,US,6,2365
OUTLANDER 450,2021-11-15,3,7,SC,US,10,2451
OUTLANDER 1000,2021-11-22,1,2,SC,US,3,2253
OUTLANDER 850,2021-11-22,6,5,SC,US,11,2376
OUTLANDER 450,2021-11-22,5,8,SC,US,13,2464
OUTLANDER 1000,2021-11-29,5,5,SC,US,10,2263
OUTLANDER 850,2021-11-29,3,3,SC,US,6,2382
OUTLANDER 450,2021-11-29,9,6,SC,US,15,2479
OUTLANDER 1000,2021-12-06,9,5,SC,US,14,2277
OUTLANDER 850,2021-12-06,11,5,SC,US,16,2398
OUTLANDER 450,2021-12-06,5,3,SC,US,8,2487
OUTLANDER 1000,2021-12-13,13,9,SC,US,22,2299
OUTLANDER 850,2021-12-13,1,5,SC,US,6,2404
OUTLANDER 450,2021-12-13,3,2,SC,US,5,2492
OUTLANDER 1000,2021-12-20,2,4,SC,US,6,2305
OUTLANDER 850,2021-12-20,5,13,SC,US,18,2422
OUTLANDER 450,2021-12-20,5,8,SC,US,13,2505
OUTLANDER 1000,2021-12-27,1,14,SC,US,15,2320
OUTLANDER 850,2021-12-27,0,10,SC,US,10,2432
OUTLANDER 450,2021-12-27,14,4,SC,US,18,2523
OUTLANDER 1000,2019-01-07,2,0,SD,US,2,2
OUTLANDER 850,2019-01-07,7,10,SD,US,17,17
OUTLANDER 450,2019-01-07,10,14,SD,US,24,24
OUTLANDER 1000,2019-01-14,4,2,SD,US,6,8
OUTLANDER 850,2019-01-14,13,5,SD,US,18,35
OUTLANDER 450,2019-01-14,11,5,SD,US,16,40
OUTLANDER 1000,2019-01-21,13,1,SD,US,14,22
OUTLANDER 850,2019-01-21,4,13,SD,US,17,52
OUTLANDER 450,2019-01-21,10,5,SD,US,15,55
OUTLANDER 1000,2019-01-28,12,10,SD,US,22,44
OUTLANDER 850,2019-01-28,3,4,SD,US,7,59
OUTLANDER 450,2019-01-28,2,4,SD,US,6,61
OUTLANDER 1000,2019-02-04,7,12,SD,US,19,63
OUTLANDER 850,2019-02-04,5,1,SD,US,6,65
OUTLANDER 450,2019-02-04,11,9,SD,US,20,81
OUTLANDER 1000,2019-02-11,2,12,SD,US,14,77
OUTLANDER 850,2019-02-11,8,2,SD,US,10,75
OUTLANDER 450,2019-02-11,4,1,SD,US,5,86
OUTLANDER 1000,2019-02-18,1,2,SD,US,3,80
OUTLANDER 850,2019-02-18,1,0,SD,US,1,76
OUTLANDER 450,2019-02-18,13,3,SD,US,16,102
OUTLANDER 1000,2019-02-25,1,12,SD,US,13,93
OUTLANDER 850,2019-02-25,10,7,SD,US,17,93
OUTLANDER 450,2019-02-25,10,12,SD,US,22,124
OUTLANDER 1000,2019-03-04,1,7,SD,US,8,101
OUTLANDER 850,2019-03-04,12,13,SD,US,25,118
OUTLANDER 450,2019-03-04,6,3,SD,US,9,133
OUTLANDER 1000,2019-03-11,1,7,SD,US,8,109
OUTLANDER 850,2019-03-11,5,6,SD,US,11,129
OUTLANDER 450,2019-03-11,7,6,SD,US,13,146
OUTLANDER 1000,2019-03-18,5,13,SD,US,18,127
OUTLANDER 850,2019-03-18,8,1,SD,US,9,138
OUTLANDER 450,2019-03-18,5,13,SD,US,18,164
OUTLANDER 1000,2019-03-25,3,14,SD,US,17,144
OUTLANDER 850,2019-03-25,13,5,SD,US,18,156
OUTLANDER 450,2019-03-25,7,10,SD,US,17,181
OUTLANDER 1000,2019-04-01,6,1,SD,US,7,151
OUTLANDER 850,2019-04-01,1,13,SD,US,14,170
OUTLANDER 450,2019-04-01,15,3,SD,US,18,199
OUTLANDER 1000,2019-04-08,3,13,SD,US,16,167
OUTLANDER 850,2019-04-08,0,8,SD,US,8,178
OUTLANDER 450,2019-04-08,14,2,SD,US,16,215
OUTLANDER 1000,2019-04-15,13,8,SD,US,21,188
OUTLANDER 850,2019-04-15,8,15,SD,US,23,201
OUTLANDER 450,2019-04-15,2,8,SD,US,10,225
OUTLANDER 1000,2019-04-22,12,11,SD,US,23,211
OUTLANDER 850,2019-04-22,7,14,SD,US,21,222
OUTLANDER 450,2019-04-22,4,5,SD,US,9,234
OUTLANDER 1000,2019-04-29,3,10,SD,US,13,224
OUTLANDER 850,2019-04-29,10,13,SD,US,23,245
OUTLANDER 450,2019-04-29,8,12,SD,US,20,254
OUTLANDER 1000,2019-05-06,5,11,SD,US,16,240
OUTLANDER 850,2019-05-06,1,6,SD,US,7,252
OUTLANDER 450,2019-05-06,2,13,SD,US,15,269
OUTLANDER 1000,2019-05-13,14,4,SD,US,18,258
OUTLANDER 850,2019-05-13,4,10,SD,US,14,266
OUTLANDER 450,2019-05-13,12,1,SD,US,13,282
OUTLANDER 1000,2019-05-20,10,2,SD,US,12,270
OUTLANDER 850,2019-05-20,3,13,SD,US,16,282
OUTLANDER 450,2019-05-20,9,7,SD,US,16,298
OUTLANDER 1000,2019-05-27,4,1,SD,US,5,275
OUTLANDER 850,2019-05-27,8,10,SD,US,18,300
OUTLANDER 450,2019-05-27,1,7,SD,US,8,306
OUTLANDER 1000,2019-06-03,6,3,SD,US,9,284
OUTLANDER 850,2019-06-03,11,12,SD,US,23,323
OUTLANDER 450,2019-06-03,11,15,SD,US,26,332
OUTLANDER 1000,2019-06-10,9,5,SD,US,14,298
OUTLANDER 850,2019-06-10,8,6,SD,US,14,337
OUTLANDER 450,2019-06-10,14,7,SD,US,21,353
OUTLANDER 1000,2019-06-17,4,14,SD,US,18,316
OUTLANDER 850,2019-06-17,2,4,SD,US,6,343
OUTLANDER 450,2019-06-17,1,0,SD,US,1,354
OUTLANDER 1000,2019-06-24,1,0,SD,US,1,317
OUTLANDER 850,2019-06-24,13,2,SD,US,15,358
OUTLANDER 450,2019-06-24,10,9,SD,US,19,373
OUTLANDER 1000,2019-07-01,2,9,SD,US,11,328
OUTLANDER 850,2019-07-01,8,2,SD,US,10,368
OUTLANDER 450,2019-07-01,1,13,SD,US,14,387
OUTLANDER 1000,2019-07-08,1,7,SD,US,8,336
OUTLANDER 850,2019-07-08,15,5,SD,US,20,388
OUTLANDER 450,2019-07-08,10,0,SD,US,10,397
OUTLANDER 1000,2019-07-15,11,12,SD,US,23,359
OUTLANDER 850,2019-07-15,4,6,SD,US,10,398
OUTLANDER 450,2019-07-15,11,14,SD,US,25,422
OUTLANDER 1000,2019-07-22,11,5,SD,US,16,375
OUTLANDER 850,2019-07-22,7,9,SD,US,16,414
OUTLANDER 450,2019-07-22,14,7,SD,US,21,443
OUTLANDER 1000,2019-07-29,9,10,SD,US,19,394
OUTLANDER 850,2019-07-29,11,12,SD,US,23,437
OUTLANDER 450,2019-07-29,2,7,SD,US,9,452
OUTLANDER 1000,2019-08-05,1,0,SD,US,1,395
OUTLANDER 850,2019-08-05,2,14,SD,US,16,453
OUTLANDER 450,2019-08-05,5,9,SD,US,14,466
OUTLANDER 1000,2019-08-12,11,13,SD,US,24,419
OUTLANDER 850,2019-08-12,4,9,SD,US,13,466
OUTLANDER 450,2019-08-12,2,13,SD,US,15,481
OUTLANDER 1000,2019-08-19,2,7,SD,US,9,428
OUTLANDER 850,2019-08-19,1,4,SD,US,5,471
OUTLANDER 450,2019-08-19,6,1,SD,US,7,488
OUTLANDER 1000,2019-08-26,10,5,SD,US,15,443
OUTLANDER 850,2019-08-26,13,4,SD,US,17,488
OUTLANDER 450,2019-08-26,8,7,SD,US,15,503
OUTLANDER 1000,2019-09-02,2,15,SD,US,17,460
OUTLANDER 850,2019-09-02,7,2,SD,US,9,497
OUTLANDER 450,2019-09-02,2,14,SD,US,16,519
OUTLANDER 1000,2019-09-09,5,13,SD,US,18,478
OUTLANDER 850,2019-09-09,3,10,SD,US,13,510
OUTLANDER 450,2019-09-09,7,7,SD,US,14,533
OUTLANDER 1000,2019-09-16,4,3,SD,US,7,485
OUTLANDER 850,2019-09-16,1,11,SD,US,12,522
OUTLANDER 450,2019-09-16,6,13,SD,US,19,552
OUTLANDER 1000,2019-09-23,9,8,SD,US,17,502
OUTLANDER 850,2019-09-23,6,3,SD,US,9,531
OUTLANDER 450,2019-09-23,8,12,SD,US,20,572
OUTLANDER 1000,2019-09-30,12,4,SD,US,16,518
OUTLANDER 850,2019-09-30,0,13,SD,US,13,544
OUTLANDER 450,2019-09-30,0,15,SD,US,15,587
OUTLANDER 1000,2019-10-07,0,1,SD,US,1,519
OUTLANDER 850,2019-10-07,3,11,SD,US,14,558
OUTLANDER 450,2019-10-07,8,13,SD,US,21,608
OUTLANDER 1000,2019-10-14,7,0,SD,US,7,526
OUTLANDER 850,2019-10-14,8,15,SD,US,23,581
OUTLANDER 450,2019-10-14,1,8,SD,US,9,617
OUTLANDER 1000,2019-10-21,11,6,SD,US,17,543
OUTLANDER 850,2019-10-21,6,10,SD,US,16,597
OUTLANDER 450,2019-10-21,6,12,SD,US,18,635
OUTLANDER 1000,2019-10-28,1,5,SD,US,6,549
OUTLANDER 850,2019-10-28,5,2,SD,US,7,604
OUTLANDER 450,2019-10-28,14,14,SD,US,28,663
OUTLANDER 1000,2019-11-04,10,8,SD,US,18,567
OUTLANDER 850,2019-11-04,10,3,SD,US,13,617
OUTLANDER 450,2019-11-04,6,5,SD,US,11,674
OUTLANDER 1000,2019-11-11,11,13,SD,US,24,591
OUTLANDER 850,2019-11-11,8,1,SD,US,9,626
OUTLANDER 450,2019-11-11,6,10,SD,US,16,690
OUTLANDER 1000,2019-11-18,9,9,SD,US,18,609
OUTLANDER 850,2019-11-18,4,15,SD,US,19,645
OUTLANDER 450,2019-11-18,7,2,SD,US,9,699
OUTLANDER 1000,2019-11-25,7,3,SD,US,10,619
OUTLANDER 850,2019-11-25,15,4,SD,US,19,664
OUTLANDER 450,2019-11-25,8,14,SD,US,22,721
OUTLANDER 1000,2019-12-02,2,12,SD,US,14,633
OUTLANDER 850,2019-12-02,1,8,SD,US,9,673
OUTLANDER 450,2019-12-02,3,6,SD,US,9,730
OUTLANDER 1000,2019-12-09,8,9,SD,US,17,650
OUTLANDER 850,2019-12-09,4,13,SD,US,17,690
OUTLANDER 450,2019-12-09,14,12,SD,US,26,756
OUTLANDER 1000,2019-12-16,13,0,SD,US,13,663
OUTLANDER 850,2019-12-16,8,14,SD,US,22,712
OUTLANDER 450,2019-12-16,6,13,SD,US,19,775
OUTLANDER 1000,2019-12-23,2,9,SD,US,11,674
OUTLANDER 850,2019-12-23,5,14,SD,US,19,731
OUTLANDER 450,2019-12-23,7,12,SD,US,19,794
OUTLANDER 1000,2019-12-30,10,11,SD,US,21,695
OUTLANDER 850,2019-12-30,7,11,SD,US,18,749
OUTLANDER 450,2019-12-30,1,10,SD,US,11,805
OUTLANDER 1000,2020-01-06,5,9,SD,US,14,709
OUTLANDER 850,2020-01-06,14,5,SD,US,19,768
OUTLANDER 450,2020-01-06,2,4,SD,US,6,811
OUTLANDER 1000,2020-01-13,3,9,SD,US,12,721
OUTLANDER 850,2020-01-13,15,15,SD,US,30,798
OUTLANDER 450,2020-01-13,6,3,SD,US,9,820
OUTLANDER 1000,2020-01-20,9,9,SD,US,18,739
OUTLANDER 850,2020-01-20,9,3,SD,US,12,810
OUTLANDER 450,2020-01-20,0,13,SD,US,13,833
OUTLANDER 1000,2020-01-27,14,2,SD,US,16,755
OUTLANDER 850,2020-01-27,1,1,SD,US,2,812
OUTLANDER 450,2020-01-27,12,9,SD,US,21,854
OUTLANDER 1000,2020-02-03,2,14,SD,US,16,771
OUTLANDER 850,2020-02-03,3,8,SD,US,11,823
OUTLANDER 450,2020-02-03,8,1,SD,US,9,863
OUTLANDER 1000,2020-02-10,14,6,SD,US,20,791
OUTLANDER 850,2020-02-10,4,5,SD,US,9,832
OUTLANDER 450,2020-02-10,14,5,SD,US,19,882
OUTLANDER 1000,2020-02-17,0,4,SD,US,4,795
OUTLANDER 850,2020-02-17,15,11,SD,US,26,858
OUTLANDER 450,2020-02-17,8,8,SD,US,16,898
OUTLANDER 1000,2020-02-24,7,12,SD,US,19,814
OUTLANDER 850,2020-02-24,15,14,SD,US,29,887
OUTLANDER 450,2020-02-24,7,2,SD,US,9,907
OUTLANDER 1000,2020-03-02,5,14,SD,US,19,833
OUTLANDER 850,2020-03-02,6,3,SD,US,9,896
OUTLANDER 450,2020-03-02,9,15,SD,US,24,931
OUTLANDER 1000,2020-03-09,1,9,SD,US,10,843
OUTLANDER 850,2020-03-09,2,11,SD,US,13,909
OUTLANDER 450,2020-03-09,15,14,SD,US,29,960
OUTLANDER 1000,2020-03-16,13,14,SD,US,27,870
OUTLANDER 850,2020-03-16,15,9,SD,US,24,933
OUTLANDER 450,2020-03-16,11,13,SD,US,24,984
OUTLANDER 1000,2020-03-23,2,3,SD,US,5,875
OUTLANDER 850,2020-03-23,6,9,SD,US,15,948
OUTLANDER 450,2020-03-23,6,13,SD,US,19,1003
OUTLANDER 1000,2020-03-30,5,7,SD,US,12,887
OUTLANDER 850,2020-03-30,11,13,SD,US,24,972
OUTLANDER 450,2020-03-30,9,7,SD,US,16,1019
OUTLANDER 1000,2020-04-06,13,2,SD,US,15,902
OUTLANDER 850,2020-04-06,12,6,SD,US,18,990
OUTLANDER 450,2020-04-06,4,13,SD,US,17,1036
OUTLANDER 1000,2020-04-13,2,8,SD,US,10,912
OUTLANDER 850,2020-04-13,14,4,SD,US,18,1008
OUTLANDER 450,2020-04-13,6,14,SD,US,20,1056
OUTLANDER 1000,2020-04-20,2,3,SD,US,5,917
OUTLANDER 850,2020-04-20,7,13,SD,US,20,1028
OUTLANDER 450,2020-04-20,3,6,SD,US,9,1065
OUTLANDER 1000,2020-04-27,7,9,SD,US,16,933
OUTLANDER 850,2020-04-27,4,15,SD,US,19,1047
OUTLANDER 450,2020-04-27,11,4,SD,US,15,1080
OUTLANDER 1000,2020-05-04,11,11,SD,US,22,955
OUTLANDER 850,2020-05-04,13,11,SD,US,24,1071
OUTLANDER 450,2020-05-04,8,9,SD,US,17,1097
OUTLANDER 1000,2020-05-11,9,8,SD,US,17,972
OUTLANDER 850,2020-05-11,10,11,SD,US,21,1092
OUTLANDER 450,2020-05-11,8,2,SD,US,10,1107
OUTLANDER 1000,2020-05-18,3,10,SD,US,13,985
OUTLANDER 850,2020-05-18,6,2,SD,US,8,1100
OUTLANDER 450,2020-05-18,10,13,SD,US,23,1130
OUTLANDER 1000,2020-05-25,4,9,SD,US,13,998
OUTLANDER 850,2020-05-25,5,5,SD,US,10,1110
OUTLANDER 450,2020-05-25,3,8,SD,US,11,1141
OUTLANDER 1000,2020-06-01,11,1,SD,US,12,1010
OUTLANDER 850,2020-06-01,9,3,SD,US,12,1122
OUTLANDER 450,2020-06-01,8,6,SD,US,14,1155
OUTLANDER 1000,2020-06-08,13,9,SD,US,22,1032
OUTLANDER 850,2020-06-08,6,15,SD,US,21,1143
OUTLANDER 450,2020-06-08,6,2,SD,US,8,1163
OUTLANDER 1000,2020-06-15,13,9,SD,US,22,1054
OUTLANDER 850,2020-06-15,12,14,SD,US,26,1169
OUTLANDER 450,2020-06-15,13,6,SD,US,19,1182
OUTLANDER 1000,2020-06-22,11,0,SD,US,11,1065
OUTLANDER 850,2020-06-22,8,14,SD,US,22,1191
OUTLANDER 450,2020-06-22,12,1,SD,US,13,1195
OUTLANDER 1000,2020-06-29,3,5,SD,US,8,1073
OUTLANDER 850,2020-06-29,2,2,SD,US,4,1195
OUTLANDER 450,2020-06-29,10,14,SD,US,24,1219
OUTLANDER 1000,2020-07-06,14,9,SD,US,23,1096
OUTLANDER 850,2020-07-06,0,5,SD,US,5,1200
OUTLANDER 450,2020-07-06,1,6,SD,US,7,1226
OUTLANDER 1000,2020-07-13,2,9,SD,US,11,1107
OUTLANDER 850,2020-07-13,7,3,SD,US,10,1210
OUTLANDER 450,2020-07-13,4,3,SD,US,7,1233
OUTLANDER 1000,2020-07-20,4,10,SD,US,14,1121
OUTLANDER 850,2020-07-20,11,5,SD,US,16,1226
OUTLANDER 450,2020-07-20,3,3,SD,US,6,1239
OUTLANDER 1000,2020-07-27,13,3,SD,US,16,1137
OUTLANDER 850,2020-07-27,3,7,SD,US,10,1236
OUTLANDER 450,2020-07-27,10,13,SD,US,23,1262
OUTLANDER 1000,2020-08-03,14,5,SD,US,19,1156
OUTLANDER 850,2020-08-03,8,8,SD,US,16,1252
OUTLANDER 450,2020-08-03,4,11,SD,US,15,1277
OUTLANDER 1000,2020-08-10,11,5,SD,US,16,1172
OUTLANDER 850,2020-08-10,7,15,SD,US,22,1274
OUTLANDER 450,2020-08-10,6,5,SD,US,11,1288
OUTLANDER 1000,2020-08-17,8,0,SD,US,8,1180
OUTLANDER 850,2020-08-17,3,1,SD,US,4,1278
OUTLANDER 450,2020-08-17,3,3,SD,US,6,1294
OUTLANDER 1000,2020-08-24,14,10,SD,US,24,1204
OUTLANDER 850,2020-08-24,0,13,SD,US,13,1291
OUTLANDER 450,2020-08-24,8,10,SD,US,18,1312
OUTLANDER 1000,2020-08-31,9,0,SD,US,9,1213
OUTLANDER 850,2020-08-31,3,10,SD,US,13,1304
OUTLANDER 450,2020-08-31,14,0,SD,US,14,1326
OUTLANDER 1000,2020-09-07,4,4,SD,US,8,1221
OUTLANDER 850,2020-09-07,7,7,SD,US,14,1318
OUTLANDER 450,2020-09-07,3,1,SD,US,4,1330
OUTLANDER 1000,2020-09-14,11,7,SD,US,18,1239
OUTLANDER 850,2020-09-14,1,6,SD,US,7,1325
OUTLANDER 450,2020-09-14,10,14,SD,US,24,1354
OUTLANDER 1000,2020-09-21,5,3,SD,US,8,1247
OUTLANDER 850,2020-09-21,15,5,SD,US,20,1345
OUTLANDER 450,2020-09-21,4,6,SD,US,10,1364
OUTLANDER 1000,2020-09-28,12,12,SD,US,24,1271
OUTLANDER 850,2020-09-28,5,4,SD,US,9,1354
OUTLANDER 450,2020-09-28,7,6,SD,US,13,1377
OUTLANDER 1000,2020-10-05,3,9,SD,US,12,1283
OUTLANDER 850,2020-10-05,2,0,SD,US,2,1356
OUTLANDER 450,2020-10-05,2,13,SD,US,15,1392
OUTLANDER 1000,2020-10-12,7,13,SD,US,20,1303
OUTLANDER 850,2020-10-12,1,15,SD,US,16,1372
OUTLANDER 450,2020-10-12,10,13,SD,US,23,1415
OUTLANDER 1000,2020-10-19,7,2,SD,US,9,1312
OUTLANDER 850,2020-10-19,7,6,SD,US,13,1385
OUTLANDER 450,2020-10-19,10,12,SD,US,22,1437
OUTLANDER 1000,2020-10-26,10,0,SD,US,10,1322
OUTLANDER 850,2020-10-26,1,13,SD,US,14,1399
OUTLANDER 450,2020-10-26,6,10,SD,US,16,1453
OUTLANDER 1000,2020-11-02,3,4,SD,US,7,1329
OUTLANDER 850,2020-11-02,4,2,SD,US,6,1405
OUTLANDER 450,2020-11-02,5,9,SD,US,14,1467
OUTLANDER 1000,2020-11-09,2,8,SD,US,10,1339
OUTLANDER 850,2020-11-09,12,13,SD,US,25,1430
OUTLANDER 450,2020-11-09,4,2,SD,US,6,1473
OUTLANDER 1000,2020-11-16,5,6,SD,US,11,1350
OUTLANDER 850,2020-11-16,10,13,SD,US,23,1453
OUTLANDER 450,2020-11-16,14,7,SD,US,21,1494
OUTLANDER 1000,2020-11-23,12,10,SD,US,22,1372
OUTLANDER 850,2020-11-23,8,7,SD,US,15,1468
OUTLANDER 450,2020-11-23,3,8,SD,US,11,1505
OUTLANDER 1000,2020-11-30,13,13,SD,US,26,1398
OUTLANDER 850,2020-11-30,4,4,SD,US,8,1476
OUTLANDER 450,2020-11-30,10,7,SD,US,17,1522
OUTLANDER 1000,2020-12-07,9,12,SD,US,21,1419
OUTLANDER 850,2020-12-07,3,11,SD,US,14,1490
OUTLANDER 450,2020-12-07,13,14,SD,US,27,1549
OUTLANDER 1000,2020-12-14,2,12,SD,US,14,1433
OUTLANDER 850,2020-12-14,7,5,SD,US,12,1502
OUTLANDER 450,2020-12-14,4,3,SD,US,7,1556
OUTLANDER 1000,2020-12-21,15,0,SD,US,15,1448
OUTLANDER 850,2020-12-21,5,3,SD,US,8,1510
OUTLANDER 450,2020-12-21,5,13,SD,US,18,1574
OUTLANDER 1000,2020-12-28,2,8,SD,US,10,1458
OUTLANDER 850,2020-12-28,15,5,SD,US,20,1530
OUTLANDER 450,2020-12-28,11,5,SD,US,16,1590
OUTLANDER 1000,2021-01-04,14,3,SD,US,17,1475
OUTLANDER 850,2021-01-04,13,10,SD,US,23,1553
OUTLANDER 450,2021-01-04,8,7,SD,US,15,1605
OUTLANDER 1000,2021-01-11,7,10,SD,US,17,1492
OUTLANDER 850,2021-01-11,14,1,SD,US,15,1568
OUTLANDER 450,2021-01-11,4,14,SD,US,18,1623
OUTLANDER 1000,2021-01-18,12,1,SD,US,13,1505
OUTLANDER 850,2021-01-18,8,5,SD,US,13,1581
OUTLANDER 450,2021-01-18,9,2,SD,US,11,1634
OUTLANDER 1000,2021-01-25,13,4,SD,US,17,1522
OUTLANDER 850,2021-01-25,13,4,SD,US,17,1598
OUTLANDER 450,2021-01-25,1,4,SD,US,5,1639
OUTLANDER 1000,2021-02-01,8,2,SD,US,10,1532
OUTLANDER 850,2021-02-01,1,12,SD,US,13,1611
OUTLANDER 450,2021-02-01,7,9,SD,US,16,1655
OUTLANDER 1000,2021-02-08,14,0,SD,US,14,1546
OUTLANDER 850,2021-02-08,2,9,SD,US,11,1622
OUTLANDER 450,2021-02-08,15,6,SD,US,21,1676
OUTLANDER 1000,2021-02-15,8,6,SD,US,14,1560
OUTLANDER 850,2021-02-15,2,6,SD,US,8,1630
OUTLANDER 450,2021-02-15,14,8,SD,US,22,1698
OUTLANDER 1000,2021-02-22,5,9,SD,US,14,1574
OUTLANDER 850,2021-02-22,5,5,SD,US,10,1640
OUTLANDER 450,2021-02-22,14,2,SD,US,16,1714
OUTLANDER 1000,2021-03-01,12,9,SD,US,21,1595
OUTLANDER 850,2021-03-01,0,10,SD,US,10,1650
OUTLANDER 450,2021-03-01,2,9,SD,US,11,1725
OUTLANDER 1000,2021-03-08,1,10,SD,US,11,1606
OUTLANDER 850,2021-03-08,0,3,SD,US,3,1653
OUTLANDER 450,2021-03-08,3,2,SD,US,5,1730
OUTLANDER 1000,2021-03-15,14,10,SD,US,24,1630
OUTLANDER 850,2021-03-15,6,8,SD,US,14,1667
OUTLANDER 450,2021-03-15,12,14,SD,US,26,1756
OUTLANDER 1000,2021-03-22,9,13,SD,US,22,1652
OUTLANDER 850,2021-03-22,12,1,SD,US,13,1680
OUTLANDER 450,2021-03-22,4,8,SD,US,12,1768
OUTLANDER 1000,2021-03-29,10,7,SD,US,17,1669
OUTLANDER 850,2021-03-29,5,5,SD,US,10,1690
OUTLANDER 450,2021-03-29,3,6,SD,US,9,1777
OUTLANDER 1000,2021-04-05,1,9,SD,US,10,1679
OUTLANDER 850,2021-04-05,15,9,SD,US,24,1714
OUTLANDER 450,2021-04-05,14,0,SD,US,14,1791
OUTLANDER 1000,2021-04-12,12,14,SD,US,26,1705
OUTLANDER 850,2021-04-12,12,7,SD,US,19,1733
OUTLANDER 450,2021-04-12,9,9,SD,US,18,1809
OUTLANDER 1000,2021-04-19,0,4,SD,US,4,1709
OUTLANDER 850,2021-04-19,11,9,SD,US,20,1753
OUTLANDER 450,2021-04-19,11,6,SD,US,17,1826
OUTLANDER 1000,2021-04-26,7,3,SD,US,10,1719
OUTLANDER 850,2021-04-26,12,13,SD,US,25,1778
OUTLANDER 450,2021-04-26,9,9,SD,US,18,1844
OUTLANDER 1000,2021-05-03,15,6,SD,US,21,1740
OUTLANDER 850,2021-05-03,9,9,SD,US,18,1796
OUTLANDER 450,2021-05-03,5,0,SD,US,5,1849
OUTLANDER 1000,2021-05-10,13,14,SD,US,27,1767
OUTLANDER 850,2021-05-10,6,13,SD,US,19,1815
OUTLANDER 450,2021-05-10,3,10,SD,US,13,1862
OUTLANDER 1000,2021-05-17,13,12,SD,US,25,1792
OUTLANDER 850,2021-05-17,10,2,SD,US,12,1827
OUTLANDER 450,2021-05-17,1,5,SD,US,6,1868
OUTLANDER 1000,2021-05-24,14,1,SD,US,15,1807
OUTLANDER 850,2021-05-24,7,3,SD,US,10,1837
OUTLANDER 450,2021-05-24,9,14,SD,US,23,1891
OUTLANDER 1000,2021-05-31,14,5,SD,US,19,1826
OUTLANDER 850,2021-05-31,11,4,SD,US,15,1852
OUTLANDER 450,2021-05-31,10,7,SD,US,17,1908
OUTLANDER 1000,2021-06-07,9,4,SD,US,13,1839
OUTLANDER 850,2021-06-07,6,5,SD,US,11,1863
OUTLANDER 450,2021-06-07,12,11,SD,US,23,1931
OUTLANDER 1000,2021-06-14,3,12,SD,US,15,1854
OUTLANDER 850,2021-06-14,7,0,SD,US,7,1870
OUTLANDER 450,2021-06-14,14,9,SD,US,23,1954
OUTLANDER 1000,2021-06-21,4,2,SD,US,6,1860
OUTLANDER 850,2021-06-21,13,10,SD,US,23,1893
OUTLANDER 450,2021-06-21,1,10,SD,US,11,1965
OUTLANDER 1000,2021-06-28,0,9,SD,US,9,1869
OUTLANDER 850,2021-06-28,6,6,SD,US,12,1905
OUTLANDER 450,2021-06-28,1,4,SD,US,5,1970
OUTLANDER 1000,2021-07-05,6,3,SD,US,9,1878
OUTLANDER 850,2021-07-05,1,5,SD,US,6,1911
OUTLANDER 450,2021-07-05,8,2,SD,US,10,1980
OUTLANDER 1000,2021-07-12,3,7,SD,US,10,1888
OUTLANDER 850,2021-07-12,8,15,SD,US,23,1934
OUTLANDER 450,2021-07-12,0,14,SD,US,14,1994
OUTLANDER 1000,2021-07-19,7,6,SD,US,13,1901
OUTLANDER 850,2021-07-19,15,12,SD,US,27,1961
OUTLANDER 450,2021-07-19,12,8,SD,US,20,2014
OUTLANDER 1000,2021-07-26,15,11,SD,US,26,1927
OUTLANDER 850,2021-07-26,4,14,SD,US,18,1979
OUTLANDER 450,2021-07-26,2,11,SD,US,13,2027
OUTLANDER 1000,2021-08-02,4,6,SD,US,10,1937
OUTLANDER 850,2021-08-02,4,14,SD,US,18,1997
OUTLANDER 450,2021-08-02,14,2,SD,US,16,2043
OUTLANDER 1000,2021-08-09,15,1,SD,US,16,1953
OUTLANDER 850,2021-08-09,9,11,SD,US,20,2017
OUTLANDER 450,2021-08-09,11,0,SD,US,11,2054
OUTLANDER 1000,2021-08-16,8,12,SD,US,20,1973
OUTLANDER 850,2021-08-16,8,5,SD,US,13,2030
OUTLANDER 450,2021-08-16,10,14,SD,US,24,2078
OUTLANDER 1000,2021-08-23,11,3,SD,US,14,1987
OUTLANDER 850,2021-08-23,2,10,SD,US,12,2042
OUTLANDER 450,2021-08-23,3,7,SD,US,10,2088
OUTLANDER 1000,2021-08-30,10,12,SD,US,22,2009
OUTLANDER 850,2021-08-30,12,0,SD,US,12,2054
OUTLANDER 450,2021-08-30,10,0,SD,US,10,2098
OUTLANDER 1000,2021-09-06,4,10,SD,US,14,2023
OUTLANDER 850,2021-09-06,8,9,SD,US,17,2071
OUTLANDER 450,2021-09-06,7,10,SD,US,17,2115
OUTLANDER 1000,2021-09-13,12,2,SD,US,14,2037
OUTLANDER 850,2021-09-13,14,4,SD,US,18,2089
OUTLANDER 450,2021-09-13,14,5,SD,US,19,2134
OUTLANDER 1000,2021-09-20,10,5,SD,US,15,2052
OUTLANDER 850,2021-09-20,7,4,SD,US,11,2100
OUTLANDER 450,2021-09-20,4,10,SD,US,14,2148
OUTLANDER 1000,2021-09-27,13,5,SD,US,18,2070
OUTLANDER 850,2021-09-27,4,14,SD,US,18,2118
OUTLANDER 450,2021-09-27,7,11,SD,US,18,2166
OUTLANDER 1000,2021-10-04,15,8,SD,US,23,2093
OUTLANDER 850,2021-10-04,10,1,SD,US,11,2129
OUTLANDER 450,2021-10-04,11,5,SD,US,16,2182
OUTLANDER 1000,2021-10-11,3,5,SD,US,8,2101
OUTLANDER 850,2021-10-11,1,1,SD,US,2,2131
OUTLANDER 450,2021-10-11,8,6,SD,US,14,2196
OUTLANDER 1000,2021-10-18,5,13,SD,US,18,2119
OUTLANDER 850,2021-10-18,0,4,SD,US,4,2135
OUTLANDER 450,2021-10-18,13,3,SD,US,16,2212
OUTLANDER 1000,2021-10-25,9,7,SD,US,16,2135
OUTLANDER 850,2021-10-25,13,13,SD,US,26,2161
OUTLANDER 450,2021-10-25,13,3,SD,US,16,2228
OUTLANDER 1000,2021-11-01,11,10,SD,US,21,2156
OUTLANDER 850,2021-11-01,2,4,SD,US,6,2167
OUTLANDER 450,2021-11-01,5,5,SD,US,10,2238
OUTLANDER 1000,2021-11-08,13,14,SD,US,27,2183
OUTLANDER 850,2021-11-08,10,10,SD,US,20,2187
OUTLANDER 450,2021-11-08,5,15,SD,US,20,2258
OUTLANDER 1000,2021-11-15,4,3,SD,US,7,2190
OUTLANDER 850,2021-11-15,1,1,SD,US,2,2189
OUTLANDER 450,2021-11-15,6,11,SD,US,17,2275
OUTLANDER 1000,2021-11-22,2,7,SD,US,9,2199
OUTLANDER 850,2021-11-22,14,4,SD,US,18,2207
OUTLANDER 450,2021-11-22,7,2,SD,US,9,2284
OUTLANDER 1000,2021-11-29,4,1,SD,US,5,2204
OUTLANDER 850,2021-11-29,6,6,SD,US,12,2219
OUTLANDER 450,2021-11-29,4,12,SD,US,16,2300
OUTLANDER 1000,2021-12-06,5,8,SD,US,13,2217
OUTLANDER 850,2021-12-06,4,6,SD,US,10,2229
OUTLANDER 450,2021-12-06,12,9,SD,US,21,2321
OUTLANDER 1000,2021-12-13,1,10,SD,US,11,2228
OUTLANDER 850,2021-12-13,2,2,SD,US,4,2233
OUTLANDER 450,2021-12-13,5,6,SD,US,11,2332
OUTLANDER 1000,2021-12-20,3,7,SD,US,10,2238
OUTLANDER 850,2021-12-20,14,11,SD,US,25,2258
OUTLANDER 450,2021-12-20,8,6,SD,US,14,2346
OUTLANDER 1000,2021-12-27,9,11,SD,US,20,2258
OUTLANDER 850,2021-12-27,12,12,SD,US,24,2282
OUTLANDER 450,2021-12-27,5,14,SD,US,19,2365
OUTLANDER 1000,2019-01-07,6,1,TN,US,7,7
OUTLANDER 850,2019-01-07,5,13,TN,US,18,18
OUTLANDER 450,2019-01-07,2,9,TN,US,11,11
OUTLANDER 1000,2019-01-14,7,13,TN,US,20,27
OUTLANDER 850,2019-01-14,4,3,TN,US,7,25
OUTLANDER 450,2019-01-14,1,11,TN,US,12,23
OUTLANDER 1000,2019-01-21,11,6,TN,US,17,44
OUTLANDER 850,2019-01-21,3,3,TN,US,6,31
OUTLANDER 450,2019-01-21,12,8,TN,US,20,43
OUTLANDER 1000,2019-01-28,3,12,TN,US,15,59
OUTLANDER 850,2019-01-28,13,5,TN,US,18,49
OUTLANDER 450,2019-01-28,3,14,TN,US,17,60
OUTLANDER 1000,2019-02-04,12,12,TN,US,24,83
OUTLANDER 850,2019-02-04,15,1,TN,US,16,65
OUTLANDER 450,2019-02-04,5,1,TN,US,6,66
OUTLANDER 1000,2019-02-11,7,8,TN,US,15,98
OUTLANDER 850,2019-02-11,9,9,TN,US,18,83
OUTLANDER 450,2019-02-11,6,6,TN,US,12,78
OUTLANDER 1000,2019-02-18,13,9,TN,US,22,120
OUTLANDER 850,2019-02-18,9,0,TN,US,9,92
OUTLANDER 450,2019-02-18,8,10,TN,US,18,96
OUTLANDER 1000,2019-02-25,7,13,TN,US,20,140
OUTLANDER 850,2019-02-25,11,3,TN,US,14,106
OUTLANDER 450,2019-02-25,6,12,TN,US,18,114
OUTLANDER 1000,2019-03-04,7,7,TN,US,14,154
OUTLANDER 850,2019-03-04,8,12,TN,US,20,126
OUTLANDER 450,2019-03-04,6,6,TN,US,12,126
OUTLANDER 1000,2019-03-11,10,2,TN,US,12,166
OUTLANDER 850,2019-03-11,9,8,TN,US,17,143
OUTLANDER 450,2019-03-11,15,1,TN,US,16,142
OUTLANDER 1000,2019-03-18,7,8,TN,US,15,181
OUTLANDER 850,2019-03-18,12,14,TN,US,26,169
OUTLANDER 450,2019-03-18,5,12,TN,US,17,159
OUTLANDER 1000,2019-03-25,1,15,TN,US,16,197
OUTLANDER 850,2019-03-25,1,11,TN,US,12,181
OUTLANDER 450,2019-03-25,8,14,TN,US,22,181
OUTLANDER 1000,2019-04-01,15,9,TN,US,24,221
OUTLANDER 850,2019-04-01,8,13,TN,US,21,202
OUTLANDER 450,2019-04-01,2,7,TN,US,9,190
OUTLANDER 1000,2019-04-08,12,2,TN,US,14,235
OUTLANDER 850,2019-04-08,7,9,TN,US,16,218
OUTLANDER 450,2019-04-08,1,12,TN,US,13,203
OUTLANDER 1000,2019-04-15,5,10,TN,US,15,250
OUTLANDER 850,2019-04-15,9,14,TN,US,23,241
OUTLANDER 450,2019-04-15,3,5,TN,US,8,211
OUTLANDER 1000,2019-04-22,9,2,TN,US,11,261
OUTLANDER 850,2019-04-22,13,12,TN,US,25,266
OUTLANDER 450,2019-04-22,3,15,TN,US,18,229
OUTLANDER 1000,2019-04-29,11,8,TN,US,19,280
OUTLANDER 850,2019-04-29,1,7,TN,US,8,274
OUTLANDER 450,2019-04-29,14,2,TN,US,16,245
OUTLANDER 1000,2019-05-06,7,4,TN,US,11,291
OUTLANDER 850,2019-05-06,10,0,TN,US,10,284
OUTLANDER 450,2019-05-06,3,2,TN,US,5,250
OUTLANDER 1000,2019-05-13,11,15,TN,US,26,317
OUTLANDER 850,2019-05-13,14,14,TN,US,28,312
OUTLANDER 450,2019-05-13,7,14,TN,US,21,271
OUTLANDER 1000,2019-05-20,3,0,TN,US,3,320
OUTLANDER 850,2019-05-20,13,15,TN,US,28,340
OUTLANDER 450,2019-05-20,11,14,TN,US,25,296
OUTLANDER 1000,2019-05-27,11,0,TN,US,11,331
OUTLANDER 850,2019-05-27,6,11,TN,US,17,357
OUTLANDER 450,2019-05-27,6,3,TN,US,9,305
OUTLANDER 1000,2019-06-03,9,10,TN,US,19,350
OUTLANDER 850,2019-06-03,12,3,TN,US,15,372
OUTLANDER 450,2019-06-03,3,2,TN,US,5,310
OUTLANDER 1000,2019-06-10,12,2,TN,US,14,364
OUTLANDER 850,2019-06-10,2,2,TN,US,4,376
OUTLANDER 450,2019-06-10,2,14,TN,US,16,326
OUTLANDER 1000,2019-06-17,12,4,TN,US,16,380
OUTLANDER 850,2019-06-17,9,6,TN,US,15,391
OUTLANDER 450,2019-06-17,3,15,TN,US,18,344
OUTLANDER 1000,2019-06-24,3,10,TN,US,13,393
OUTLANDER 850,2019-06-24,13,9,TN,US,22,413
OUTLANDER 450,2019-06-24,10,8,TN,US,18,362
OUTLANDER 1000,2019-07-01,4,5,TN,US,9,402
OUTLANDER 850,2019-07-01,9,0,TN,US,9,422
OUTLANDER 450,2019-07-01,8,1,TN,US,9,371
OUTLANDER 1000,2019-07-08,11,3,TN,US,14,416
OUTLANDER 850,2019-07-08,1,6,TN,US,7,429
OUTLANDER 450,2019-07-08,1,13,TN,US,14,385
OUTLANDER 1000,2019-07-15,14,3,TN,US,17,433
OUTLANDER 850,2019-07-15,1,7,TN,US,8,437
OUTLANDER 450,2019-07-15,12,10,TN,US,22,407
OUTLANDER 1000,2019-07-22,2,9,TN,US,11,444
OUTLANDER 850,2019-07-22,7,12,TN,US,19,456
OUTLANDER 450,2019-07-22,11,1,TN,US,12,419
OUTLANDER 1000,2019-07-29,11,9,TN,US,20,464
OUTLANDER 850,2019-07-29,6,6,TN,US,12,468
OUTLANDER 450,2019-07-29,2,9,TN,US,11,430
OUTLANDER 1000,2019-08-05,5,6,TN,US,11,475
OUTLANDER 850,2019-08-05,7,14,TN,US,21,489
OUTLANDER 450,2019-08-05,12,0,TN,US,12,442
OUTLANDER 1000,2019-08-12,2,9,TN,US,11,486
OUTLANDER 850,2019-08-12,7,7,TN,US,14,503
OUTLANDER 450,2019-08-12,14,8,TN,US,22,464
OUTLANDER 1000,2019-08-19,2,3,TN,US,5,491
OUTLANDER 850,2019-08-19,0,12,TN,US,12,515
OUTLANDER 450,2019-08-19,15,10,TN,US,25,489
OUTLANDER 1000,2019-08-26,1,8,TN,US,9,500
OUTLANDER 850,2019-08-26,9,4,TN,US,13,528
OUTLANDER 450,2019-08-26,10,11,TN,US,21,510
OUTLANDER 1000,2019-09-02,15,6,TN,US,21,521
OUTLANDER 850,2019-09-02,7,5,TN,US,12,540
OUTLANDER 450,2019-09-02,3,8,TN,US,11,521
OUTLANDER 1000,2019-09-09,7,3,TN,US,10,531
OUTLANDER 850,2019-09-09,13,1,TN,US,14,554
OUTLANDER 450,2019-09-09,14,4,TN,US,18,539
OUTLANDER 1000,2019-09-16,8,6,TN,US,14,545
OUTLANDER 850,2019-09-16,11,11,TN,US,22,576
OUTLANDER 450,2019-09-16,9,12,TN,US,21,560
OUTLANDER 1000,2019-09-23,5,14,TN,US,19,564
OUTLANDER 850,2019-09-23,6,4,TN,US,10,586
OUTLANDER 450,2019-09-23,13,3,TN,US,16,576
OUTLANDER 1000,2019-09-30,8,5,TN,US,13,577
OUTLANDER 850,2019-09-30,4,14,TN,US,18,604
OUTLANDER 450,2019-09-30,12,6,TN,US,18,594
OUTLANDER 1000,2019-10-07,12,1,TN,US,13,590
OUTLANDER 850,2019-10-07,5,8,TN,US,13,617
OUTLANDER 450,2019-10-07,3,8,TN,US,11,605
OUTLANDER 1000,2019-10-14,3,3,TN,US,6,596
OUTLANDER 850,2019-10-14,3,14,TN,US,17,634
OUTLANDER 450,2019-10-14,7,6,TN,US,13,618
OUTLANDER 1000,2019-10-21,6,7,TN,US,13,609
OUTLANDER 850,2019-10-21,7,9,TN,US,16,650
OUTLANDER 450,2019-10-21,11,12,TN,US,23,641
OUTLANDER 1000,2019-10-28,10,6,TN,US,16,625
OUTLANDER 850,2019-10-28,12,11,TN,US,23,673
OUTLANDER 450,2019-10-28,5,14,TN,US,19,660
OUTLANDER 1000,2019-11-04,2,2,TN,US,4,629
OUTLANDER 850,2019-11-04,12,8,TN,US,20,693
OUTLANDER 450,2019-11-04,3,11,TN,US,14,674
OUTLANDER 1000,2019-11-11,3,8,TN,US,11,640
OUTLANDER 850,2019-11-11,10,15,TN,US,25,718
OUTLANDER 450,2019-11-11,5,8,TN,US,13,687
OUTLANDER 1000,2019-11-18,8,10,TN,US,18,658
OUTLANDER 850,2019-11-18,11,15,TN,US,26,744
OUTLANDER 450,2019-11-18,2,0,TN,US,2,689
OUTLANDER 1000,2019-11-25,5,12,TN,US,17,675
OUTLANDER 850,2019-11-25,4,4,TN,US,8,752
OUTLANDER 450,2019-11-25,14,4,TN,US,18,707
OUTLANDER 1000,2019-12-02,8,10,TN,US,18,693
OUTLANDER 850,2019-12-02,0,8,TN,US,8,760
OUTLANDER 450,2019-12-02,2,12,TN,US,14,721
OUTLANDER 1000,2019-12-09,3,5,TN,US,8,701
OUTLANDER 850,2019-12-09,9,3,TN,US,12,772
OUTLANDER 450,2019-12-09,12,10,TN,US,22,743
OUTLANDER 1000,2019-12-16,6,4,TN,US,10,711
OUTLANDER 850,2019-12-16,3,12,TN,US,15,787
OUTLANDER 450,2019-12-16,2,10,TN,US,12,755
OUTLANDER 1000,2019-12-23,12,4,TN,US,16,727
OUTLANDER 850,2019-12-23,10,3,TN,US,13,800
OUTLANDER 450,2019-12-23,2,11,TN,US,13,768
OUTLANDER 1000,2019-12-30,4,2,TN,US,6,733
OUTLANDER 850,2019-12-30,12,1,TN,US,13,813
OUTLANDER 450,2019-12-30,9,15,TN,US,24,792
OUTLANDER 1000,2020-01-06,1,8,TN,US,9,742
OUTLANDER 850,2020-01-06,14,14,TN,US,28,841
OUTLANDER 450,2020-01-06,13,2,TN,US,15,807
OUTLANDER 1000,2020-01-13,10,1,TN,US,11,753
OUTLANDER 850,2020-01-13,3,14,TN,US,17,858
OUTLANDER 450,2020-01-13,0,10,TN,US,10,817
OUTLANDER 1000,2020-01-20,14,2,TN,US,16,769
OUTLANDER 850,2020-01-20,9,13,TN,US,22,880
OUTLANDER 450,2020-01-20,4,7,TN,US,11,828
OUTLANDER 1000,2020-01-27,11,1,TN,US,12,781
OUTLANDER 850,2020-01-27,2,9,TN,US,11,891
OUTLANDER 450,2020-01-27,2,14,TN,US,16,844
OUTLANDER 1000,2020-02-03,6,14,TN,US,20,801
OUTLANDER 850,2020-02-03,8,11,TN,US,19,910
OUTLANDER 450,2020-02-03,12,3,TN,US,15,859
OUTLANDER 1000,2020-02-10,9,3,TN,US,12,813
OUTLANDER 850,2020-02-10,1,11,TN,US,12,922
OUTLANDER 450,2020-02-10,2,3,TN,US,5,864
OUTLANDER 1000,2020-02-17,10,9,TN,US,19,832
OUTLANDER 850,2020-02-17,9,1,TN,US,10,932
OUTLANDER 450,2020-02-17,12,14,TN,US,26,890
OUTLANDER 1000,2020-02-24,7,4,TN,US,11,843
OUTLANDER 850,2020-02-24,1,10,TN,US,11,943
OUTLANDER 450,2020-02-24,5,12,TN,US,17,907
OUTLANDER 1000,2020-03-02,2,4,TN,US,6,849
OUTLANDER 850,2020-03-02,5,10,TN,US,15,958
OUTLANDER 450,2020-03-02,3,5,TN,US,8,915
OUTLANDER 1000,2020-03-09,15,8,TN,US,23,872
OUTLANDER 850,2020-03-09,9,12,TN,US,21,979
OUTLANDER 450,2020-03-09,9,8,TN,US,17,932
OUTLANDER 1000,2020-03-16,2,13,TN,US,15,887
OUTLANDER 850,2020-03-16,8,9,TN,US,17,996
OUTLANDER 450,2020-03-16,8,14,TN,US,22,954
OUTLANDER 1000,2020-03-23,4,7,TN,US,11,898
OUTLANDER 850,2020-03-23,5,2,TN,US,7,1003
OUTLANDER 450,2020-03-23,1,12,TN,US,13,967
OUTLANDER 1000,2020-03-30,0,11,TN,US,11,909
OUTLANDER 850,2020-03-30,6,7,TN,US,13,1016
OUTLANDER 450,2020-03-30,8,13,TN,US,21,988
OUTLANDER 1000,2020-04-06,8,15,TN,US,23,932
OUTLANDER 850,2020-04-06,5,4,TN,US,9,1025
OUTLANDER 450,2020-04-06,6,4,TN,US,10,998
OUTLANDER 1000,2020-04-13,5,11,TN,US,16,948
OUTLANDER 850,2020-04-13,10,4,TN,US,14,1039
OUTLANDER 450,2020-04-13,12,5,TN,US,17,1015
OUTLANDER 1000,2020-04-20,8,12,TN,US,20,968
OUTLANDER 850,2020-04-20,9,9,TN,US,18,1057
OUTLANDER 450,2020-04-20,2,0,TN,US,2,1017
OUTLANDER 1000,2020-04-27,13,2,TN,US,15,983
OUTLANDER 850,2020-04-27,12,10,TN,US,22,1079
OUTLANDER 450,2020-04-27,2,8,TN,US,10,1027
OUTLANDER 1000,2020-05-04,11,6,TN,US,17,1000
OUTLANDER 850,2020-05-04,1,14,TN,US,15,1094
OUTLANDER 450,2020-05-04,9,6,TN,US,15,1042
OUTLANDER 1000,2020-05-11,4,4,TN,US,8,1008
OUTLANDER 850,2020-05-11,3,15,TN,US,18,1112
OUTLANDER 450,2020-05-11,3,13,TN,US,16,1058
OUTLANDER 1000,2020-05-18,12,13,TN,US,25,1033
OUTLANDER 850,2020-05-18,14,12,TN,US,26,1138
OUTLANDER 450,2020-05-18,9,3,TN,US,12,1070
OUTLANDER 1000,2020-05-25,6,8,TN,US,14,1047
OUTLANDER 850,2020-05-25,6,10,TN,US,16,1154
OUTLANDER 450,2020-05-25,8,15,TN,US,23,1093
OUTLANDER 1000,2020-06-01,14,5,TN,US,19,1066
OUTLANDER 850,2020-06-01,13,7,TN,US,20,1174
OUTLANDER 450,2020-06-01,6,9,TN,US,15,1108
OUTLANDER 1000,2020-06-08,15,5,TN,US,20,1086
OUTLANDER 850,2020-06-08,3,13,TN,US,16,1190
OUTLANDER 450,2020-06-08,7,6,TN,US,13,1121
OUTLANDER 1000,2020-06-15,9,5,TN,US,14,1100
OUTLANDER 850,2020-06-15,4,0,TN,US,4,1194
OUTLANDER 450,2020-06-15,4,2,TN,US,6,1127
OUTLANDER 1000,2020-06-22,13,13,TN,US,26,1126
OUTLANDER 850,2020-06-22,7,1,TN,US,8,1202
OUTLANDER 450,2020-06-22,1,8,TN,US,9,1136
OUTLANDER 1000,2020-06-29,6,8,TN,US,14,1140
OUTLANDER 850,2020-06-29,9,15,TN,US,24,1226
OUTLANDER 450,2020-06-29,8,11,TN,US,19,1155
OUTLANDER 1000,2020-07-06,5,2,TN,US,7,1147
OUTLANDER 850,2020-07-06,0,14,TN,US,14,1240
OUTLANDER 450,2020-07-06,14,10,TN,US,24,1179
OUTLANDER 1000,2020-07-13,10,5,TN,US,15,1162
OUTLANDER 850,2020-07-13,12,5,TN,US,17,1257
OUTLANDER 450,2020-07-13,7,13,TN,US,20,1199
OUTLANDER 1000,2020-07-20,12,14,TN,US,26,1188
OUTLANDER 850,2020-07-20,11,9,TN,US,20,1277
OUTLANDER 450,2020-07-20,8,10,TN,US,18,1217
OUTLANDER 1000,2020-07-27,15,9,TN,US,24,1212
OUTLANDER 850,2020-07-27,12,9,TN,US,21,1298
OUTLANDER 450,2020-07-27,4,8,TN,US,12,1229
OUTLANDER 1000,2020-08-03,8,8,TN,US,16,1228
OUTLANDER 850,2020-08-03,1,7,TN,US,8,1306
OUTLANDER 450,2020-08-03,9,1,TN,US,10,1239
OUTLANDER 1000,2020-08-10,12,13,TN,US,25,1253
OUTLANDER 850,2020-08-10,6,10,TN,US,16,1322
OUTLANDER 450,2020-08-10,6,2,TN,US,8,1247
OUTLANDER 1000,2020-08-17,1,5,TN,US,6,1259
OUTLANDER 850,2020-08-17,10,0,TN,US,10,1332
OUTLANDER 450,2020-08-17,9,2,TN,US,11,1258
OUTLANDER 1000,2020-08-24,5,1,TN,US,6,1265
OUTLANDER 850,2020-08-24,13,9,TN,US,22,1354
OUTLANDER 450,2020-08-24,11,3,TN,US,14,1272
OUTLANDER 1000,2020-08-31,0,8,TN,US,8,1273
OUTLANDER 850,2020-08-31,13,13,TN,US,26,1380
OUTLANDER 450,2020-08-31,5,1,TN,US,6,1278
OUTLANDER 1000,2020-09-07,3,13,TN,US,16,1289
OUTLANDER 850,2020-09-07,3,14,TN,US,17,1397
OUTLANDER 450,2020-09-07,6,12,TN,US,18,1296
OUTLANDER 1000,2020-09-14,4,15,TN,US,19,1308
OUTLANDER 850,2020-09-14,3,7,TN,US,10,1407
OUTLANDER 450,2020-09-14,8,13,TN,US,21,1317
OUTLANDER 1000,2020-09-21,6,3,TN,US,9,1317
OUTLANDER 850,2020-09-21,15,12,TN,US,27,1434
OUTLANDER 450,2020-09-21,13,11,TN,US,24,1341
OUTLANDER 1000,2020-09-28,1,13,TN,US,14,1331
OUTLANDER 850,2020-09-28,14,2,TN,US,16,1450
OUTLANDER 450,2020-09-28,12,8,TN,US,20,1361
OUTLANDER 1000,2020-10-05,5,14,TN,US,19,1350
OUTLANDER 850,2020-10-05,3,4,TN,US,7,1457
OUTLANDER 450,2020-10-05,3,3,TN,US,6,1367
OUTLANDER 1000,2020-10-12,13,1,TN,US,14,1364
OUTLANDER 850,2020-10-12,15,7,TN,US,22,1479
OUTLANDER 450,2020-10-12,6,0,TN,US,6,1373
OUTLANDER 1000,2020-10-19,14,7,TN,US,21,1385
OUTLANDER 850,2020-10-19,10,15,TN,US,25,1504
OUTLANDER 450,2020-10-19,13,7,TN,US,20,1393
OUTLANDER 1000,2020-10-26,2,2,TN,US,4,1389
OUTLANDER 850,2020-10-26,4,8,TN,US,12,1516
OUTLANDER 450,2020-10-26,14,11,TN,US,25,1418
OUTLANDER 1000,2020-11-02,8,3,TN,US,11,1400
OUTLANDER 850,2020-11-02,9,8,TN,US,17,1533
OUTLANDER 450,2020-11-02,12,13,TN,US,25,1443
OUTLANDER 1000,2020-11-09,10,15,TN,US,25,1425
OUTLANDER 850,2020-11-09,12,15,TN,US,27,1560
OUTLANDER 450,2020-11-09,3,2,TN,US,5,1448
OUTLANDER 1000,2020-11-16,5,4,TN,US,9,1434
OUTLANDER 850,2020-11-16,8,13,TN,US,21,1581
OUTLANDER 450,2020-11-16,11,2,TN,US,13,1461
OUTLANDER 1000,2020-11-23,9,1,TN,US,10,1444
OUTLANDER 850,2020-11-23,6,6,TN,US,12,1593
OUTLANDER 450,2020-11-23,9,2,TN,US,11,1472
OUTLANDER 1000,2020-11-30,2,7,TN,US,9,1453
OUTLANDER 850,2020-11-30,2,3,TN,US,5,1598
OUTLANDER 450,2020-11-30,7,4,TN,US,11,1483
OUTLANDER 1000,2020-12-07,8,8,TN,US,16,1469
OUTLANDER 850,2020-12-07,11,8,TN,US,19,1617
OUTLANDER 450,2020-12-07,3,5,TN,US,8,1491
OUTLANDER 1000,2020-12-14,7,6,TN,US,13,1482
OUTLANDER 850,2020-12-14,10,9,TN,US,19,1636
OUTLANDER 450,2020-12-14,0,10,TN,US,10,1501
OUTLANDER 1000,2020-12-21,3,12,TN,US,15,1497
OUTLANDER 850,2020-12-21,7,2,TN,US,9,1645
OUTLANDER 450,2020-12-21,7,2,TN,US,9,1510
OUTLANDER 1000,2020-12-28,9,4,TN,US,13,1510
OUTLANDER 850,2020-12-28,13,7,TN,US,20,1665
OUTLANDER 450,2020-12-28,4,4,TN,US,8,1518
OUTLANDER 1000,2021-01-04,3,5,TN,US,8,1518
OUTLANDER 850,2021-01-04,6,9,TN,US,15,1680
OUTLANDER 450,2021-01-04,0,4,TN,US,4,1522
OUTLANDER 1000,2021-01-11,5,7,TN,US,12,1530
OUTLANDER 850,2021-01-11,6,14,TN,US,20,1700
OUTLANDER 450,2021-01-11,10,12,TN,US,22,1544
OUTLANDER 1000,2021-01-18,3,8,TN,US,11,1541
OUTLANDER 850,2021-01-18,5,12,TN,US,17,1717
OUTLANDER 450,2021-01-18,9,12,TN,US,21,1565
OUTLANDER 1000,2021-01-25,8,14,TN,US,22,1563
OUTLANDER 850,2021-01-25,11,12,TN,US,23,1740
OUTLANDER 450,2021-01-25,8,8,TN,US,16,1581
OUTLANDER 1000,2021-02-01,9,12,TN,US,21,1584
OUTLANDER 850,2021-02-01,14,5,TN,US,19,1759
OUTLANDER 450,2021-02-01,2,2,TN,US,4,1585
OUTLANDER 1000,2021-02-08,3,1,TN,US,4,1588
OUTLANDER 850,2021-02-08,1,7,TN,US,8,1767
OUTLANDER 450,2021-02-08,9,8,TN,US,17,1602
OUTLANDER 1000,2021-02-15,11,8,TN,US,19,1607
OUTLANDER 850,2021-02-15,15,10,TN,US,25,1792
OUTLANDER 450,2021-02-15,0,7,TN,US,7,1609
OUTLANDER 1000,2021-02-22,13,11,TN,US,24,1631
OUTLANDER 850,2021-02-22,1,10,TN,US,11,1803
OUTLANDER 450,2021-02-22,10,2,TN,US,12,1621
OUTLANDER 1000,2021-03-01,7,14,TN,US,21,1652
OUTLANDER 850,2021-03-01,4,9,TN,US,13,1816
OUTLANDER 450,2021-03-01,14,0,TN,US,14,1635
OUTLANDER 1000,2021-03-08,6,7,TN,US,13,1665
OUTLANDER 850,2021-03-08,4,13,TN,US,17,1833
OUTLANDER 450,2021-03-08,4,14,TN,US,18,1653
OUTLANDER 1000,2021-03-15,1,10,TN,US,11,1676
OUTLANDER 850,2021-03-15,6,2,TN,US,8,1841
OUTLANDER 450,2021-03-15,9,4,TN,US,13,1666
OUTLANDER 1000,2021-03-22,0,10,TN,US,10,1686
OUTLANDER 850,2021-03-22,9,5,TN,US,14,1855
OUTLANDER 450,2021-03-22,3,5,TN,US,8,1674
OUTLANDER 1000,2021-03-29,15,13,TN,US,28,1714
OUTLANDER 850,2021-03-29,13,14,TN,US,27,1882
OUTLANDER 450,2021-03-29,8,5,TN,US,13,1687
OUTLANDER 1000,2021-04-05,1,4,TN,US,5,1719
OUTLANDER 850,2021-04-05,2,5,TN,US,7,1889
OUTLANDER 450,2021-04-05,4,2,TN,US,6,1693
OUTLANDER 1000,2021-04-12,13,3,TN,US,16,1735
OUTLANDER 850,2021-04-12,11,3,TN,US,14,1903
OUTLANDER 450,2021-04-12,3,4,TN,US,7,1700
OUTLANDER 1000,2021-04-19,7,12,TN,US,19,1754
OUTLANDER 850,2021-04-19,14,7,TN,US,21,1924
OUTLANDER 450,2021-04-19,4,9,TN,US,13,1713
OUTLANDER 1000,2021-04-26,15,14,TN,US,29,1783
OUTLANDER 850,2021-04-26,14,3,TN,US,17,1941
OUTLANDER 450,2021-04-26,7,1,TN,US,8,1721
OUTLANDER 1000,2021-05-03,12,5,TN,US,17,1800
OUTLANDER 850,2021-05-03,3,10,TN,US,13,1954
OUTLANDER 450,2021-05-03,8,13,TN,US,21,1742
OUTLANDER 1000,2021-05-10,8,6,TN,US,14,1814
OUTLANDER 850,2021-05-10,13,3,TN,US,16,1970
OUTLANDER 450,2021-05-10,8,12,TN,US,20,1762
OUTLANDER 1000,2021-05-17,2,11,TN,US,13,1827
OUTLANDER 850,2021-05-17,12,8,TN,US,20,1990
OUTLANDER 450,2021-05-17,0,1,TN,US,1,1763
OUTLANDER 1000,2021-05-24,11,10,TN,US,21,1848
OUTLANDER 850,2021-05-24,8,7,TN,US,15,2005
OUTLANDER 450,2021-05-24,2,14,TN,US,16,1779
OUTLANDER 1000,2021-05-31,8,13,TN,US,21,1869
OUTLANDER 850,2021-05-31,5,11,TN,US,16,2021
OUTLANDER 450,2021-05-31,13,4,TN,US,17,1796
OUTLANDER 1000,2021-06-07,5,12,TN,US,17,1886
OUTLANDER 850,2021-06-07,11,7,TN,US,18,2039
OUTLANDER 450,2021-06-07,4,14,TN,US,18,1814
OUTLANDER 1000,2021-06-14,2,4,TN,US,6,1892
OUTLANDER 850,2021-06-14,11,4,TN,US,15,2054
OUTLANDER 450,2021-06-14,4,11,TN,US,15,1829
OUTLANDER 1000,2021-06-21,8,11,TN,US,19,1911
OUTLANDER 850,2021-06-21,0,13,TN,US,13,2067
OUTLANDER 450,2021-06-21,5,10,TN,US,15,1844
OUTLANDER 1000,2021-06-28,3,9,TN,US,12,1923
OUTLANDER 850,2021-06-28,10,5,TN,US,15,2082
OUTLANDER 450,2021-06-28,6,10,TN,US,16,1860
OUTLANDER 1000,2021-07-05,8,1,TN,US,9,1932
OUTLANDER 850,2021-07-05,9,7,TN,US,16,2098
OUTLANDER 450,2021-07-05,4,11,TN,US,15,1875
OUTLANDER 1000,2021-07-12,9,1,TN,US,10,1942
OUTLANDER 850,2021-07-12,14,8,TN,US,22,2120
OUTLANDER 450,2021-07-12,3,10,TN,US,13,1888
OUTLANDER 1000,2021-07-19,1,15,TN,US,16,1958
OUTLANDER 850,2021-07-19,10,11,TN,US,21,2141
OUTLANDER 450,2021-07-19,6,8,TN,US,14,1902
OUTLANDER 1000,2021-07-26,5,6,TN,US,11,1969
OUTLANDER 850,2021-07-26,12,10,TN,US,22,2163
OUTLANDER 450,2021-07-26,7,0,TN,US,7,1909
OUTLANDER 1000,2021-08-02,8,10,TN,US,18,1987
OUTLANDER 850,2021-08-02,10,11,TN,US,21,2184
OUTLANDER 450,2021-08-02,8,12,TN,US,20,1929
OUTLANDER 1000,2021-08-09,14,4,TN,US,18,2005
OUTLANDER 850,2021-08-09,2,0,TN,US,2,2186
OUTLANDER 450,2021-08-09,10,5,TN,US,15,1944
OUTLANDER 1000,2021-08-16,4,11,TN,US,15,2020
OUTLANDER 850,2021-08-16,1,4,TN,US,5,2191
OUTLANDER 450,2021-08-16,14,0,TN,US,14,1958
OUTLANDER 1000,2021-08-23,5,9,TN,US,14,2034
OUTLANDER 850,2021-08-23,7,9,TN,US,16,2207
OUTLANDER 450,2021-08-23,4,2,TN,US,6,1964
OUTLANDER 1000,2021-08-30,9,11,TN,US,20,2054
OUTLANDER 850,2021-08-30,8,14,TN,US,22,2229
OUTLANDER 450,2021-08-30,0,14,TN,US,14,1978
OUTLANDER 1000,2021-09-06,11,7,TN,US,18,2072
OUTLANDER 850,2021-09-06,14,7,TN,US,21,2250
OUTLANDER 450,2021-09-06,10,9,TN,US,19,1997
OUTLANDER 1000,2021-09-13,12,13,TN,US,25,2097
OUTLANDER 850,2021-09-13,11,3,TN,US,14,2264
OUTLANDER 450,2021-09-13,12,7,TN,US,19,2016
OUTLANDER 1000,2021-09-20,3,3,TN,US,6,2103
OUTLANDER 850,2021-09-20,14,7,TN,US,21,2285
OUTLANDER 450,2021-09-20,7,8,TN,US,15,2031
OUTLANDER 1000,2021-09-27,1,7,TN,US,8,2111
OUTLANDER 850,2021-09-27,8,12,TN,US,20,2305
OUTLANDER 450,2021-09-27,8,6,TN,US,14,2045
OUTLANDER 1000,2021-10-04,4,5,TN,US,9,2120
OUTLANDER 850,2021-10-04,14,6,TN,US,20,2325
OUTLANDER 450,2021-10-04,10,15,TN,US,25,2070
OUTLANDER 1000,2021-10-11,5,7,TN,US,12,2132
OUTLANDER 850,2021-10-11,2,13,TN,US,15,2340
OUTLANDER 450,2021-10-11,1,10,TN,US,11,2081
OUTLANDER 1000,2021-10-18,2,0,TN,US,2,2134
OUTLANDER 850,2021-10-18,6,7,TN,US,13,2353
OUTLANDER 450,2021-10-18,7,5,TN,US,12,2093
OUTLANDER 1000,2021-10-25,11,11,TN,US,22,2156
OUTLANDER 850,2021-10-25,3,2,TN,US,5,2358
OUTLANDER 450,2021-10-25,12,3,TN,US,15,2108
OUTLANDER 1000,2021-11-01,12,6,TN,US,18,2174
OUTLANDER 850,2021-11-01,2,8,TN,US,10,2368
OUTLANDER 450,2021-11-01,9,6,TN,US,15,2123
OUTLANDER 1000,2021-11-08,5,10,TN,US,15,2189
OUTLANDER 850,2021-11-08,5,10,TN,US,15,2383
OUTLANDER 450,2021-11-08,7,8,TN,US,15,2138
OUTLANDER 1000,2021-11-15,12,12,TN,US,24,2213
OUTLANDER 850,2021-11-15,8,14,TN,US,22,2405
OUTLANDER 450,2021-11-15,4,1,TN,US,5,2143
OUTLANDER 1000,2021-11-22,6,6,TN,US,12,2225
OUTLANDER 850,2021-11-22,1,5,TN,US,6,2411
OUTLANDER 450,2021-11-22,15,10,TN,US,25,2168
OUTLANDER 1000,2021-11-29,11,7,TN,US,18,2243
OUTLANDER 850,2021-11-29,9,2,TN,US,11,2422
OUTLANDER 450,2021-11-29,8,3,TN,US,11,2179
OUTLANDER 1000,2021-12-06,14,1,TN,US,15,2258
OUTLANDER 850,2021-12-06,4,10,TN,US,14,2436
OUTLANDER 450,2021-12-06,1,8,TN,US,9,2188
OUTLANDER 1000,2021-12-13,7,6,TN,US,13,2271
OUTLANDER 850,2021-12-13,1,11,TN,US,12,2448
OUTLANDER 450,2021-12-13,10,7,TN,US,17,2205
OUTLANDER 1000,2021-12-20,13,12,TN,US,25,2296
OUTLANDER 850,2021-12-20,2,4,TN,US,6,2454
OUTLANDER 450,2021-12-20,1,13,TN,US,14,2219
OUTLANDER 1000,2021-12-27,5,13,TN,US,18,2314
OUTLANDER 850,2021-12-27,4,5,TN,US,9,2463
OUTLANDER 450,2021-12-27,10,15,TN,US,25,2244
OUTLANDER 1000,2019-01-07,12,12,TX,US,24,24
OUTLANDER 850,2019-01-07,9,12,TX,US,21,21
OUTLANDER 450,2019-01-07,3,14,TX,US,17,17
OUTLANDER 1000,2019-01-14,3,9,TX,US,12,36
OUTLANDER 850,2019-01-14,10,7,TX,US,17,38
OUTLANDER 450,2019-01-14,8,10,TX,US,18,35
OUTLANDER 1000,2019-01-21,14,9,TX,US,23,59
OUTLANDER 850,2019-01-21,8,13,TX,US,21,59
OUTLANDER 450,2019-01-21,12,14,TX,US,26,61
OUTLANDER 1000,2019-01-28,1,4,TX,US,5,64
OUTLANDER 850,2019-01-28,14,0,TX,US,14,73
OUTLANDER 450,2019-01-28,7,1,TX,US,8,69
OUTLANDER 1000,2019-02-04,13,5,TX,US,18,82
OUTLANDER 850,2019-02-04,2,6,TX,US,8,81
OUTLANDER 450,2019-02-04,12,3,TX,US,15,84
OUTLANDER 1000,2019-02-11,13,3,TX,US,16,98
OUTLANDER 850,2019-02-11,11,7,TX,US,18,99
OUTLANDER 450,2019-02-11,11,5,TX,US,16,100
OUTLANDER 1000,2019-02-18,10,2,TX,US,12,110
OUTLANDER 850,2019-02-18,10,4,TX,US,14,113
OUTLANDER 450,2019-02-18,12,10,TX,US,22,122
OUTLANDER 1000,2019-02-25,4,8,TX,US,12,122
OUTLANDER 850,2019-02-25,10,9,TX,US,19,132
OUTLANDER 450,2019-02-25,4,4,TX,US,8,130
OUTLANDER 1000,2019-03-04,6,8,TX,US,14,136
OUTLANDER 850,2019-03-04,6,10,TX,US,16,148
OUTLANDER 450,2019-03-04,13,2,TX,US,15,145
OUTLANDER 1000,2019-03-11,5,15,TX,US,20,156
OUTLANDER 850,2019-03-11,2,14,TX,US,16,164
OUTLANDER 450,2019-03-11,13,9,TX,US,22,167
OUTLANDER 1000,2019-03-18,5,3,TX,US,8,164
OUTLANDER 850,2019-03-18,13,4,TX,US,17,181
OUTLANDER 450,2019-03-18,2,11,TX,US,13,180
OUTLANDER 1000,2019-03-25,11,1,TX,US,12,176
OUTLANDER 850,2019-03-25,8,10,TX,US,18,199
OUTLANDER 450,2019-03-25,5,9,TX,US,14,194
OUTLANDER 1000,2019-04-01,3,3,TX,US,6,182
OUTLANDER 850,2019-04-01,6,1,TX,US,7,206
OUTLANDER 450,2019-04-01,11,7,TX,US,18,212
OUTLANDER 1000,2019-04-08,10,8,TX,US,18,200
OUTLANDER 850,2019-04-08,4,15,TX,US,19,225
OUTLANDER 450,2019-04-08,8,7,TX,US,15,227
OUTLANDER 1000,2019-04-15,5,3,TX,US,8,208
OUTLANDER 850,2019-04-15,8,14,TX,US,22,247
OUTLANDER 450,2019-04-15,12,8,TX,US,20,247
OUTLANDER 1000,2019-04-22,5,9,TX,US,14,222
OUTLANDER 850,2019-04-22,10,4,TX,US,14,261
OUTLANDER 450,2019-04-22,9,12,TX,US,21,268
OUTLANDER 1000,2019-04-29,11,2,TX,US,13,235
OUTLANDER 850,2019-04-29,13,12,TX,US,25,286
OUTLANDER 450,2019-04-29,7,13,TX,US,20,288
OUTLANDER 1000,2019-05-06,12,9,TX,US,21,256
OUTLANDER 850,2019-05-06,11,3,TX,US,14,300
OUTLANDER 450,2019-05-06,12,10,TX,US,22,310
OUTLANDER 1000,2019-05-13,9,6,TX,US,15,271
OUTLANDER 850,2019-05-13,9,11,TX,US,20,320
OUTLANDER 450,2019-05-13,11,6,TX,US,17,327
OUTLANDER 1000,2019-05-20,9,3,TX,US,12,283
OUTLANDER 850,2019-05-20,9,1,TX,US,10,330
OUTLANDER 450,2019-05-20,3,11,TX,US,14,341
OUTLANDER 1000,2019-05-27,10,15,TX,US,25,308
OUTLANDER 850,2019-05-27,4,5,TX,US,9,339
OUTLANDER 450,2019-05-27,4,11,TX,US,15,356
OUTLANDER 1000,2019-06-03,10,5,TX,US,15,323
OUTLANDER 850,2019-06-03,8,12,TX,US,20,359
OUTLANDER 450,2019-06-03,11,11,TX,US,22,378
OUTLANDER 1000,2019-06-10,1,9,TX,US,10,333
OUTLANDER 850,2019-06-10,3,1,TX,US,4,363
OUTLANDER 450,2019-06-10,14,2,TX,US,16,394
OUTLANDER 1000,2019-06-17,14,13,TX,US,27,360
OUTLANDER 850,2019-06-17,10,6,TX,US,16,379
OUTLANDER 450,2019-06-17,12,13,TX,US,25,419
OUTLANDER 1000,2019-06-24,6,13,TX,US,19,379
OUTLANDER 850,2019-06-24,11,2,TX,US,13,392
OUTLANDER 450,2019-06-24,12,4,TX,US,16,435
OUTLANDER 1000,2019-07-01,8,14,TX,US,22,401
OUTLANDER 850,2019-07-01,14,15,TX,US,29,421
OUTLANDER 450,2019-07-01,15,5,TX,US,20,455
OUTLANDER 1000,2019-07-08,11,5,TX,US,16,417
OUTLANDER 850,2019-07-08,9,3,TX,US,12,433
OUTLANDER 450,2019-07-08,4,11,TX,US,15,470
OUTLANDER 1000,2019-07-15,8,13,TX,US,21,438
OUTLANDER 850,2019-07-15,15,3,TX,US,18,451
OUTLANDER 450,2019-07-15,10,4,TX,US,14,484
OUTLANDER 1000,2019-07-22,8,1,TX,US,9,447
OUTLANDER 850,2019-07-22,14,2,TX,US,16,467
OUTLANDER 450,2019-07-22,5,1,TX,US,6,490
OUTLANDER 1000,2019-07-29,9,10,TX,US,19,466
OUTLANDER 850,2019-07-29,11,14,TX,US,25,492
OUTLANDER 450,2019-07-29,0,7,TX,US,7,497
OUTLANDER 1000,2019-08-05,14,1,TX,US,15,481
OUTLANDER 850,2019-08-05,12,13,TX,US,25,517
OUTLANDER 450,2019-08-05,8,5,TX,US,13,510
OUTLANDER 1000,2019-08-12,13,15,TX,US,28,509
OUTLANDER 850,2019-08-12,5,4,TX,US,9,526
OUTLANDER 450,2019-08-12,4,6,TX,US,10,520
OUTLANDER 1000,2019-08-19,2,15,TX,US,17,526
OUTLANDER 850,2019-08-19,7,12,TX,US,19,545
OUTLANDER 450,2019-08-19,0,10,TX,US,10,530
OUTLANDER 1000,2019-08-26,14,12,TX,US,26,552
OUTLANDER 850,2019-08-26,14,5,TX,US,19,564
OUTLANDER 450,2019-08-26,7,10,TX,US,17,547
OUTLANDER 1000,2019-09-02,9,2,TX,US,11,563
OUTLANDER 850,2019-09-02,5,2,TX,US,7,571
OUTLANDER 450,2019-09-02,8,7,TX,US,15,562
OUTLANDER 1000,2019-09-09,3,2,TX,US,5,568
OUTLANDER 850,2019-09-09,5,7,TX,US,12,583
OUTLANDER 450,2019-09-09,10,3,TX,US,13,575
OUTLANDER 1000,2019-09-16,15,14,TX,US,29,597
OUTLANDER 850,2019-09-16,7,6,TX,US,13,596
OUTLANDER 450,2019-09-16,13,1,TX,US,14,589
OUTLANDER 1000,2019-09-23,3,13,TX,US,16,613
OUTLANDER 850,2019-09-23,14,10,TX,US,24,620
OUTLANDER 450,2019-09-23,9,4,TX,US,13,602
OUTLANDER 1000,2019-09-30,15,10,TX,US,25,638
OUTLANDER 850,2019-09-30,6,4,TX,US,10,630
OUTLANDER 450,2019-09-30,4,14,TX,US,18,620
OUTLANDER 1000,2019-10-07,6,9,TX,US,15,653
OUTLANDER 850,2019-10-07,6,4,TX,US,10,640
OUTLANDER 450,2019-10-07,5,10,TX,US,15,635
OUTLANDER 1000,2019-10-14,12,5,TX,US,17,670
OUTLANDER 850,2019-10-14,1,15,TX,US,16,656
OUTLANDER 450,2019-10-14,0,1,TX,US,1,636
OUTLANDER 1000,2019-10-21,12,0,TX,US,12,682
OUTLANDER 850,2019-10-21,1,4,TX,US,5,661
OUTLANDER 450,2019-10-21,8,7,TX,US,15,651
OUTLANDER 1000,2019-10-28,6,7,TX,US,13,695
OUTLANDER 850,2019-10-28,8,9,TX,US,17,678
OUTLANDER 450,2019-10-28,15,1,TX,US,16,667
OUTLANDER 1000,2019-11-04,2,5,TX,US,7,702
OUTLANDER 850,2019-11-04,0,12,TX,US,12,690
OUTLANDER 450,2019-11-04,9,4,TX,US,13,680
OUTLANDER 1000,2019-11-11,0,11,TX,US,11,713
OUTLANDER 850,2019-11-11,7,11,TX,US,18,708
OUTLANDER 450,2019-11-11,4,2,TX,US,6,686
OUTLANDER 1000,2019-11-18,1,11,TX,US,12,725
OUTLANDER 850,2019-11-18,0,2,TX,US,2,710
OUTLANDER 450,2019-11-18,7,3,TX,US,10,696
OUTLANDER 1000,2019-11-25,5,9,TX,US,14,739
OUTLANDER 850,2019-11-25,3,0,TX,US,3,713
OUTLANDER 450,2019-11-25,2,9,TX,US,11,707
OUTLANDER 1000,2019-12-02,1,10,TX,US,11,750
OUTLANDER 850,2019-12-02,10,15,TX,US,25,738
OUTLANDER 450,2019-12-02,1,13,TX,US,14,721
OUTLANDER 1000,2019-12-09,11,1,TX,US,12,762
OUTLANDER 850,2019-12-09,10,9,TX,US,19,757
OUTLANDER 450,2019-12-09,1,11,TX,US,12,733
OUTLANDER 1000,2019-12-16,10,10,TX,US,20,782
OUTLANDER 850,2019-12-16,1,12,TX,US,13,770
OUTLANDER 450,2019-12-16,1,9,TX,US,10,743
OUTLANDER 1000,2019-12-23,6,10,TX,US,16,798
OUTLANDER 850,2019-12-23,10,2,TX,US,12,782
OUTLANDER 450,2019-12-23,6,10,TX,US,16,759
OUTLANDER 1000,2019-12-30,5,5,TX,US,10,808
OUTLANDER 850,2019-12-30,7,12,TX,US,19,801
OUTLANDER 450,2019-12-30,2,9,TX,US,11,770
OUTLANDER 1000,2020-01-06,14,14,TX,US,28,836
OUTLANDER 850,2020-01-06,10,14,TX,US,24,825
OUTLANDER 450,2020-01-06,3,8,TX,US,11,781
OUTLANDER 1000,2020-01-13,1,12,TX,US,13,849
OUTLANDER 850,2020-01-13,13,4,TX,US,17,842
OUTLANDER 450,2020-01-13,5,12,TX,US,17,798
OUTLANDER 1000,2020-01-20,3,14,TX,US,17,866
OUTLANDER 850,2020-01-20,4,5,TX,US,9,851
OUTLANDER 450,2020-01-20,8,1,TX,US,9,807
OUTLANDER 1000,2020-01-27,14,10,TX,US,24,890
OUTLANDER 850,2020-01-27,3,5,TX,US,8,859
OUTLANDER 450,2020-01-27,3,3,TX,US,6,813
OUTLANDER 1000,2020-02-03,3,0,TX,US,3,893
OUTLANDER 850,2020-02-03,11,9,TX,US,20,879
OUTLANDER 450,2020-02-03,1,12,TX,US,13,826
OUTLANDER 1000,2020-02-10,13,7,TX,US,20,913
OUTLANDER 850,2020-02-10,1,4,TX,US,5,884
OUTLANDER 450,2020-02-10,5,1,TX,US,6,832
OUTLANDER 1000,2020-02-17,2,9,TX,US,11,924
OUTLANDER 850,2020-02-17,7,14,TX,US,21,905
OUTLANDER 450,2020-02-17,4,1,TX,US,5,837
OUTLANDER 1000,2020-02-24,11,3,TX,US,14,938
OUTLANDER 850,2020-02-24,5,3,TX,US,8,913
OUTLANDER 450,2020-02-24,1,7,TX,US,8,845
OUTLANDER 1000,2020-03-02,15,8,TX,US,23,961
OUTLANDER 850,2020-03-02,8,10,TX,US,18,931
OUTLANDER 450,2020-03-02,14,11,TX,US,25,870
OUTLANDER 1000,2020-03-09,11,3,TX,US,14,975
OUTLANDER 850,2020-03-09,11,5,TX,US,16,947
OUTLANDER 450,2020-03-09,14,3,TX,US,17,887
OUTLANDER 1000,2020-03-16,3,2,TX,US,5,980
OUTLANDER 850,2020-03-16,8,8,TX,US,16,963
OUTLANDER 450,2020-03-16,8,6,TX,US,14,901
OUTLANDER 1000,2020-03-23,9,10,TX,US,19,999
OUTLANDER 850,2020-03-23,13,14,TX,US,27,990
OUTLANDER 450,2020-03-23,3,3,TX,US,6,907
OUTLANDER 1000,2020-03-30,14,2,TX,US,16,1015
OUTLANDER 850,2020-03-30,12,13,TX,US,25,1015
OUTLANDER 450,2020-03-30,13,3,TX,US,16,923
OUTLANDER 1000,2020-04-06,2,12,TX,US,14,1029
OUTLANDER 850,2020-04-06,10,7,TX,US,17,1032
OUTLANDER 450,2020-04-06,8,5,TX,US,13,936
OUTLANDER 1000,2020-04-13,8,8,TX,US,16,1045
OUTLANDER 850,2020-04-13,11,2,TX,US,13,1045
OUTLANDER 450,2020-04-13,15,8,TX,US,23,959
OUTLANDER 1000,2020-04-20,9,14,TX,US,23,1068
OUTLANDER 850,2020-04-20,6,5,TX,US,11,1056
OUTLANDER 450,2020-04-20,8,5,TX,US,13,972
OUTLANDER 1000,2020-04-27,14,5,TX,US,19,1087
OUTLANDER 850,2020-04-27,5,8,TX,US,13,1069
OUTLANDER 450,2020-04-27,2,2,TX,US,4,976
OUTLANDER 1000,2020-05-04,1,5,TX,US,6,1093
OUTLANDER 850,2020-05-04,13,4,TX,US,17,1086
OUTLANDER 450,2020-05-04,1,5,TX,US,6,982
OUTLANDER 1000,2020-05-11,8,5,TX,US,13,1106
OUTLANDER 850,2020-05-11,15,3,TX,US,18,1104
OUTLANDER 450,2020-05-11,9,10,TX,US,19,1001
OUTLANDER 1000,2020-05-18,8,5,TX,US,13,1119
OUTLANDER 850,2020-05-18,6,14,TX,US,20,1124
OUTLANDER 450,2020-05-18,1,5,TX,US,6,1007
OUTLANDER 1000,2020-05-25,10,5,TX,US,15,1134
OUTLANDER 850,2020-05-25,11,11,TX,US,22,1146
OUTLANDER 450,2020-05-25,4,13,TX,US,17,1024
OUTLANDER 1000,2020-06-01,2,6,TX,US,8,1142
OUTLANDER 850,2020-06-01,10,7,TX,US,17,1163
OUTLANDER 450,2020-06-01,4,0,TX,US,4,1028
OUTLANDER 1000,2020-06-08,8,3,TX,US,11,1153
OUTLANDER 850,2020-06-08,15,6,TX,US,21,1184
OUTLANDER 450,2020-06-08,8,2,TX,US,10,1038
OUTLANDER 1000,2020-06-15,5,1,TX,US,6,1159
OUTLANDER 850,2020-06-15,15,14,TX,US,29,1213
OUTLANDER 450,2020-06-15,15,6,TX,US,21,1059
OUTLANDER 1000,2020-06-22,14,11,TX,US,25,1184
OUTLANDER 850,2020-06-22,15,14,TX,US,29,1242
OUTLANDER 450,2020-06-22,11,8,TX,US,19,1078
OUTLANDER 1000,2020-06-29,0,14,TX,US,14,1198
OUTLANDER 850,2020-06-29,9,12,TX,US,21,1263
OUTLANDER 450,2020-06-29,4,10,TX,US,14,1092
OUTLANDER 1000,2020-07-06,14,2,TX,US,16,1214
OUTLANDER 850,2020-07-06,5,3,TX,US,8,1271
OUTLANDER 450,2020-07-06,5,15,TX,US,20,1112
OUTLANDER 1000,2020-07-13,7,12,TX,US,19,1233
OUTLANDER 850,2020-07-13,3,13,TX,US,16,1287
OUTLANDER 450,2020-07-13,10,8,TX,US,18,1130
OUTLANDER 1000,2020-07-20,10,11,TX,US,21,1254
OUTLANDER 850,2020-07-20,8,12,TX,US,20,1307
OUTLANDER 450,2020-07-20,11,10,TX,US,21,1151
OUTLANDER 1000,2020-07-27,9,8,TX,US,17,1271
OUTLANDER 850,2020-07-27,0,9,TX,US,9,1316
OUTLANDER 450,2020-07-27,2,4,TX,US,6,1157
OUTLANDER 1000,2020-08-03,8,4,TX,US,12,1283
OUTLANDER 850,2020-08-03,2,4,TX,US,6,1322
OUTLANDER 450,2020-08-03,1,12,TX,US,13,1170
OUTLANDER 1000,2020-08-10,14,2,TX,US,16,1299
OUTLANDER 850,2020-08-10,3,9,TX,US,12,1334
OUTLANDER 450,2020-08-10,13,6,TX,US,19,1189
OUTLANDER 1000,2020-08-17,14,3,TX,US,17,1316
OUTLANDER 850,2020-08-17,3,0,TX,US,3,1337
OUTLANDER 450,2020-08-17,15,1,TX,US,16,1205
OUTLANDER 1000,2020-08-24,14,4,TX,US,18,1334
OUTLANDER 850,2020-08-24,12,4,TX,US,16,1353
OUTLANDER 450,2020-08-24,4,0,TX,US,4,1209
OUTLANDER 1000,2020-08-31,9,0,TX,US,9,1343
OUTLANDER 850,2020-08-31,11,1,TX,US,12,1365
OUTLANDER 450,2020-08-31,5,13,TX,US,18,1227
OUTLANDER 1000,2020-09-07,8,4,TX,US,12,1355
OUTLANDER 850,2020-09-07,4,10,TX,US,14,1379
OUTLANDER 450,2020-09-07,13,11,TX,US,24,1251
OUTLANDER 1000,2020-09-14,11,9,TX,US,20,1375
OUTLANDER 850,2020-09-14,12,4,TX,US,16,1395
OUTLANDER 450,2020-09-14,5,9,TX,US,14,1265
OUTLANDER 1000,2020-09-21,9,12,TX,US,21,1396
OUTLANDER 850,2020-09-21,8,13,TX,US,21,1416
OUTLANDER 450,2020-09-21,12,1,TX,US,13,1278
OUTLANDER 1000,2020-09-28,4,8,TX,US,12,1408
OUTLANDER 850,2020-09-28,11,2,TX,US,13,1429
OUTLANDER 450,2020-09-28,10,9,TX,US,19,1297
OUTLANDER 1000,2020-10-05,11,6,TX,US,17,1425
OUTLANDER 850,2020-10-05,8,9,TX,US,17,1446
OUTLANDER 450,2020-10-05,3,12,TX,US,15,1312
OUTLANDER 1000,2020-10-12,14,12,TX,US,26,1451
OUTLANDER 850,2020-10-12,1,14,TX,US,15,1461
OUTLANDER 450,2020-10-12,12,10,TX,US,22,1334
OUTLANDER 1000,2020-10-19,5,5,TX,US,10,1461
OUTLANDER 850,2020-10-19,14,7,TX,US,21,1482
OUTLANDER 450,2020-10-19,11,4,TX,US,15,1349
OUTLANDER 1000,2020-10-26,11,5,TX,US,16,1477
OUTLANDER 850,2020-10-26,9,15,TX,US,24,1506
OUTLANDER 450,2020-10-26,14,14,TX,US,28,1377
OUTLANDER 1000,2020-11-02,8,1,TX,US,9,1486
OUTLANDER 850,2020-11-02,6,14,TX,US,20,1526
OUTLANDER 450,2020-11-02,9,12,TX,US,21,1398
OUTLANDER 1000,2020-11-09,3,4,TX,US,7,1493
OUTLANDER 850,2020-11-09,4,0,TX,US,4,1530
OUTLANDER 450,2020-11-09,1,7,TX,US,8,1406
OUTLANDER 1000,2020-11-16,8,9,TX,US,17,1510
OUTLANDER 850,2020-11-16,3,3,TX,US,6,1536
OUTLANDER 450,2020-11-16,5,6,TX,US,11,1417
OUTLANDER 1000,2020-11-23,7,11,TX,US,18,1528
OUTLANDER 850,2020-11-23,7,12,TX,US,19,1555
OUTLANDER 450,2020-11-23,4,8,TX,US,12,1429
OUTLANDER 1000,2020-11-30,7,15,TX,US,22,1550
OUTLANDER 850,2020-11-30,6,4,TX,US,10,1565
OUTLANDER 450,2020-11-30,11,3,TX,US,14,1443
OUTLANDER 1000,2020-12-07,2,10,TX,US,12,1562
OUTLANDER 850,2020-12-07,2,14,TX,US,16,1581
OUTLANDER 450,2020-12-07,7,5,TX,US,12,1455
OUTLANDER 1000,2020-12-14,6,0,TX,US,6,1568
OUTLANDER 850,2020-12-14,5,1,TX,US,6,1587
OUTLANDER 450,2020-12-14,13,3,TX,US,16,1471
OUTLANDER 1000,2020-12-21,6,15,TX,US,21,1589
OUTLANDER 850,2020-12-21,12,4,TX,US,16,1603
OUTLANDER 450,2020-12-21,4,0,TX,US,4,1475
OUTLANDER 1000,2020-12-28,3,5,TX,US,8,1597
OUTLANDER 850,2020-12-28,1,11,TX,US,12,1615
OUTLANDER 450,2020-12-28,3,14,TX,US,17,1492
OUTLANDER 1000,2021-01-04,14,9,TX,US,23,1620
OUTLANDER 850,2021-01-04,8,13,TX,US,21,1636
OUTLANDER 450,2021-01-04,7,15,TX,US,22,1514
OUTLANDER 1000,2021-01-11,7,5,TX,US,12,1632
OUTLANDER 850,2021-01-11,11,2,TX,US,13,1649
OUTLANDER 450,2021-01-11,12,7,TX,US,19,1533
OUTLANDER 1000,2021-01-18,11,5,TX,US,16,1648
OUTLANDER 850,2021-01-18,11,12,TX,US,23,1672
OUTLANDER 450,2021-01-18,8,2,TX,US,10,1543
OUTLANDER 1000,2021-01-25,10,13,TX,US,23,1671
OUTLANDER 850,2021-01-25,0,1,TX,US,1,1673
OUTLANDER 450,2021-01-25,14,5,TX,US,19,1562
OUTLANDER 1000,2021-02-01,10,14,TX,US,24,1695
OUTLANDER 850,2021-02-01,1,5,TX,US,6,1679
OUTLANDER 450,2021-02-01,12,5,TX,US,17,1579
OUTLANDER 1000,2021-02-08,2,8,TX,US,10,1705
OUTLANDER 850,2021-02-08,13,7,TX,US,20,1699
OUTLANDER 450,2021-02-08,1,0,TX,US,1,1580
OUTLANDER 1000,2021-02-15,15,8,TX,US,23,1728
OUTLANDER 850,2021-02-15,13,5,TX,US,18,1717
OUTLANDER 450,2021-02-15,9,14,TX,US,23,1603
OUTLANDER 1000,2021-02-22,11,2,TX,US,13,1741
OUTLANDER 850,2021-02-22,6,6,TX,US,12,1729
OUTLANDER 450,2021-02-22,7,13,TX,US,20,1623
OUTLANDER 1000,2021-03-01,1,8,TX,US,9,1750
OUTLANDER 850,2021-03-01,8,7,TX,US,15,1744
OUTLANDER 450,2021-03-01,13,10,TX,US,23,1646
OUTLANDER 1000,2021-03-08,0,4,TX,US,4,1754
OUTLANDER 850,2021-03-08,0,8,TX,US,8,1752
OUTLANDER 450,2021-03-08,4,5,TX,US,9,1655
OUTLANDER 1000,2021-03-15,12,11,TX,US,23,1777
OUTLANDER 850,2021-03-15,7,14,TX,US,21,1773
OUTLANDER 450,2021-03-15,8,7,TX,US,15,1670
OUTLANDER 1000,2021-03-22,9,3,TX,US,12,1789
OUTLANDER 850,2021-03-22,9,7,TX,US,16,1789
OUTLANDER 450,2021-03-22,7,3,TX,US,10,1680
OUTLANDER 1000,2021-03-29,8,12,TX,US,20,1809
OUTLANDER 850,2021-03-29,4,4,TX,US,8,1797
OUTLANDER 450,2021-03-29,13,4,TX,US,17,1697
OUTLANDER 1000,2021-04-05,12,11,TX,US,23,1832
OUTLANDER 850,2021-04-05,9,9,TX,US,18,1815
OUTLANDER 450,2021-04-05,10,13,TX,US,23,1720
OUTLANDER 1000,2021-04-12,12,9,TX,US,21,1853
OUTLANDER 850,2021-04-12,7,5,TX,US,12,1827
OUTLANDER 450,2021-04-12,9,10,TX,US,19,1739
OUTLANDER 1000,2021-04-19,13,12,TX,US,25,1878
OUTLANDER 850,2021-04-19,3,13,TX,US,16,1843
OUTLANDER 450,2021-04-19,2,3,TX,US,5,1744
OUTLANDER 1000,2021-04-26,15,1,TX,US,16,1894
OUTLANDER 850,2021-04-26,15,6,TX,US,21,1864
OUTLANDER 450,2021-04-26,11,5,TX,US,16,1760
OUTLANDER 1000,2021-05-03,9,9,TX,US,18,1912
OUTLANDER 850,2021-05-03,11,1,TX,US,12,1876
OUTLANDER 450,2021-05-03,12,10,TX,US,22,1782
OUTLANDER 1000,2021-05-10,12,9,TX,US,21,1933
OUTLANDER 850,2021-05-10,0,9,TX,US,9,1885
OUTLANDER 450,2021-05-10,8,5,TX,US,13,1795
OUTLANDER 1000,2021-05-17,10,13,TX,US,23,1956
OUTLANDER 850,2021-05-17,4,8,TX,US,12,1897
OUTLANDER 450,2021-05-17,1,12,TX,US,13,1808
OUTLANDER 1000,2021-05-24,11,5,TX,US,16,1972
OUTLANDER 850,2021-05-24,6,13,TX,US,19,1916
OUTLANDER 450,2021-05-24,11,14,TX,US,25,1833
OUTLANDER 1000,2021-05-31,14,12,TX,US,26,1998
OUTLANDER 850,2021-05-31,6,5,TX,US,11,1927
OUTLANDER 450,2021-05-31,13,13,TX,US,26,1859
OUTLANDER 1000,2021-06-07,15,2,TX,US,17,2015
OUTLANDER 850,2021-06-07,2,14,TX,US,16,1943
OUTLANDER 450,2021-06-07,12,2,TX,US,14,1873
OUTLANDER 1000,2021-06-14,6,2,TX,US,8,2023
OUTLANDER 850,2021-06-14,14,6,TX,US,20,1963
OUTLANDER 450,2021-06-14,1,3,TX,US,4,1877
OUTLANDER 1000,2021-06-21,1,8,TX,US,9,2032
OUTLANDER 850,2021-06-21,11,0,TX,US,11,1974
OUTLANDER 450,2021-06-21,11,7,TX,US,18,1895
OUTLANDER 1000,2021-06-28,6,5,TX,US,11,2043
OUTLANDER 850,2021-06-28,10,0,TX,US,10,1984
OUTLANDER 450,2021-06-28,6,5,TX,US,11,1906
OUTLANDER 1000,2021-07-05,8,12,TX,US,20,2063
OUTLANDER 850,2021-07-05,4,12,TX,US,16,2000
OUTLANDER 450,2021-07-05,8,14,TX,US,22,1928
OUTLANDER 1000,2021-07-12,7,7,TX,US,14,2077
OUTLANDER 850,2021-07-12,11,14,TX,US,25,2025
OUTLANDER 450,2021-07-12,14,6,TX,US,20,1948
OUTLANDER 1000,2021-07-19,3,8,TX,US,11,2088
OUTLANDER 850,2021-07-19,14,6,TX,US,20,2045
OUTLANDER 450,2021-07-19,1,10,TX,US,11,1959
OUTLANDER 1000,2021-07-26,11,12,TX,US,23,2111
OUTLANDER 850,2021-07-26,6,8,TX,US,14,2059
OUTLANDER 450,2021-07-26,7,1,TX,US,8,1967
OUTLANDER 1000,2021-08-02,15,14,TX,US,29,2140
OUTLANDER 850,2021-08-02,13,6,TX,US,19,2078
OUTLANDER 450,2021-08-02,1,10,TX,US,11,1978
OUTLANDER 1000,2021-08-09,14,1,TX,US,15,2155
OUTLANDER 850,2021-08-09,5,1,TX,US,6,2084
OUTLANDER 450,2021-08-09,12,8,TX,US,20,1998
OUTLANDER 1000,2021-08-16,5,14,TX,US,19,2174
OUTLANDER 850,2021-08-16,9,8,TX,US,17,2101
OUTLANDER 450,2021-08-16,13,1,TX,US,14,2012
OUTLANDER 1000,2021-08-23,14,13,TX,US,27,2201
OUTLANDER 850,2021-08-23,2,8,TX,US,10,2111
OUTLANDER 450,2021-08-23,11,4,TX,US,15,2027
OUTLANDER 1000,2021-08-30,2,7,TX,US,9,2210
OUTLANDER 850,2021-08-30,13,6,TX,US,19,2130
OUTLANDER 450,2021-08-30,7,4,TX,US,11,2038
OUTLANDER 1000,2021-09-06,14,13,TX,US,27,2237
OUTLANDER 850,2021-09-06,8,12,TX,US,20,2150
OUTLANDER 450,2021-09-06,10,3,TX,US,13,2051
OUTLANDER 1000,2021-09-13,15,0,TX,US,15,2252
OUTLANDER 850,2021-09-13,5,14,TX,US,19,2169
OUTLANDER 450,2021-09-13,4,7,TX,US,11,2062
OUTLANDER 1000,2021-09-20,8,8,TX,US,16,2268
OUTLANDER 850,2021-09-20,3,13,TX,US,16,2185
OUTLANDER 450,2021-09-20,4,1,TX,US,5,2067
OUTLANDER 1000,2021-09-27,9,4,TX,US,13,2281
OUTLANDER 850,2021-09-27,14,7,TX,US,21,2206
OUTLANDER 450,2021-09-27,0,9,TX,US,9,2076
OUTLANDER 1000,2021-10-04,9,5,TX,US,14,2295
OUTLANDER 850,2021-10-04,11,5,TX,US,16,2222
OUTLANDER 450,2021-10-04,2,9,TX,US,11,2087
OUTLANDER 1000,2021-10-11,12,14,TX,US,26,2321
OUTLANDER 850,2021-10-11,1,1,TX,US,2,2224
OUTLANDER 450,2021-10-11,4,9,TX,US,13,2100
OUTLANDER 1000,2021-10-18,8,13,TX,US,21,2342
OUTLANDER 850,2021-10-18,5,10,TX,US,15,2239
OUTLANDER 450,2021-10-18,11,10,TX,US,21,2121
OUTLANDER 1000,2021-10-25,0,14,TX,US,14,2356
OUTLANDER 850,2021-10-25,15,1,TX,US,16,2255
OUTLANDER 450,2021-10-25,3,13,TX,US,16,2137
OUTLANDER 1000,2021-11-01,10,4,TX,US,14,2370
OUTLANDER 850,2021-11-01,14,12,TX,US,26,2281
OUTLANDER 450,2021-11-01,14,12,TX,US,26,2163
OUTLANDER 1000,2021-11-08,13,3,TX,US,16,2386
OUTLANDER 850,2021-11-08,8,8,TX,US,16,2297
OUTLANDER 450,2021-11-08,6,6,TX,US,12,2175
OUTLANDER 1000,2021-11-15,7,6,TX,US,13,2399
OUTLANDER 850,2021-11-15,14,1,TX,US,15,2312
OUTLANDER 450,2021-11-15,2,14,TX,US,16,2191
OUTLANDER 1000,2021-11-22,3,9,TX,US,12,2411
OUTLANDER 850,2021-11-22,2,8,TX,US,10,2322
OUTLANDER 450,2021-11-22,3,15,TX,US,18,2209
OUTLANDER 1000,2021-11-29,12,9,TX,US,21,2432
OUTLANDER 850,2021-11-29,14,0,TX,US,14,2336
OUTLANDER 450,2021-11-29,7,11,TX,US,18,2227
OUTLANDER 1000,2021-12-06,13,2,TX,US,15,2447
OUTLANDER 850,2021-12-06,14,3,TX,US,17,2353
OUTLANDER 450,2021-12-06,6,8,TX,US,14,2241
OUTLANDER 1000,2021-12-13,10,8,TX,US,18,2465
OUTLANDER 850,2021-12-13,11,10,TX,US,21,2374
OUTLANDER 450,2021-12-13,8,0,TX,US,8,2249
OUTLANDER 1000,2021-12-20,2,3,TX,US,5,2470
OUTLANDER 850,2021-12-20,2,14,TX,US,16,2390
OUTLANDER 450,2021-12-20,4,6,TX,US,10,2259
OUTLANDER 1000,2021-12-27,9,10,TX,US,19,2489
OUTLANDER 850,2021-12-27,1,12,TX,US,13,2403
OUTLANDER 450,2021-12-27,2,2,TX,US,4,2263
OUTLANDER 1000,2019-01-07,10,0,UT,US,10,10
OUTLANDER 850,2019-01-07,4,6,UT,US,10,10
OUTLANDER 450,2019-01-07,8,3,UT,US,11,11
OUTLANDER 1000,2019-01-14,7,5,UT,US,12,22
OUTLANDER 850,2019-01-14,4,12,UT,US,16,26
OUTLANDER 450,2019-01-14,10,3,UT,US,13,24
OUTLANDER 1000,2019-01-21,5,11,UT,US,16,38
OUTLANDER 850,2019-01-21,1,10,UT,US,11,37
OUTLANDER 450,2019-01-21,3,0,UT,US,3,27
OUTLANDER 1000,2019-01-28,1,5,UT,US,6,44
OUTLANDER 850,2019-01-28,9,7,UT,US,16,53
OUTLANDER 450,2019-01-28,13,4,UT,US,17,44
OUTLANDER 1000,2019-02-04,1,2,UT,US,3,47
OUTLANDER 850,2019-02-04,13,8,UT,US,21,74
OUTLANDER 450,2019-02-04,5,1,UT,US,6,50
OUTLANDER 1000,2019-02-11,12,1,UT,US,13,60
OUTLANDER 850,2019-02-11,9,4,UT,US,13,87
OUTLANDER 450,2019-02-11,2,8,UT,US,10,60
OUTLANDER 1000,2019-02-18,10,7,UT,US,17,77
OUTLANDER 850,2019-02-18,11,11,UT,US,22,109
OUTLANDER 450,2019-02-18,9,10,UT,US,19,79
OUTLANDER 1000,2019-02-25,6,3,UT,US,9,86
OUTLANDER 850,2019-02-25,8,1,UT,US,9,118
OUTLANDER 450,2019-02-25,10,1,UT,US,11,90
OUTLANDER 1000,2019-03-04,8,15,UT,US,23,109
OUTLANDER 850,2019-03-04,9,7,UT,US,16,134
OUTLANDER 450,2019-03-04,11,5,UT,US,16,106
OUTLANDER 1000,2019-03-11,7,9,UT,US,16,125
OUTLANDER 850,2019-03-11,8,8,UT,US,16,150
OUTLANDER 450,2019-03-11,7,1,UT,US,8,114
OUTLANDER 1000,2019-03-18,14,1,UT,US,15,140
OUTLANDER 850,2019-03-18,9,14,UT,US,23,173
OUTLANDER 450,2019-03-18,8,9,UT,US,17,131
OUTLANDER 1000,2019-03-25,5,9,UT,US,14,154
OUTLANDER 850,2019-03-25,5,2,UT,US,7,180
OUTLANDER 450,2019-03-25,4,11,UT,US,15,146
OUTLANDER 1000,2019-04-01,5,1,UT,US,6,160
OUTLANDER 850,2019-04-01,10,4,UT,US,14,194
OUTLANDER 450,2019-04-01,6,3,UT,US,9,155
OUTLANDER 1000,2019-04-08,12,4,UT,US,16,176
OUTLANDER 850,2019-04-08,3,5,UT,US,8,202
OUTLANDER 450,2019-04-08,12,15,UT,US,27,182
OUTLANDER 1000,2019-04-15,1,13,UT,US,14,190
OUTLANDER 850,2019-04-15,14,15,UT,US,29,231
OUTLANDER 450,2019-04-15,12,4,UT,US,16,198
OUTLANDER 1000,2019-04-22,9,8,UT,US,17,207
OUTLANDER 850,2019-04-22,11,11,UT,US,22,253
OUTLANDER 450,2019-04-22,2,14,UT,US,16,214
OUTLANDER 1000,2019-04-29,3,4,UT,US,7,214
OUTLANDER 850,2019-04-29,14,8,UT,US,22,275
OUTLANDER 450,2019-04-29,10,10,UT,US,20,234
OUTLANDER 1000,2019-05-06,4,2,UT,US,6,220
OUTLANDER 850,2019-05-06,1,12,UT,US,13,288
OUTLANDER 450,2019-05-06,12,10,UT,US,22,256
OUTLANDER 1000,2019-05-13,10,12,UT,US,22,242
OUTLANDER 850,2019-05-13,2,2,UT,US,4,292
OUTLANDER 450,2019-05-13,5,14,UT,US,19,275
OUTLANDER 1000,2019-05-20,4,2,UT,US,6,248
OUTLANDER 850,2019-05-20,8,5,UT,US,13,305
OUTLANDER 450,2019-05-20,2,0,UT,US,2,277
OUTLANDER 1000,2019-05-27,13,14,UT,US,27,275
OUTLANDER 850,2019-05-27,14,6,UT,US,20,325
OUTLANDER 450,2019-05-27,6,10,UT,US,16,293
OUTLANDER 1000,2019-06-03,4,6,UT,US,10,285
OUTLANDER 850,2019-06-03,11,6,UT,US,17,342
OUTLANDER 450,2019-06-03,2,12,UT,US,14,307
OUTLANDER 1000,2019-06-10,11,1,UT,US,12,297
OUTLANDER 850,2019-06-10,9,6,UT,US,15,357
OUTLANDER 450,2019-06-10,5,5,UT,US,10,317
OUTLANDER 1000,2019-06-17,6,15,UT,US,21,318
OUTLANDER 850,2019-06-17,7,4,UT,US,11,368
OUTLANDER 450,2019-06-17,11,12,UT,US,23,340
OUTLANDER 1000,2019-06-24,12,8,UT,US,20,338
OUTLANDER 850,2019-06-24,13,1,UT,US,14,382
OUTLANDER 450,2019-06-24,3,13,UT,US,16,356
OUTLANDER 1000,2019-07-01,11,11,UT,US,22,360
OUTLANDER 850,2019-07-01,2,2,UT,US,4,386
OUTLANDER 450,2019-07-01,5,1,UT,US,6,362
OUTLANDER 1000,2019-07-08,7,9,UT,US,16,376
OUTLANDER 850,2019-07-08,4,9,UT,US,13,399
OUTLANDER 450,2019-07-08,14,5,UT,US,19,381
OUTLANDER 1000,2019-07-15,9,6,UT,US,15,391
OUTLANDER 850,2019-07-15,13,11,UT,US,24,423
OUTLANDER 450,2019-07-15,7,12,UT,US,19,400
OUTLANDER 1000,2019-07-22,3,6,UT,US,9,400
OUTLANDER 850,2019-07-22,12,12,UT,US,24,447
OUTLANDER 450,2019-07-22,14,11,UT,US,25,425
OUTLANDER 1000,2019-07-29,5,14,UT,US,19,419
OUTLANDER 850,2019-07-29,7,1,UT,US,8,455
OUTLANDER 450,2019-07-29,7,12,UT,US,19,444
OUTLANDER 1000,2019-08-05,3,12,UT,US,15,434
OUTLANDER 850,2019-08-05,14,11,UT,US,25,480
OUTLANDER 450,2019-08-05,5,13,UT,US,18,462
OUTLANDER 1000,2019-08-12,3,15,UT,US,18,452
OUTLANDER 850,2019-08-12,10,15,UT,US,25,505
OUTLANDER 450,2019-08-12,14,9,UT,US,23,485
OUTLANDER 1000,2019-08-19,12,15,UT,US,27,479
OUTLANDER 850,2019-08-19,4,7,UT,US,11,516
OUTLANDER 450,2019-08-19,14,4,UT,US,18,503
OUTLANDER 1000,2019-08-26,11,15,UT,US,26,505
OUTLANDER 850,2019-08-26,11,9,UT,US,20,536
OUTLANDER 450,2019-08-26,13,7,UT,US,20,523
OUTLANDER 1000,2019-09-02,15,1,UT,US,16,521
OUTLANDER 850,2019-09-02,10,9,UT,US,19,555
OUTLANDER 450,2019-09-02,10,14,UT,US,24,547
OUTLANDER 1000,2019-09-09,9,6,UT,US,15,536
OUTLANDER 850,2019-09-09,3,6,UT,US,9,564
OUTLANDER 450,2019-09-09,6,3,UT,US,9,556
OUTLANDER 1000,2019-09-16,3,7,UT,US,10,546
OUTLANDER 850,2019-09-16,6,5,UT,US,11,575
OUTLANDER 450,2019-09-16,0,11,UT,US,11,567
OUTLANDER 1000,2019-09-23,12,14,UT,US,26,572
OUTLANDER 850,2019-09-23,1,6,UT,US,7,582
OUTLANDER 450,2019-09-23,8,6,UT,US,14,581
OUTLANDER 1000,2019-09-30,11,2,UT,US,13,585
OUTLANDER 850,2019-09-30,0,13,UT,US,13,595
OUTLANDER 450,2019-09-30,4,12,UT,US,16,597
OUTLANDER 1000,2019-10-07,14,12,UT,US,26,611
OUTLANDER 850,2019-10-07,8,14,UT,US,22,617
OUTLANDER 450,2019-10-07,3,10,UT,US,13,610
OUTLANDER 1000,2019-10-14,14,15,UT,US,29,640
OUTLANDER 850,2019-10-14,6,13,UT,US,19,636
OUTLANDER 450,2019-10-14,13,5,UT,US,18,628
OUTLANDER 1000,2019-10-21,1,5,UT,US,6,646
OUTLANDER 850,2019-10-21,10,5,UT,US,15,651
OUTLANDER 450,2019-10-21,12,7,UT,US,19,647
OUTLANDER 1000,2019-10-28,1,4,UT,US,5,651
OUTLANDER 850,2019-10-28,6,11,UT,US,17,668
OUTLANDER 450,2019-10-28,12,11,UT,US,23,670
OUTLANDER 1000,2019-11-04,4,12,UT,US,16,667
OUTLANDER 850,2019-11-04,6,14,UT,US,20,688
OUTLANDER 450,2019-11-04,4,10,UT,US,14,684
OUTLANDER 1000,2019-11-11,14,2,UT,US,16,683
OUTLANDER 850,2019-11-11,0,13,UT,US,13,701
OUTLANDER 450,2019-11-11,3,0,UT,US,3,687
OUTLANDER 1000,2019-11-18,3,1,UT,US,4,687
OUTLANDER 850,2019-11-18,0,9,UT,US,9,710
OUTLANDER 450,2019-11-18,12,8,UT,US,20,707
OUTLANDER 1000,2019-11-25,4,13,UT,US,17,704
OUTLANDER 850,2019-11-25,5,3,UT,US,8,718
OUTLANDER 450,2019-11-25,15,5,UT,US,20,727
OUTLANDER 1000,2019-12-02,9,1,UT,US,10,714
OUTLANDER 850,2019-12-02,5,2,UT,US,7,725
OUTLANDER 450,2019-12-02,1,1,UT,US,2,729
OUTLANDER 1000,2019-12-09,11,5,UT,US,16,730
OUTLANDER 850,2019-12-09,8,0,UT,US,8,733
OUTLANDER 450,2019-12-09,12,4,UT,US,16,745
OUTLANDER 1000,2019-12-16,7,8,UT,US,15,745
OUTLANDER 850,2019-12-16,1,4,UT,US,5,738
OUTLANDER 450,2019-12-16,6,6,UT,US,12,757
OUTLANDER 1000,2019-12-23,4,4,UT,US,8,753
OUTLANDER 850,2019-12-23,13,14,UT,US,27,765
OUTLANDER 450,2019-12-23,10,14,UT,US,24,781
OUTLANDER 1000,2019-12-30,5,14,UT,US,19,772
OUTLANDER 850,2019-12-30,4,13,UT,US,17,782
OUTLANDER 450,2019-12-30,13,0,UT,US,13,794
OUTLANDER 1000,2020-01-06,2,9,UT,US,11,783
OUTLANDER 850,2020-01-06,9,4,UT,US,13,795
OUTLANDER 450,2020-01-06,14,8,UT,US,22,816
OUTLANDER 1000,2020-01-13,1,6,UT,US,7,790
OUTLANDER 850,2020-01-13,11,8,UT,US,19,814
OUTLANDER 450,2020-01-13,15,12,UT,US,27,843
OUTLANDER 1000,2020-01-20,11,6,UT,US,17,807
OUTLANDER 850,2020-01-20,9,1,UT,US,10,824
OUTLANDER 450,2020-01-20,7,6,UT,US,13,856
OUTLANDER 1000,2020-01-27,8,4,UT,US,12,819
OUTLANDER 850,2020-01-27,5,7,UT,US,12,836
OUTLANDER 450,2020-01-27,3,10,UT,US,13,869
OUTLANDER 1000,2020-02-03,8,5,UT,US,13,832
OUTLANDER 850,2020-02-03,12,4,UT,US,16,852
OUTLANDER 450,2020-02-03,8,11,UT,US,19,888
OUTLANDER 1000,2020-02-10,10,10,UT,US,20,852
OUTLANDER 850,2020-02-10,2,6,UT,US,8,860
OUTLANDER 450,2020-02-10,9,11,UT,US,20,908
OUTLANDER 1000,2020-02-17,3,1,UT,US,4,856
OUTLANDER 850,2020-02-17,13,4,UT,US,17,877
OUTLANDER 450,2020-02-17,5,12,UT,US,17,925
OUTLANDER 1000,2020-02-24,6,9,UT,US,15,871
OUTLANDER 850,2020-02-24,1,7,UT,US,8,885
OUTLANDER 450,2020-02-24,7,8,UT,US,15,940
OUTLANDER 1000,2020-03-02,13,7,UT,US,20,891
OUTLANDER 850,2020-03-02,12,1,UT,US,13,898
OUTLANDER 450,2020-03-02,1,14,UT,US,15,955
OUTLANDER 1000,2020-03-09,5,9,UT,US,14,905
OUTLANDER 850,2020-03-09,2,11,UT,US,13,911
OUTLANDER 450,2020-03-09,3,6,UT,US,9,964
OUTLANDER 1000,2020-03-16,13,13,UT,US,26,931
OUTLANDER 850,2020-03-16,9,0,UT,US,9,920
OUTLANDER 450,2020-03-16,6,15,UT,US,21,985
OUTLANDER 1000,2020-03-23,8,15,UT,US,23,954
OUTLANDER 850,2020-03-23,5,11,UT,US,16,936
OUTLANDER 450,2020-03-23,3,4,UT,US,7,992
OUTLANDER 1000,2020-03-30,13,14,UT,US,27,981
OUTLANDER 850,2020-03-30,2,10,UT,US,12,948
OUTLANDER 450,2020-03-30,6,0,UT,US,6,998
OUTLANDER 1000,2020-04-06,11,8,UT,US,19,1000
OUTLANDER 850,2020-04-06,7,1,UT,US,8,956
OUTLANDER 450,2020-04-06,10,1,UT,US,11,1009
OUTLANDER 1000,2020-04-13,1,2,UT,US,3,1003
OUTLANDER 850,2020-04-13,3,13,UT,US,16,972
OUTLANDER 450,2020-04-13,13,3,UT,US,16,1025
OUTLANDER 1000,2020-04-20,5,0,UT,US,5,1008
OUTLANDER 850,2020-04-20,3,11,UT,US,14,986
OUTLANDER 450,2020-04-20,1,8,UT,US,9,1034
OUTLANDER 1000,2020-04-27,13,10,UT,US,23,1031
OUTLANDER 850,2020-04-27,2,0,UT,US,2,988
OUTLANDER 450,2020-04-27,5,1,UT,US,6,1040
OUTLANDER 1000,2020-05-04,14,11,UT,US,25,1056
OUTLANDER 850,2020-05-04,2,3,UT,US,5,993
OUTLANDER 450,2020-05-04,7,2,UT,US,9,1049
OUTLANDER 1000,2020-05-11,10,14,UT,US,24,1080
OUTLANDER 850,2020-05-11,14,0,UT,US,14,1007
OUTLANDER 450,2020-05-11,0,11,UT,US,11,1060
OUTLANDER 1000,2020-05-18,3,7,UT,US,10,1090
OUTLANDER 850,2020-05-18,9,8,UT,US,17,1024
OUTLANDER 450,2020-05-18,3,0,UT,US,3,1063
OUTLANDER 1000,2020-05-25,10,5,UT,US,15,1105
OUTLANDER 850,2020-05-25,8,9,UT,US,17,1041
OUTLANDER 450,2020-05-25,8,1,UT,US,9,1072
OUTLANDER 1000,2020-06-01,1,9,UT,US,10,1115
OUTLANDER 850,2020-06-01,9,6,UT,US,15,1056
OUTLANDER 450,2020-06-01,1,10,UT,US,11,1083
OUTLANDER 1000,2020-06-08,10,14,UT,US,24,1139
OUTLANDER 850,2020-06-08,7,15,UT,US,22,1078
OUTLANDER 450,2020-06-08,15,2,UT,US,17,1100
OUTLANDER 1000,2020-06-15,15,9,UT,US,24,1163
OUTLANDER 850,2020-06-15,12,7,UT,US,19,1097
OUTLANDER 450,2020-06-15,12,14,UT,US,26,1126
OUTLANDER 1000,2020-06-22,10,3,UT,US,13,1176
OUTLANDER 850,2020-06-22,9,5,UT,US,14,1111
OUTLANDER 450,2020-06-22,2,11,UT,US,13,1139
OUTLANDER 1000,2020-06-29,10,11,UT,US,21,1197
OUTLANDER 850,2020-06-29,14,14,UT,US,28,1139
OUTLANDER 450,2020-06-29,3,9,UT,US,12,1151
OUTLANDER 1000,2020-07-06,4,12,UT,US,16,1213
OUTLANDER 850,2020-07-06,1,3,UT,US,4,1143
OUTLANDER 450,2020-07-06,13,9,UT,US,22,1173
OUTLANDER 1000,2020-07-13,5,13,UT,US,18,1231
OUTLANDER 850,2020-07-13,13,8,UT,US,21,1164
OUTLANDER 450,2020-07-13,9,9,UT,US,18,1191
OUTLANDER 1000,2020-07-20,10,15,UT,US,25,1256
OUTLANDER 850,2020-07-20,9,9,UT,US,18,1182
OUTLANDER 450,2020-07-20,4,10,UT,US,14,1205
OUTLANDER 1000,2020-07-27,13,1,UT,US,14,1270
OUTLANDER 850,2020-07-27,1,9,UT,US,10,1192
OUTLANDER 450,2020-07-27,7,2,UT,US,9,1214
OUTLANDER 1000,2020-08-03,12,3,UT,US,15,1285
OUTLANDER 850,2020-08-03,13,4,UT,US,17,1209
OUTLANDER 450,2020-08-03,14,1,UT,US,15,1229
OUTLANDER 1000,2020-08-10,12,15,UT,US,27,1312
OUTLANDER 850,2020-08-10,11,3,UT,US,14,1223
OUTLANDER 450,2020-08-10,2,4,UT,US,6,1235
OUTLANDER 1000,2020-08-17,3,1,UT,US,4,1316
OUTLANDER 850,2020-08-17,3,10,UT,US,13,1236
OUTLANDER 450,2020-08-17,0,1,UT,US,1,1236
OUTLANDER 1000,2020-08-24,2,1,UT,US,3,1319
OUTLANDER 850,2020-08-24,4,6,UT,US,10,1246
OUTLANDER 450,2020-08-24,7,13,UT,US,20,1256
OUTLANDER 1000,2020-08-31,6,4,UT,US,10,1329
OUTLANDER 850,2020-08-31,8,4,UT,US,12,1258
OUTLANDER 450,2020-08-31,10,11,UT,US,21,1277
OUTLANDER 1000,2020-09-07,10,13,UT,US,23,1352
OUTLANDER 850,2020-09-07,12,9,UT,US,21,1279
OUTLANDER 450,2020-09-07,0,1,UT,US,1,1278
OUTLANDER 1000,2020-09-14,4,14,UT,US,18,1370
OUTLANDER 850,2020-09-14,4,14,UT,US,18,1297
OUTLANDER 450,2020-09-14,5,10,UT,US,15,1293
OUTLANDER 1000,2020-09-21,3,14,UT,US,17,1387
OUTLANDER 850,2020-09-21,5,13,UT,US,18,1315
OUTLANDER 450,2020-09-21,1,13,UT,US,14,1307
OUTLANDER 1000,2020-09-28,5,4,UT,US,9,1396
OUTLANDER 850,2020-09-28,0,10,UT,US,10,1325
OUTLANDER 450,2020-09-28,5,8,UT,US,13,1320
OUTLANDER 1000,2020-10-05,8,11,UT,US,19,1415
OUTLANDER 850,2020-10-05,7,12,UT,US,19,1344
OUTLANDER 450,2020-10-05,12,14,UT,US,26,1346
OUTLANDER 1000,2020-10-12,6,9,UT,US,15,1430
OUTLANDER 850,2020-10-12,6,1,UT,US,7,1351
OUTLANDER 450,2020-10-12,7,9,UT,US,16,1362
OUTLANDER 1000,2020-10-19,13,15,UT,US,28,1458
OUTLANDER 850,2020-10-19,14,1,UT,US,15,1366
OUTLANDER 450,2020-10-19,5,10,UT,US,15,1377
OUTLANDER 1000,2020-10-26,10,0,UT,US,10,1468
OUTLANDER 850,2020-10-26,12,14,UT,US,26,1392
OUTLANDER 450,2020-10-26,11,9,UT,US,20,1397
OUTLANDER 1000,2020-11-02,6,5,UT,US,11,1479
OUTLANDER 850,2020-11-02,2,4,UT,US,6,1398
OUTLANDER 450,2020-11-02,3,12,UT,US,15,1412
OUTLANDER 1000,2020-11-09,13,1,UT,US,14,1493
OUTLANDER 850,2020-11-09,12,1,UT,US,13,1411
OUTLANDER 450,2020-11-09,9,2,UT,US,11,1423
OUTLANDER 1000,2020-11-16,7,7,UT,US,14,1507
OUTLANDER 850,2020-11-16,13,3,UT,US,16,1427
OUTLANDER 450,2020-11-16,1,13,UT,US,14,1437
OUTLANDER 1000,2020-11-23,9,7,UT,US,16,1523
OUTLANDER 850,2020-11-23,2,7,UT,US,9,1436
OUTLANDER 450,2020-11-23,6,6,UT,US,12,1449
OUTLANDER 1000,2020-11-30,12,0,UT,US,12,1535
OUTLANDER 850,2020-11-30,5,5,UT,US,10,1446
OUTLANDER 450,2020-11-30,12,14,UT,US,26,1475
OUTLANDER 1000,2020-12-07,10,14,UT,US,24,1559
OUTLANDER 850,2020-12-07,5,5,UT,US,10,1456
OUTLANDER 450,2020-12-07,0,1,UT,US,1,1476
OUTLANDER 1000,2020-12-14,2,8,UT,US,10,1569
OUTLANDER 850,2020-12-14,2,4,UT,US,6,1462
OUTLANDER 450,2020-12-14,11,7,UT,US,18,1494
OUTLANDER 1000,2020-12-21,14,8,UT,US,22,1591
OUTLANDER 850,2020-12-21,8,10,UT,US,18,1480
OUTLANDER 450,2020-12-21,10,1,UT,US,11,1505
OUTLANDER 1000,2020-12-28,15,12,UT,US,27,1618
OUTLANDER 850,2020-12-28,12,4,UT,US,16,1496
OUTLANDER 450,2020-12-28,8,14,UT,US,22,1527
OUTLANDER 1000,2021-01-04,14,6,UT,US,20,1638
OUTLANDER 850,2021-01-04,10,1,UT,US,11,1507
OUTLANDER 450,2021-01-04,9,3,UT,US,12,1539
OUTLANDER 1000,2021-01-11,8,10,UT,US,18,1656
OUTLANDER 850,2021-01-11,5,3,UT,US,8,1515
OUTLANDER 450,2021-01-11,10,2,UT,US,12,1551
OUTLANDER 1000,2021-01-18,8,10,UT,US,18,1674
OUTLANDER 850,2021-01-18,7,11,UT,US,18,1533
OUTLANDER 450,2021-01-18,11,9,UT,US,20,1571
OUTLANDER 1000,2021-01-25,11,2,UT,US,13,1687
OUTLANDER 850,2021-01-25,8,13,UT,US,21,1554
OUTLANDER 450,2021-01-25,1,9,UT,US,10,1581
OUTLANDER 1000,2021-02-01,12,6,UT,US,18,1705
OUTLANDER 850,2021-02-01,8,5,UT,US,13,1567
OUTLANDER 450,2021-02-01,3,3,UT,US,6,1587
OUTLANDER 1000,2021-02-08,4,11,UT,US,15,1720
OUTLANDER 850,2021-02-08,13,14,UT,US,27,1594
OUTLANDER 450,2021-02-08,7,12,UT,US,19,1606
OUTLANDER 1000,2021-02-15,13,11,UT,US,24,1744
OUTLANDER 850,2021-02-15,15,4,UT,US,19,1613
OUTLANDER 450,2021-02-15,11,9,UT,US,20,1626
OUTLANDER 1000,2021-02-22,12,0,UT,US,12,1756
OUTLANDER 850,2021-02-22,2,6,UT,US,8,1621
OUTLANDER 450,2021-02-22,5,6,UT,US,11,1637
OUTLANDER 1000,2021-03-01,4,12,UT,US,16,1772
OUTLANDER 850,2021-03-01,5,10,UT,US,15,1636
OUTLANDER 450,2021-03-01,9,8,UT,US,17,1654
OUTLANDER 1000,2021-03-08,15,8,UT,US,23,1795
OUTLANDER 850,2021-03-08,8,11,UT,US,19,1655
OUTLANDER 450,2021-03-08,12,7,UT,US,19,1673
OUTLANDER 1000,2021-03-15,12,8,UT,US,20,1815
OUTLANDER 850,2021-03-15,14,11,UT,US,25,1680
OUTLANDER 450,2021-03-15,5,9,UT,US,14,1687
OUTLANDER 1000,2021-03-22,11,0,UT,US,11,1826
OUTLANDER 850,2021-03-22,14,9,UT,US,23,1703
OUTLANDER 450,2021-03-22,9,3,UT,US,12,1699
OUTLANDER 1000,2021-03-29,13,8,UT,US,21,1847
OUTLANDER 850,2021-03-29,5,0,UT,US,5,1708
OUTLANDER 450,2021-03-29,8,10,UT,US,18,1717
OUTLANDER 1000,2021-04-05,11,2,UT,US,13,1860
OUTLANDER 850,2021-04-05,12,6,UT,US,18,1726
OUTLANDER 450,2021-04-05,9,8,UT,US,17,1734
OUTLANDER 1000,2021-04-12,3,8,UT,US,11,1871
OUTLANDER 850,2021-04-12,13,4,UT,US,17,1743
OUTLANDER 450,2021-04-12,4,10,UT,US,14,1748
OUTLANDER 1000,2021-04-19,2,6,UT,US,8,1879
OUTLANDER 850,2021-04-19,7,2,UT,US,9,1752
OUTLANDER 450,2021-04-19,3,11,UT,US,14,1762
OUTLANDER 1000,2021-04-26,14,4,UT,US,18,1897
OUTLANDER 850,2021-04-26,0,2,UT,US,2,1754
OUTLANDER 450,2021-04-26,4,2,UT,US,6,1768
OUTLANDER 1000,2021-05-03,12,0,UT,US,12,1909
OUTLANDER 850,2021-05-03,2,14,UT,US,16,1770
OUTLANDER 450,2021-05-03,10,0,UT,US,10,1778
OUTLANDER 1000,2021-05-10,3,12,UT,US,15,1924
OUTLANDER 850,2021-05-10,8,2,UT,US,10,1780
OUTLANDER 450,2021-05-10,2,1,UT,US,3,1781
OUTLANDER 1000,2021-05-17,4,12,UT,US,16,1940
OUTLANDER 850,2021-05-17,11,12,UT,US,23,1803
OUTLANDER 450,2021-05-17,0,1,UT,US,1,1782
OUTLANDER 1000,2021-05-24,6,15,UT,US,21,1961
OUTLANDER 850,2021-05-24,13,3,UT,US,16,1819
OUTLANDER 450,2021-05-24,3,7,UT,US,10,1792
OUTLANDER 1000,2021-05-31,1,15,UT,US,16,1977
OUTLANDER 850,2021-05-31,10,2,UT,US,12,1831
OUTLANDER 450,2021-05-31,15,6,UT,US,21,1813
OUTLANDER 1000,2021-06-07,6,6,UT,US,12,1989
OUTLANDER 850,2021-06-07,15,9,UT,US,24,1855
OUTLANDER 450,2021-06-07,2,8,UT,US,10,1823
OUTLANDER 1000,2021-06-14,3,3,UT,US,6,1995
OUTLANDER 850,2021-06-14,14,1,UT,US,15,1870
OUTLANDER 450,2021-06-14,7,11,UT,US,18,1841
OUTLANDER 1000,2021-06-21,0,4,UT,US,4,1999
OUTLANDER 850,2021-06-21,11,0,UT,US,11,1881
OUTLANDER 450,2021-06-21,4,11,UT,US,15,1856
OUTLANDER 1000,2021-06-28,9,11,UT,US,20,2019
OUTLANDER 850,2021-06-28,4,13,UT,US,17,1898
OUTLANDER 450,2021-06-28,11,1,UT,US,12,1868
OUTLANDER 1000,2021-07-05,13,7,UT,US,20,2039
OUTLANDER 850,2021-07-05,12,4,UT,US,16,1914
OUTLANDER 450,2021-07-05,0,3,UT,US,3,1871
OUTLANDER 1000,2021-07-12,6,3,UT,US,9,2048
OUTLANDER 850,2021-07-12,4,5,UT,US,9,1923
OUTLANDER 450,2021-07-12,13,0,UT,US,13,1884
OUTLANDER 1000,2021-07-19,7,1,UT,US,8,2056
OUTLANDER 850,2021-07-19,3,10,UT,US,13,1936
OUTLANDER 450,2021-07-19,5,3,UT,US,8,1892
OUTLANDER 1000,2021-07-26,4,5,UT,US,9,2065
OUTLANDER 850,2021-07-26,8,4,UT,US,12,1948
OUTLANDER 450,2021-07-26,10,15,UT,US,25,1917
OUTLANDER 1000,2021-08-02,6,0,UT,US,6,2071
OUTLANDER 850,2021-08-02,3,5,UT,US,8,1956
OUTLANDER 450,2021-08-02,15,6,UT,US,21,1938
OUTLANDER 1000,2021-08-09,10,13,UT,US,23,2094
OUTLANDER 850,2021-08-09,6,11,UT,US,17,1973
OUTLANDER 450,2021-08-09,13,10,UT,US,23,1961
OUTLANDER 1000,2021-08-16,12,13,UT,US,25,2119
OUTLANDER 850,2021-08-16,4,0,UT,US,4,1977
OUTLANDER 450,2021-08-16,1,1,UT,US,2,1963
OUTLANDER 1000,2021-08-23,4,7,UT,US,11,2130
OUTLANDER 850,2021-08-23,0,13,UT,US,13,1990
OUTLANDER 450,2021-08-23,8,11,UT,US,19,1982
OUTLANDER 1000,2021-08-30,10,14,UT,US,24,2154
OUTLANDER 850,2021-08-30,5,5,UT,US,10,2000
OUTLANDER 450,2021-08-30,15,12,UT,US,27,2009
OUTLANDER 1000,2021-09-06,4,4,UT,US,8,2162
OUTLANDER 850,2021-09-06,13,13,UT,US,26,2026
OUTLANDER 450,2021-09-06,15,7,UT,US,22,2031
OUTLANDER 1000,2021-09-13,13,5,UT,US,18,2180
OUTLANDER 850,2021-09-13,7,11,UT,US,18,2044
OUTLANDER 450,2021-09-13,7,5,UT,US,12,2043
OUTLANDER 1000,2021-09-20,1,15,UT,US,16,2196
OUTLANDER 850,2021-09-20,15,8,UT,US,23,2067
OUTLANDER 450,2021-09-20,13,2,UT,US,15,2058
OUTLANDER 1000,2021-09-27,8,3,UT,US,11,2207
OUTLANDER 850,2021-09-27,4,6,UT,US,10,2077
OUTLANDER 450,2021-09-27,7,2,UT,US,9,2067
OUTLANDER 1000,2021-10-04,8,15,UT,US,23,2230
OUTLANDER 850,2021-10-04,2,5,UT,US,7,2084
OUTLANDER 450,2021-10-04,2,7,UT,US,9,2076
OUTLANDER 1000,2021-10-11,2,6,UT,US,8,2238
OUTLANDER 850,2021-10-11,6,4,UT,US,10,2094
OUTLANDER 450,2021-10-11,13,9,UT,US,22,2098
OUTLANDER 1000,2021-10-18,3,2,UT,US,5,2243
OUTLANDER 850,2021-10-18,11,10,UT,US,21,2115
OUTLANDER 450,2021-10-18,4,3,UT,US,7,2105
OUTLANDER 1000,2021-10-25,12,5,UT,US,17,2260
OUTLANDER 850,2021-10-25,11,5,UT,US,16,2131
OUTLANDER 450,2021-10-25,11,11,UT,US,22,2127
OUTLANDER 1000,2021-11-01,4,4,UT,US,8,2268
OUTLANDER 850,2021-11-01,5,15,UT,US,20,2151
OUTLANDER 450,2021-11-01,10,3,UT,US,13,2140
OUTLANDER 1000,2021-11-08,6,8,UT,US,14,2282
OUTLANDER 850,2021-11-08,1,11,UT,US,12,2163
OUTLANDER 450,2021-11-08,1,8,UT,US,9,2149
OUTLANDER 1000,2021-11-15,10,12,UT,US,22,2304
OUTLANDER 850,2021-11-15,13,7,UT,US,20,2183
OUTLANDER 450,2021-11-15,7,14,UT,US,21,2170
OUTLANDER 1000,2021-11-22,6,2,UT,US,8,2312
OUTLANDER 850,2021-11-22,14,1,UT,US,15,2198
OUTLANDER 450,2021-11-22,8,7,UT,US,15,2185
OUTLANDER 1000,2021-11-29,0,8,UT,US,8,2320
OUTLANDER 850,2021-11-29,13,3,UT,US,16,2214
OUTLANDER 450,2021-11-29,9,4,UT,US,13,2198
OUTLANDER 1000,2021-12-06,12,4,UT,US,16,2336
OUTLANDER 850,2021-12-06,1,2,UT,US,3,2217
OUTLANDER 450,2021-12-06,5,11,UT,US,16,2214
OUTLANDER 1000,2021-12-13,2,2,UT,US,4,2340
OUTLANDER 850,2021-12-13,9,8,UT,US,17,2234
OUTLANDER 450,2021-12-13,7,11,UT,US,18,2232
OUTLANDER 1000,2021-12-20,5,3,UT,US,8,2348
OUTLANDER 850,2021-12-20,8,7,UT,US,15,2249
OUTLANDER 450,2021-12-20,3,3,UT,US,6,2238
OUTLANDER 1000,2021-12-27,2,6,UT,US,8,2356
OUTLANDER 850,2021-12-27,1,4,UT,US,5,2254
OUTLANDER 450,2021-12-27,15,13,UT,US,28,2266
OUTLANDER 1000,2019-01-07,9,4,VT,US,13,13
OUTLANDER 850,2019-01-07,5,11,VT,US,16,16
OUTLANDER 450,2019-01-07,3,6,VT,US,9,9
OUTLANDER 1000,2019-01-14,7,4,VT,US,11,24
OUTLANDER 850,2019-01-14,0,10,VT,US,10,26
OUTLANDER 450,2019-01-14,12,14,VT,US,26,35
OUTLANDER 1000,2019-01-21,2,10,VT,US,12,36
OUTLANDER 850,2019-01-21,8,9,VT,US,17,43
OUTLANDER 450,2019-01-21,0,5,VT,US,5,40
OUTLANDER 1000,2019-01-28,7,1,VT,US,8,44
OUTLANDER 850,2019-01-28,1,6,VT,US,7,50
OUTLANDER 450,2019-01-28,8,12,VT,US,20,60
OUTLANDER 1000,2019-02-04,9,1,VT,US,10,54
OUTLANDER 850,2019-02-04,10,11,VT,US,21,71
OUTLANDER 450,2019-02-04,6,0,VT,US,6,66
OUTLANDER 1000,2019-02-11,2,2,VT,US,4,58
OUTLANDER 850,2019-02-11,2,10,VT,US,12,83
OUTLANDER 450,2019-02-11,1,6,VT,US,7,73
OUTLANDER 1000,2019-02-18,11,6,VT,US,17,75
OUTLANDER 850,2019-02-18,6,10,VT,US,16,99
OUTLANDER 450,2019-02-18,1,3,VT,US,4,77
OUTLANDER 1000,2019-02-25,7,12,VT,US,19,94
OUTLANDER 850,2019-02-25,15,2,VT,US,17,116
OUTLANDER 450,2019-02-25,13,3,VT,US,16,93
OUTLANDER 1000,2019-03-04,4,9,VT,US,13,107
OUTLANDER 850,2019-03-04,3,14,VT,US,17,133
OUTLANDER 450,2019-03-04,8,6,VT,US,14,107
OUTLANDER 1000,2019-03-11,13,5,VT,US,18,125
OUTLANDER 850,2019-03-11,14,11,VT,US,25,158
OUTLANDER 450,2019-03-11,13,0,VT,US,13,120
OUTLANDER 1000,2019-03-18,9,4,VT,US,13,138
OUTLANDER 850,2019-03-18,5,2,VT,US,7,165
OUTLANDER 450,2019-03-18,5,13,VT,US,18,138
OUTLANDER 1000,2019-03-25,10,10,VT,US,20,158
OUTLANDER 850,2019-03-25,8,12,VT,US,20,185
OUTLANDER 450,2019-03-25,0,7,VT,US,7,145
OUTLANDER 1000,2019-04-01,6,7,VT,US,13,171
OUTLANDER 850,2019-04-01,1,13,VT,US,14,199
OUTLANDER 450,2019-04-01,13,2,VT,US,15,160
OUTLANDER 1000,2019-04-08,12,7,VT,US,19,190
OUTLANDER 850,2019-04-08,10,9,VT,US,19,218
OUTLANDER 450,2019-04-08,13,8,VT,US,21,181
OUTLANDER 1000,2019-04-15,5,1,VT,US,6,196
OUTLANDER 850,2019-04-15,10,7,VT,US,17,235
OUTLANDER 450,2019-04-15,1,13,VT,US,14,195
OUTLANDER 1000,2019-04-22,13,14,VT,US,27,223
OUTLANDER 850,2019-04-22,4,12,VT,US,16,251
OUTLANDER 450,2019-04-22,8,9,VT,US,17,212
OUTLANDER 1000,2019-04-29,10,10,VT,US,20,243
OUTLANDER 850,2019-04-29,11,6,VT,US,17,268
OUTLANDER 450,2019-04-29,7,14,VT,US,21,233
OUTLANDER 1000,2019-05-06,4,13,VT,US,17,260
OUTLANDER 850,2019-05-06,10,0,VT,US,10,278
OUTLANDER 450,2019-05-06,5,4,VT,US,9,242
OUTLANDER 1000,2019-05-13,3,2,VT,US,5,265
OUTLANDER 850,2019-05-13,13,10,VT,US,23,301
OUTLANDER 450,2019-05-13,7,12,VT,US,19,261
OUTLANDER 1000,2019-05-20,11,3,VT,US,14,279
OUTLANDER 850,2019-05-20,10,15,VT,US,25,326
OUTLANDER 450,2019-05-20,13,7,VT,US,20,281
OUTLANDER 1000,2019-05-27,6,1,VT,US,7,286
OUTLANDER 850,2019-05-27,15,6,VT,US,21,347
OUTLANDER 450,2019-05-27,11,12,VT,US,23,304
OUTLANDER 1000,2019-06-03,2,8,VT,US,10,296
OUTLANDER 850,2019-06-03,10,0,VT,US,10,357
OUTLANDER 450,2019-06-03,3,14,VT,US,17,321
OUTLANDER 1000,2019-06-10,13,4,VT,US,17,313
OUTLANDER 850,2019-06-10,13,14,VT,US,27,384
OUTLANDER 450,2019-06-10,12,3,VT,US,15,336
OUTLANDER 1000,2019-06-17,10,7,VT,US,17,330
OUTLANDER 850,2019-06-17,0,9,VT,US,9,393
OUTLANDER 450,2019-06-17,4,6,VT,US,10,346
OUTLANDER 1000,2019-06-24,8,5,VT,US,13,343
OUTLANDER 850,2019-06-24,13,4,VT,US,17,410
OUTLANDER 450,2019-06-24,11,10,VT,US,21,367
OUTLANDER 1000,2019-07-01,14,8,VT,US,22,365
OUTLANDER 850,2019-07-01,11,13,VT,US,24,434
OUTLANDER 450,2019-07-01,11,10,VT,US,21,388
OUTLANDER 1000,2019-07-08,8,10,VT,US,18,383
OUTLANDER 850,2019-07-08,13,5,VT,US,18,452
OUTLANDER 450,2019-07-08,11,12,VT,US,23,411
OUTLANDER 1000,2019-07-15,10,15,VT,US,25,408
OUTLANDER 850,2019-07-15,2,10,VT,US,12,464
OUTLANDER 450,2019-07-15,13,14,VT,US,27,438
OUTLANDER 1000,2019-07-22,3,12,VT,US,15,423
OUTLANDER 850,2019-07-22,1,2,VT,US,3,467
OUTLANDER 450,2019-07-22,4,12,VT,US,16,454
OUTLANDER 1000,2019-07-29,11,10,VT,US,21,444
OUTLANDER 850,2019-07-29,0,5,VT,US,5,472
OUTLANDER 450,2019-07-29,10,10,VT,US,20,474
OUTLANDER 1000,2019-08-05,9,11,VT,US,20,464
OUTLANDER 850,2019-08-05,0,4,VT,US,4,476
OUTLANDER 450,2019-08-05,12,6,VT,US,18,492
OUTLANDER 1000,2019-08-12,5,9,VT,US,14,478
OUTLANDER 850,2019-08-12,3,12,VT,US,15,491
OUTLANDER 450,2019-08-12,12,1,VT,US,13,505
OUTLANDER 1000,2019-08-19,9,1,VT,US,10,488
OUTLANDER 850,2019-08-19,2,5,VT,US,7,498
OUTLANDER 450,2019-08-19,9,8,VT,US,17,522
OUTLANDER 1000,2019-08-26,0,13,VT,US,13,501
OUTLANDER 850,2019-08-26,8,1,VT,US,9,507
OUTLANDER 450,2019-08-26,0,5,VT,US,5,527
OUTLANDER 1000,2019-09-02,14,8,VT,US,22,523
OUTLANDER 850,2019-09-02,5,6,VT,US,11,518
OUTLANDER 450,2019-09-02,5,11,VT,US,16,543
OUTLANDER 1000,2019-09-09,10,0,VT,US,10,533
OUTLANDER 850,2019-09-09,5,4,VT,US,9,527
OUTLANDER 450,2019-09-09,3,9,VT,US,12,555
OUTLANDER 1000,2019-09-16,8,5,VT,US,13,546
OUTLANDER 850,2019-09-16,13,13,VT,US,26,553
OUTLANDER 450,2019-09-16,7,10,VT,US,17,572
OUTLANDER 1000,2019-09-23,4,5,VT,US,9,555
OUTLANDER 850,2019-09-23,12,14,VT,US,26,579
OUTLANDER 450,2019-09-23,15,6,VT,US,21,593
OUTLANDER 1000,2019-09-30,4,13,VT,US,17,572
OUTLANDER 850,2019-09-30,9,10,VT,US,19,598
OUTLANDER 450,2019-09-30,13,6,VT,US,19,612
OUTLANDER 1000,2019-10-07,11,5,VT,US,16,588
OUTLANDER 850,2019-10-07,1,11,VT,US,12,610
OUTLANDER 450,2019-10-07,10,11,VT,US,21,633
OUTLANDER 1000,2019-10-14,12,9,VT,US,21,609
OUTLANDER 850,2019-10-14,10,8,VT,US,18,628
OUTLANDER 450,2019-10-14,7,4,VT,US,11,644
OUTLANDER 1000,2019-10-21,12,7,VT,US,19,628
OUTLANDER 850,2019-10-21,15,9,VT,US,24,652
OUTLANDER 450,2019-10-21,9,4,VT,US,13,657
OUTLANDER 1000,2019-10-28,2,7,VT,US,9,637
OUTLANDER 850,2019-10-28,5,4,VT,US,9,661
OUTLANDER 450,2019-10-28,8,4,VT,US,12,669
OUTLANDER 1000,2019-11-04,9,7,VT,US,16,653
OUTLANDER 850,2019-11-04,11,0,VT,US,11,672
OUTLANDER 450,2019-11-04,10,9,VT,US,19,688
OUTLANDER 1000,2019-11-11,2,14,VT,US,16,669
OUTLANDER 850,2019-11-11,2,15,VT,US,17,689
OUTLANDER 450,2019-11-11,6,15,VT,US,21,709
OUTLANDER 1000,2019-11-18,5,2,VT,US,7,676
OUTLANDER 850,2019-11-18,8,9,VT,US,17,706
OUTLANDER 450,2019-11-18,10,2,VT,US,12,721
OUTLANDER 1000,2019-11-25,11,11,VT,US,22,698
OUTLANDER 850,2019-11-25,2,0,VT,US,2,708
OUTLANDER 450,2019-11-25,14,2,VT,US,16,737
OUTLANDER 1000,2019-12-02,5,7,VT,US,12,710
OUTLANDER 850,2019-12-02,13,11,VT,US,24,732
OUTLANDER 450,2019-12-02,3,1,VT,US,4,741
OUTLANDER 1000,2019-12-09,3,9,VT,US,12,722
OUTLANDER 850,2019-12-09,14,11,VT,US,25,757
OUTLANDER 450,2019-12-09,12,7,VT,US,19,760
OUTLANDER 1000,2019-12-16,6,10,VT,US,16,738
OUTLANDER 850,2019-12-16,7,6,VT,US,13,770
OUTLANDER 450,2019-12-16,13,14,VT,US,27,787
OUTLANDER 1000,2019-12-23,11,12,VT,US,23,761
OUTLANDER 850,2019-12-23,8,4,VT,US,12,782
OUTLANDER 450,2019-12-23,9,11,VT,US,20,807
OUTLANDER 1000,2019-12-30,8,6,VT,US,14,775
OUTLANDER 850,2019-12-30,4,1,VT,US,5,787
OUTLANDER 450,2019-12-30,2,3,VT,US,5,812
OUTLANDER 1000,2020-01-06,14,6,VT,US,20,795
OUTLANDER 850,2020-01-06,4,6,VT,US,10,797
OUTLANDER 450,2020-01-06,11,1,VT,US,12,824
OUTLANDER 1000,2020-01-13,9,3,VT,US,12,807
OUTLANDER 850,2020-01-13,4,1,VT,US,5,802
OUTLANDER 450,2020-01-13,11,14,VT,US,25,849
OUTLANDER 1000,2020-01-20,4,11,VT,US,15,822
OUTLANDER 850,2020-01-20,14,12,VT,US,26,828
OUTLANDER 450,2020-01-20,10,6,VT,US,16,865
OUTLANDER 1000,2020-01-27,1,12,VT,US,13,835
OUTLANDER 850,2020-01-27,9,13,VT,US,22,850
OUTLANDER 450,2020-01-27,2,14,VT,US,16,881
OUTLANDER 1000,2020-02-03,13,4,VT,US,17,852
OUTLANDER 850,2020-02-03,6,15,VT,US,21,871
OUTLANDER 450,2020-02-03,1,6,VT,US,7,888
OUTLANDER 1000,2020-02-10,1,2,VT,US,3,855
OUTLANDER 850,2020-02-10,6,12,VT,US,18,889
OUTLANDER 450,2020-02-10,10,6,VT,US,16,904
OUTLANDER 1000,2020-02-17,3,10,VT,US,13,868
OUTLANDER 850,2020-02-17,1,9,VT,US,10,899
OUTLANDER 450,2020-02-17,15,9,VT,US,24,928
OUTLANDER 1000,2020-02-24,1,5,VT,US,6,874
OUTLANDER 850,2020-02-24,3,5,VT,US,8,907
OUTLANDER 450,2020-02-24,1,7,VT,US,8,936
OUTLANDER 1000,2020-03-02,15,8,VT,US,23,897
OUTLANDER 850,2020-03-02,14,2,VT,US,16,923
OUTLANDER 450,2020-03-02,1,7,VT,US,8,944
OUTLANDER 1000,2020-03-09,4,8,VT,US,12,909
OUTLANDER 850,2020-03-09,9,10,VT,US,19,942
OUTLANDER 450,2020-03-09,4,8,VT,US,12,956
OUTLANDER 1000,2020-03-16,7,13,VT,US,20,929
OUTLANDER 850,2020-03-16,9,3,VT,US,12,954
OUTLANDER 450,2020-03-16,11,14,VT,US,25,981
OUTLANDER 1000,2020-03-23,12,14,VT,US,26,955
OUTLANDER 850,2020-03-23,5,13,VT,US,18,972
OUTLANDER 450,2020-03-23,9,7,VT,US,16,997
OUTLANDER 1000,2020-03-30,2,8,VT,US,10,965
OUTLANDER 850,2020-03-30,12,2,VT,US,14,986
OUTLANDER 450,2020-03-30,11,7,VT,US,18,1015
OUTLANDER 1000,2020-04-06,6,2,VT,US,8,973
OUTLANDER 850,2020-04-06,6,4,VT,US,10,996
OUTLANDER 450,2020-04-06,8,9,VT,US,17,1032
OUTLANDER 1000,2020-04-13,7,4,VT,US,11,984
OUTLANDER 850,2020-04-13,7,7,VT,US,14,1010
OUTLANDER 450,2020-04-13,10,3,VT,US,13,1045
OUTLANDER 1000,2020-04-20,5,0,VT,US,5,989
OUTLANDER 850,2020-04-20,14,13,VT,US,27,1037
OUTLANDER 450,2020-04-20,11,14,VT,US,25,1070
OUTLANDER 1000,2020-04-27,12,14,VT,US,26,1015
OUTLANDER 850,2020-04-27,1,2,VT,US,3,1040
OUTLANDER 450,2020-04-27,4,5,VT,US,9,1079
OUTLANDER 1000,2020-05-04,1,8,VT,US,9,1024
OUTLANDER 850,2020-05-04,6,3,VT,US,9,1049
OUTLANDER 450,2020-05-04,14,13,VT,US,27,1106
OUTLANDER 1000,2020-05-11,1,8,VT,US,9,1033
OUTLANDER 850,2020-05-11,14,4,VT,US,18,1067
OUTLANDER 450,2020-05-11,7,12,VT,US,19,1125
OUTLANDER 1000,2020-05-18,10,8,VT,US,18,1051
OUTLANDER 850,2020-05-18,4,11,VT,US,15,1082
OUTLANDER 450,2020-05-18,13,2,VT,US,15,1140
OUTLANDER 1000,2020-05-25,6,4,VT,US,10,1061
OUTLANDER 850,2020-05-25,3,8,VT,US,11,1093
OUTLANDER 450,2020-05-25,13,12,VT,US,25,1165
OUTLANDER 1000,2020-06-01,6,6,VT,US,12,1073
OUTLANDER 850,2020-06-01,8,13,VT,US,21,1114
OUTLANDER 450,2020-06-01,1,2,VT,US,3,1168
OUTLANDER 1000,2020-06-08,3,15,VT,US,18,1091
OUTLANDER 850,2020-06-08,3,1,VT,US,4,1118
OUTLANDER 450,2020-06-08,9,11,VT,US,20,1188
OUTLANDER 1000,2020-06-15,5,10,VT,US,15,1106
OUTLANDER 850,2020-06-15,12,12,VT,US,24,1142
OUTLANDER 450,2020-06-15,10,4,VT,US,14,1202
OUTLANDER 1000,2020-06-22,5,1,VT,US,6,1112
OUTLANDER 850,2020-06-22,4,9,VT,US,13,1155
OUTLANDER 450,2020-06-22,2,7,VT,US,9,1211
OUTLANDER 1000,2020-06-29,14,7,VT,US,21,1133
OUTLANDER 850,2020-06-29,14,11,VT,US,25,1180
OUTLANDER 450,2020-06-29,4,3,VT,US,7,1218
OUTLANDER 1000,2020-07-06,14,1,VT,US,15,1148
OUTLANDER 850,2020-07-06,11,10,VT,US,21,1201
OUTLANDER 450,2020-07-06,12,5,VT,US,17,1235
OUTLANDER 1000,2020-07-13,14,8,VT,US,22,1170
OUTLANDER 850,2020-07-13,3,1,VT,US,4,1205
OUTLANDER 450,2020-07-13,11,2,VT,US,13,1248
OUTLANDER 1000,2020-07-20,2,2,VT,US,4,1174
OUTLANDER 850,2020-07-20,4,2,VT,US,6,1211
OUTLANDER 450,2020-07-20,7,4,VT,US,11,1259
OUTLANDER 1000,2020-07-27,2,11,VT,US,13,1187
OUTLANDER 850,2020-07-27,6,1,VT,US,7,1218
OUTLANDER 450,2020-07-27,0,7,VT,US,7,1266
OUTLANDER 1000,2020-08-03,13,14,VT,US,27,1214
OUTLANDER 850,2020-08-03,15,9,VT,US,24,1242
OUTLANDER 450,2020-08-03,12,13,VT,US,25,1291
OUTLANDER 1000,2020-08-10,9,8,VT,US,17,1231
OUTLANDER 850,2020-08-10,7,15,VT,US,22,1264
OUTLANDER 450,2020-08-10,13,3,VT,US,16,1307
OUTLANDER 1000,2020-08-17,6,10,VT,US,16,1247
OUTLANDER 850,2020-08-17,1,10,VT,US,11,1275
OUTLANDER 450,2020-08-17,13,12,VT,US,25,1332
OUTLANDER 1000,2020-08-24,12,15,VT,US,27,1274
OUTLANDER 850,2020-08-24,15,12,VT,US,27,1302
OUTLANDER 450,2020-08-24,6,3,VT,US,9,1341
OUTLANDER 1000,2020-08-31,8,10,VT,US,18,1292
OUTLANDER 850,2020-08-31,10,6,VT,US,16,1318
OUTLANDER 450,2020-08-31,6,8,VT,US,14,1355
OUTLANDER 1000,2020-09-07,2,15,VT,US,17,1309
OUTLANDER 850,2020-09-07,6,13,VT,US,19,1337
OUTLANDER 450,2020-09-07,3,2,VT,US,5,1360
OUTLANDER 1000,2020-09-14,7,0,VT,US,7,1316
OUTLANDER 850,2020-09-14,12,13,VT,US,25,1362
OUTLANDER 450,2020-09-14,11,11,VT,US,22,1382
OUTLANDER 1000,2020-09-21,12,3,VT,US,15,1331
OUTLANDER 850,2020-09-21,13,2,VT,US,15,1377
OUTLANDER 450,2020-09-21,2,7,VT,US,9,1391
OUTLANDER 1000,2020-09-28,4,2,VT,US,6,1337
OUTLANDER 850,2020-09-28,0,9,VT,US,9,1386
OUTLANDER 450,2020-09-28,3,1,VT,US,4,1395
OUTLANDER 1000,2020-10-05,10,9,VT,US,19,1356
OUTLANDER 850,2020-10-05,4,8,VT,US,12,1398
OUTLANDER 450,2020-10-05,14,12,VT,US,26,1421
OUTLANDER 1000,2020-10-12,12,15,VT,US,27,1383
OUTLANDER 850,2020-10-12,13,15,VT,US,28,1426
OUTLANDER 450,2020-10-12,5,13,VT,US,18,1439
OUTLANDER 1000,2020-10-19,5,1,VT,US,6,1389
OUTLANDER 850,2020-10-19,5,10,VT,US,15,1441
OUTLANDER 450,2020-10-19,3,4,VT,US,7,1446
OUTLANDER 1000,2020-10-26,1,14,VT,US,15,1404
OUTLANDER 850,2020-10-26,6,2,VT,US,8,1449
OUTLANDER 450,2020-10-26,14,4,VT,US,18,1464
OUTLANDER 1000,2020-11-02,2,6,VT,US,8,1412
OUTLANDER 850,2020-11-02,7,13,VT,US,20,1469
OUTLANDER 450,2020-11-02,6,8,VT,US,14,1478
OUTLANDER 1000,2020-11-09,0,9,VT,US,9,1421
OUTLANDER 850,2020-11-09,10,3,VT,US,13,1482
OUTLANDER 450,2020-11-09,9,10,VT,US,19,1497
OUTLANDER 1000,2020-11-16,8,13,VT,US,21,1442
OUTLANDER 850,2020-11-16,14,4,VT,US,18,1500
OUTLANDER 450,2020-11-16,12,6,VT,US,18,1515
OUTLANDER 1000,2020-11-23,2,1,VT,US,3,1445
OUTLANDER 850,2020-11-23,11,1,VT,US,12,1512
OUTLANDER 450,2020-11-23,12,9,VT,US,21,1536
OUTLANDER 1000,2020-11-30,8,14,VT,US,22,1467
OUTLANDER 850,2020-11-30,10,9,VT,US,19,1531
OUTLANDER 450,2020-11-30,6,3,VT,US,9,1545
OUTLANDER 1000,2020-12-07,6,14,VT,US,20,1487
OUTLANDER 850,2020-12-07,3,7,VT,US,10,1541
OUTLANDER 450,2020-12-07,3,9,VT,US,12,1557
OUTLANDER 1000,2020-12-14,5,12,VT,US,17,1504
OUTLANDER 850,2020-12-14,4,14,VT,US,18,1559
OUTLANDER 450,2020-12-14,8,5,VT,US,13,1570
OUTLANDER 1000,2020-12-21,10,4,VT,US,14,1518
OUTLANDER 850,2020-12-21,13,4,VT,US,17,1576
OUTLANDER 450,2020-12-21,1,6,VT,US,7,1577
OUTLANDER 1000,2020-12-28,6,9,VT,US,15,1533
OUTLANDER 850,2020-12-28,4,5,VT,US,9,1585
OUTLANDER 450,2020-12-28,3,6,VT,US,9,1586
OUTLANDER 1000,2021-01-04,9,0,VT,US,9,1542
OUTLANDER 850,2021-01-04,13,6,VT,US,19,1604
OUTLANDER 450,2021-01-04,7,12,VT,US,19,1605
OUTLANDER 1000,2021-01-11,7,10,VT,US,17,1559
OUTLANDER 850,2021-01-11,14,9,VT,US,23,1627
OUTLANDER 450,2021-01-11,9,10,VT,US,19,1624
OUTLANDER 1000,2021-01-18,8,6,VT,US,14,1573
OUTLANDER 850,2021-01-18,15,5,VT,US,20,1647
OUTLANDER 450,2021-01-18,8,6,VT,US,14,1638
OUTLANDER 1000,2021-01-25,6,2,VT,US,8,1581
OUTLANDER 850,2021-01-25,7,4,VT,US,11,1658
OUTLANDER 450,2021-01-25,8,8,VT,US,16,1654
OUTLANDER 1000,2021-02-01,3,2,VT,US,5,1586
OUTLANDER 850,2021-02-01,12,6,VT,US,18,1676
OUTLANDER 450,2021-02-01,4,11,VT,US,15,1669
OUTLANDER 1000,2021-02-08,14,1,VT,US,15,1601
OUTLANDER 850,2021-02-08,12,11,VT,US,23,1699
OUTLANDER 450,2021-02-08,3,15,VT,US,18,1687
OUTLANDER 1000,2021-02-15,8,3,VT,US,11,1612
OUTLANDER 850,2021-02-15,4,7,VT,US,11,1710
OUTLANDER 450,2021-02-15,5,12,VT,US,17,1704
OUTLANDER 1000,2021-02-22,1,4,VT,US,5,1617
OUTLANDER 850,2021-02-22,14,4,VT,US,18,1728
OUTLANDER 450,2021-02-22,2,14,VT,US,16,1720
OUTLANDER 1000,2021-03-01,7,3,VT,US,10,1627
OUTLANDER 850,2021-03-01,15,2,VT,US,17,1745
OUTLANDER 450,2021-03-01,4,13,VT,US,17,1737
OUTLANDER 1000,2021-03-08,15,4,VT,US,19,1646
OUTLANDER 850,2021-03-08,6,13,VT,US,19,1764
OUTLANDER 450,2021-03-08,3,14,VT,US,17,1754
OUTLANDER 1000,2021-03-15,3,4,VT,US,7,1653
OUTLANDER 850,2021-03-15,12,2,VT,US,14,1778
OUTLANDER 450,2021-03-15,6,8,VT,US,14,1768
OUTLANDER 1000,2021-03-22,14,2,VT,US,16,1669
OUTLANDER 850,2021-03-22,12,7,VT,US,19,1797
OUTLANDER 450,2021-03-22,4,14,VT,US,18,1786
OUTLANDER 1000,2021-03-29,11,0,VT,US,11,1680
OUTLANDER 850,2021-03-29,14,4,VT,US,18,1815
OUTLANDER 450,2021-03-29,3,6,VT,US,9,1795
OUTLANDER 1000,2021-04-05,7,10,VT,US,17,1697
OUTLANDER 850,2021-04-05,7,10,VT,US,17,1832
OUTLANDER 450,2021-04-05,7,13,VT,US,20,1815
OUTLANDER 1000,2021-04-12,13,15,VT,US,28,1725
OUTLANDER 850,2021-04-12,12,6,VT,US,18,1850
OUTLANDER 450,2021-04-12,7,9,VT,US,16,1831
OUTLANDER 1000,2021-04-19,8,9,VT,US,17,1742
OUTLANDER 850,2021-04-19,13,10,VT,US,23,1873
OUTLANDER 450,2021-04-19,10,10,VT,US,20,1851
OUTLANDER 1000,2021-04-26,5,11,VT,US,16,1758
OUTLANDER 850,2021-04-26,9,5,VT,US,14,1887
OUTLANDER 450,2021-04-26,2,0,VT,US,2,1853
OUTLANDER 1000,2021-05-03,2,10,VT,US,12,1770
OUTLANDER 850,2021-05-03,5,13,VT,US,18,1905
OUTLANDER 450,2021-05-03,12,7,VT,US,19,1872
OUTLANDER 1000,2021-05-10,8,8,VT,US,16,1786
OUTLANDER 850,2021-05-10,7,3,VT,US,10,1915
OUTLANDER 450,2021-05-10,12,4,VT,US,16,1888
OUTLANDER 1000,2021-05-17,4,9,VT,US,13,1799
OUTLANDER 850,2021-05-17,1,14,VT,US,15,1930
OUTLANDER 450,2021-05-17,5,5,VT,US,10,1898
OUTLANDER 1000,2021-05-24,8,10,VT,US,18,1817
OUTLANDER 850,2021-05-24,10,1,VT,US,11,1941
OUTLANDER 450,2021-05-24,13,7,VT,US,20,1918
OUTLANDER 1000,2021-05-31,10,2,VT,US,12,1829
OUTLANDER 850,2021-05-31,12,6,VT,US,18,1959
OUTLANDER 450,2021-05-31,14,8,VT,US,22,1940
OUTLANDER 1000,2021-06-07,6,14,VT,US,20,1849
OUTLANDER 850,2021-06-07,13,7,VT,US,20,1979
OUTLANDER 450,2021-06-07,9,14,VT,US,23,1963
OUTLANDER 1000,2021-06-14,5,13,VT,US,18,1867
OUTLANDER 850,2021-06-14,2,4,VT,US,6,1985
OUTLANDER 450,2021-06-14,14,2,VT,US,16,1979
OUTLANDER 1000,2021-06-21,6,8,VT,US,14,1881
OUTLANDER 850,2021-06-21,7,12,VT,US,19,2004
OUTLANDER 450,2021-06-21,1,6,VT,US,7,1986
OUTLANDER 1000,2021-06-28,1,4,VT,US,5,1886
OUTLANDER 850,2021-06-28,0,11,VT,US,11,2015
OUTLANDER 450,2021-06-28,8,9,VT,US,17,2003
OUTLANDER 1000,2021-07-05,11,10,VT,US,21,1907
OUTLANDER 850,2021-07-05,14,4,VT,US,18,2033
OUTLANDER 450,2021-07-05,5,4,VT,US,9,2012
OUTLANDER 1000,2021-07-12,7,7,VT,US,14,1921
OUTLANDER 850,2021-07-12,14,0,VT,US,14,2047
OUTLANDER 450,2021-07-12,11,5,VT,US,16,2028
OUTLANDER 1000,2021-07-19,3,8,VT,US,11,1932
OUTLANDER 850,2021-07-19,7,9,VT,US,16,2063
OUTLANDER 450,2021-07-19,11,11,VT,US,22,2050
OUTLANDER 1000,2021-07-26,4,14,VT,US,18,1950
OUTLANDER 850,2021-07-26,14,10,VT,US,24,2087
OUTLANDER 450,2021-07-26,0,12,VT,US,12,2062
OUTLANDER 1000,2021-08-02,8,10,VT,US,18,1968
OUTLANDER 850,2021-08-02,4,9,VT,US,13,2100
OUTLANDER 450,2021-08-02,5,13,VT,US,18,2080
OUTLANDER 1000,2021-08-09,7,12,VT,US,19,1987
OUTLANDER 850,2021-08-09,1,5,VT,US,6,2106
OUTLANDER 450,2021-08-09,5,15,VT,US,20,2100
OUTLANDER 1000,2021-08-16,1,8,VT,US,9,1996
OUTLANDER 850,2021-08-16,5,9,VT,US,14,2120
OUTLANDER 450,2021-08-16,11,2,VT,US,13,2113
OUTLANDER 1000,2021-08-23,7,1,VT,US,8,2004
OUTLANDER 850,2021-08-23,14,8,VT,US,22,2142
OUTLANDER 450,2021-08-23,2,2,VT,US,4,2117
OUTLANDER 1000,2021-08-30,1,11,VT,US,12,2016
OUTLANDER 850,2021-08-30,7,8,VT,US,15,2157
OUTLANDER 450,2021-08-30,2,11,VT,US,13,2130
OUTLANDER 1000,2021-09-06,13,8,VT,US,21,2037
OUTLANDER 850,2021-09-06,11,10,VT,US,21,2178
OUTLANDER 450,2021-09-06,14,6,VT,US,20,2150
OUTLANDER 1000,2021-09-13,3,9,VT,US,12,2049
OUTLANDER 850,2021-09-13,14,15,VT,US,29,2207
OUTLANDER 450,2021-09-13,11,15,VT,US,26,2176
OUTLANDER 1000,2021-09-20,10,3,VT,US,13,2062
OUTLANDER 850,2021-09-20,14,3,VT,US,17,2224
OUTLANDER 450,2021-09-20,12,1,VT,US,13,2189
OUTLANDER 1000,2021-09-27,11,9,VT,US,20,2082
OUTLANDER 850,2021-09-27,15,9,VT,US,24,2248
OUTLANDER 450,2021-09-27,1,4,VT,US,5,2194
OUTLANDER 1000,2021-10-04,14,11,VT,US,25,2107
OUTLANDER 850,2021-10-04,7,7,VT,US,14,2262
OUTLANDER 450,2021-10-04,3,6,VT,US,9,2203
OUTLANDER 1000,2021-10-11,10,5,VT,US,15,2122
OUTLANDER 850,2021-10-11,4,15,VT,US,19,2281
OUTLANDER 450,2021-10-11,11,2,VT,US,13,2216
OUTLANDER 1000,2021-10-18,4,14,VT,US,18,2140
OUTLANDER 850,2021-10-18,4,11,VT,US,15,2296
OUTLANDER 450,2021-10-18,4,3,VT,US,7,2223
OUTLANDER 1000,2021-10-25,5,4,VT,US,9,2149
OUTLANDER 850,2021-10-25,4,10,VT,US,14,2310
OUTLANDER 450,2021-10-25,4,4,VT,US,8,2231
OUTLANDER 1000,2021-11-01,6,12,VT,US,18,2167
OUTLANDER 850,2021-11-01,5,3,VT,US,8,2318
OUTLANDER 450,2021-11-01,1,9,VT,US,10,2241
OUTLANDER 1000,2021-11-08,2,3,VT,US,5,2172
OUTLANDER 850,2021-11-08,7,5,VT,US,12,2330
OUTLANDER 450,2021-11-08,3,2,VT,US,5,2246
OUTLANDER 1000,2021-11-15,5,4,VT,US,9,2181
OUTLANDER 850,2021-11-15,5,13,VT,US,18,2348
OUTLANDER 450,2021-11-15,5,13,VT,US,18,2264
OUTLANDER 1000,2021-11-22,6,4,VT,US,10,2191
OUTLANDER 850,2021-11-22,14,15,VT,US,29,2377
OUTLANDER 450,2021-11-22,2,11,VT,US,13,2277
OUTLANDER 1000,2021-11-29,1,11,VT,US,12,2203
OUTLANDER 850,2021-11-29,14,14,VT,US,28,2405
OUTLANDER 450,2021-11-29,7,2,VT,US,9,2286
OUTLANDER 1000,2021-12-06,5,13,VT,US,18,2221
OUTLANDER 850,2021-12-06,6,9,VT,US,15,2420
OUTLANDER 450,2021-12-06,5,15,VT,US,20,2306
OUTLANDER 1000,2021-12-13,7,8,VT,US,15,2236
OUTLANDER 850,2021-12-13,8,3,VT,US,11,2431
OUTLANDER 450,2021-12-13,10,0,VT,US,10,2316
OUTLANDER 1000,2021-12-20,2,7,VT,US,9,2245
OUTLANDER 850,2021-12-20,3,13,VT,US,16,2447
OUTLANDER 450,2021-12-20,14,8,VT,US,22,2338
OUTLANDER 1000,2021-12-27,6,9,VT,US,15,2260
OUTLANDER 850,2021-12-27,9,12,VT,US,21,2468
OUTLANDER 450,2021-12-27,7,10,VT,US,17,2355
OUTLANDER 1000,2019-01-07,5,0,VA,US,5,5
OUTLANDER 850,2019-01-07,8,1,VA,US,9,9
OUTLANDER 450,2019-01-07,3,14,VA,US,17,17
OUTLANDER 1000,2019-01-14,12,10,VA,US,22,27
OUTLANDER 850,2019-01-14,14,1,VA,US,15,24
OUTLANDER 450,2019-01-14,5,14,VA,US,19,36
OUTLANDER 1000,2019-01-21,14,7,VA,US,21,48
OUTLANDER 850,2019-01-21,12,0,VA,US,12,36
OUTLANDER 450,2019-01-21,2,2,VA,US,4,40
OUTLANDER 1000,2019-01-28,7,13,VA,US,20,68
OUTLANDER 850,2019-01-28,0,7,VA,US,7,43
OUTLANDER 450,2019-01-28,2,1,VA,US,3,43
OUTLANDER 1000,2019-02-04,13,2,VA,US,15,83
OUTLANDER 850,2019-02-04,13,0,VA,US,13,56
OUTLANDER 450,2019-02-04,9,1,VA,US,10,53
OUTLANDER 1000,2019-02-11,0,8,VA,US,8,91
OUTLANDER 850,2019-02-11,7,15,VA,US,22,78
OUTLANDER 450,2019-02-11,2,9,VA,US,11,64
OUTLANDER 1000,2019-02-18,4,1,VA,US,5,96
OUTLANDER 850,2019-02-18,12,9,VA,US,21,99
OUTLANDER 450,2019-02-18,10,12,VA,US,22,86
OUTLANDER 1000,2019-02-25,3,7,VA,US,10,106
OUTLANDER 850,2019-02-25,1,0,VA,US,1,100
OUTLANDER 450,2019-02-25,11,5,VA,US,16,102
OUTLANDER 1000,2019-03-04,10,9,VA,US,19,125
OUTLANDER 850,2019-03-04,2,7,VA,US,9,109
OUTLANDER 450,2019-03-04,12,8,VA,US,20,122
OUTLANDER 1000,2019-03-11,5,10,VA,US,15,140
OUTLANDER 850,2019-03-11,9,9,VA,US,18,127
OUTLANDER 450,2019-03-11,14,10,VA,US,24,146
OUTLANDER 1000,2019-03-18,9,13,VA,US,22,162
OUTLANDER 850,2019-03-18,14,13,VA,US,27,154
OUTLANDER 450,2019-03-18,7,6,VA,US,13,159
OUTLANDER 1000,2019-03-25,14,13,VA,US,27,189
OUTLANDER 850,2019-03-25,10,5,VA,US,15,169
OUTLANDER 450,2019-03-25,15,6,VA,US,21,180
OUTLANDER 1000,2019-04-01,9,6,VA,US,15,204
OUTLANDER 850,2019-04-01,2,8,VA,US,10,179
OUTLANDER 450,2019-04-01,12,5,VA,US,17,197
OUTLANDER 1000,2019-04-08,2,6,VA,US,8,212
OUTLANDER 850,2019-04-08,13,7,VA,US,20,199
OUTLANDER 450,2019-04-08,5,2,VA,US,7,204
OUTLANDER 1000,2019-04-15,5,1,VA,US,6,218
OUTLANDER 850,2019-04-15,8,2,VA,US,10,209
OUTLANDER 450,2019-04-15,13,12,VA,US,25,229
OUTLANDER 1000,2019-04-22,6,5,VA,US,11,229
OUTLANDER 850,2019-04-22,1,2,VA,US,3,212
OUTLANDER 450,2019-04-22,8,14,VA,US,22,251
OUTLANDER 1000,2019-04-29,9,5,VA,US,14,243
OUTLANDER 850,2019-04-29,13,7,VA,US,20,232
OUTLANDER 450,2019-04-29,2,0,VA,US,2,253
OUTLANDER 1000,2019-05-06,12,13,VA,US,25,268
OUTLANDER 850,2019-05-06,14,12,VA,US,26,258
OUTLANDER 450,2019-05-06,11,2,VA,US,13,266
OUTLANDER 1000,2019-05-13,6,3,VA,US,9,277
OUTLANDER 850,2019-05-13,2,9,VA,US,11,269
OUTLANDER 450,2019-05-13,6,10,VA,US,16,282
OUTLANDER 1000,2019-05-20,10,9,VA,US,19,296
OUTLANDER 850,2019-05-20,5,11,VA,US,16,285
OUTLANDER 450,2019-05-20,11,7,VA,US,18,300
OUTLANDER 1000,2019-05-27,12,0,VA,US,12,308
OUTLANDER 850,2019-05-27,10,11,VA,US,21,306
OUTLANDER 450,2019-05-27,13,5,VA,US,18,318
OUTLANDER 1000,2019-06-03,4,1,VA,US,5,313
OUTLANDER 850,2019-06-03,10,8,VA,US,18,324
OUTLANDER 450,2019-06-03,1,1,VA,US,2,320
OUTLANDER 1000,2019-06-10,3,8,VA,US,11,324
OUTLANDER 850,2019-06-10,8,11,VA,US,19,343
OUTLANDER 450,2019-06-10,5,13,VA,US,18,338
OUTLANDER 1000,2019-06-17,13,12,VA,US,25,349
OUTLANDER 850,2019-06-17,0,2,VA,US,2,345
OUTLANDER 450,2019-06-17,5,6,VA,US,11,349
OUTLANDER 1000,2019-06-24,7,11,VA,US,18,367
OUTLANDER 850,2019-06-24,6,2,VA,US,8,353
OUTLANDER 450,2019-06-24,9,1,VA,US,10,359
OUTLANDER 1000,2019-07-01,13,4,VA,US,17,384
OUTLANDER 850,2019-07-01,4,6,VA,US,10,363
OUTLANDER 450,2019-07-01,2,9,VA,US,11,370
OUTLANDER 1000,2019-07-08,2,3,VA,US,5,389
OUTLANDER 850,2019-07-08,2,8,VA,US,10,373
OUTLANDER 450,2019-07-08,10,2,VA,US,12,382
OUTLANDER 1000,2019-07-15,8,2,VA,US,10,399
OUTLANDER 850,2019-07-15,11,5,VA,US,16,389
OUTLANDER 450,2019-07-15,0,3,VA,US,3,385
OUTLANDER 1000,2019-07-22,1,14,VA,US,15,414
OUTLANDER 850,2019-07-22,15,14,VA,US,29,418
OUTLANDER 450,2019-07-22,10,11,VA,US,21,406
OUTLANDER 1000,2019-07-29,2,4,VA,US,6,420
OUTLANDER 850,2019-07-29,6,6,VA,US,12,430
OUTLANDER 450,2019-07-29,2,4,VA,US,6,412
OUTLANDER 1000,2019-08-05,11,1,VA,US,12,432
OUTLANDER 850,2019-08-05,0,13,VA,US,13,443
OUTLANDER 450,2019-08-05,15,11,VA,US,26,438
OUTLANDER 1000,2019-08-12,4,10,VA,US,14,446
OUTLANDER 850,2019-08-12,5,13,VA,US,18,461
OUTLANDER 450,2019-08-12,15,14,VA,US,29,467
OUTLANDER 1000,2019-08-19,9,7,VA,US,16,462
OUTLANDER 850,2019-08-19,13,8,VA,US,21,482
OUTLANDER 450,2019-08-19,12,11,VA,US,23,490
OUTLANDER 1000,2019-08-26,12,5,VA,US,17,479
OUTLANDER 850,2019-08-26,8,3,VA,US,11,493
OUTLANDER 450,2019-08-26,9,15,VA,US,24,514
OUTLANDER 1000,2019-09-02,4,8,VA,US,12,491
OUTLANDER 850,2019-09-02,6,8,VA,US,14,507
OUTLANDER 450,2019-09-02,13,6,VA,US,19,533
OUTLANDER 1000,2019-09-09,7,7,VA,US,14,505
OUTLANDER 850,2019-09-09,14,5,VA,US,19,526
OUTLANDER 450,2019-09-09,11,13,VA,US,24,557
OUTLANDER 1000,2019-09-16,7,10,VA,US,17,522
OUTLANDER 850,2019-09-16,15,4,VA,US,19,545
OUTLANDER 450,2019-09-16,6,3,VA,US,9,566
OUTLANDER 1000,2019-09-23,2,2,VA,US,4,526
OUTLANDER 850,2019-09-23,9,5,VA,US,14,559
OUTLANDER 450,2019-09-23,5,8,VA,US,13,579
OUTLANDER 1000,2019-09-30,4,2,VA,US,6,532
OUTLANDER 850,2019-09-30,5,7,VA,US,12,571
OUTLANDER 450,2019-09-30,1,12,VA,US,13,592
OUTLANDER 1000,2019-10-07,7,9,VA,US,16,548
OUTLANDER 850,2019-10-07,0,9,VA,US,9,580
OUTLANDER 450,2019-10-07,9,11,VA,US,20,612
OUTLANDER 1000,2019-10-14,4,6,VA,US,10,558
OUTLANDER 850,2019-10-14,14,9,VA,US,23,603
OUTLANDER 450,2019-10-14,9,11,VA,US,20,632
OUTLANDER 1000,2019-10-21,11,5,VA,US,16,574
OUTLANDER 850,2019-10-21,2,10,VA,US,12,615
OUTLANDER 450,2019-10-21,6,14,VA,US,20,652
OUTLANDER 1000,2019-10-28,11,9,VA,US,20,594
OUTLANDER 850,2019-10-28,7,3,VA,US,10,625
OUTLANDER 450,2019-10-28,0,5,VA,US,5,657
OUTLANDER 1000,2019-11-04,4,6,VA,US,10,604
OUTLANDER 850,2019-11-04,5,4,VA,US,9,634
OUTLANDER 450,2019-11-04,12,1,VA,US,13,670
OUTLANDER 1000,2019-11-11,4,14,VA,US,18,622
OUTLANDER 850,2019-11-11,4,11,VA,US,15,649
OUTLANDER 450,2019-11-11,11,3,VA,US,14,684
OUTLANDER 1000,2019-11-18,5,7,VA,US,12,634
OUTLANDER 850,2019-11-18,3,6,VA,US,9,658
OUTLANDER 450,2019-11-18,9,4,VA,US,13,697
OUTLANDER 1000,2019-11-25,10,4,VA,US,14,648
OUTLANDER 850,2019-11-25,3,7,VA,US,10,668
OUTLANDER 450,2019-11-25,6,4,VA,US,10,707
OUTLANDER 1000,2019-12-02,5,5,VA,US,10,658
OUTLANDER 850,2019-12-02,5,14,VA,US,19,687
OUTLANDER 450,2019-12-02,15,2,VA,US,17,724
OUTLANDER 1000,2019-12-09,12,2,VA,US,14,672
OUTLANDER 850,2019-12-09,8,6,VA,US,14,701
OUTLANDER 450,2019-12-09,7,5,VA,US,12,736
OUTLANDER 1000,2019-12-16,13,8,VA,US,21,693
OUTLANDER 850,2019-12-16,1,8,VA,US,9,710
OUTLANDER 450,2019-12-16,5,2,VA,US,7,743
OUTLANDER 1000,2019-12-23,4,5,VA,US,9,702
OUTLANDER 850,2019-12-23,7,12,VA,US,19,729
OUTLANDER 450,2019-12-23,14,9,VA,US,23,766
OUTLANDER 1000,2019-12-30,6,14,VA,US,20,722
OUTLANDER 850,2019-12-30,5,0,VA,US,5,734
OUTLANDER 450,2019-12-30,9,1,VA,US,10,776
OUTLANDER 1000,2020-01-06,10,11,VA,US,21,743
OUTLANDER 850,2020-01-06,6,2,VA,US,8,742
OUTLANDER 450,2020-01-06,9,13,VA,US,22,798
OUTLANDER 1000,2020-01-13,4,9,VA,US,13,756
OUTLANDER 850,2020-01-13,15,0,VA,US,15,757
OUTLANDER 450,2020-01-13,12,2,VA,US,14,812
OUTLANDER 1000,2020-01-20,7,7,VA,US,14,770
OUTLANDER 850,2020-01-20,12,13,VA,US,25,782
OUTLANDER 450,2020-01-20,8,6,VA,US,14,826
OUTLANDER 1000,2020-01-27,9,1,VA,US,10,780
OUTLANDER 850,2020-01-27,10,13,VA,US,23,805
OUTLANDER 450,2020-01-27,3,13,VA,US,16,842
OUTLANDER 1000,2020-02-03,5,12,VA,US,17,797
OUTLANDER 850,2020-02-03,7,14,VA,US,21,826
OUTLANDER 450,2020-02-03,13,10,VA,US,23,865
OUTLANDER 1000,2020-02-10,4,6,VA,US,10,807
OUTLANDER 850,2020-02-10,12,10,VA,US,22,848
OUTLANDER 450,2020-02-10,1,5,VA,US,6,871
OUTLANDER 1000,2020-02-17,2,14,VA,US,16,823
OUTLANDER 850,2020-02-17,9,6,VA,US,15,863
OUTLANDER 450,2020-02-17,7,14,VA,US,21,892
OUTLANDER 1000,2020-02-24,8,6,VA,US,14,837
OUTLANDER 850,2020-02-24,6,0,VA,US,6,869
OUTLANDER 450,2020-02-24,9,11,VA,US,20,912
OUTLANDER 1000,2020-03-02,14,14,VA,US,28,865
OUTLANDER 850,2020-03-02,13,13,VA,US,26,895
OUTLANDER 450,2020-03-02,7,12,VA,US,19,931
OUTLANDER 1000,2020-03-09,14,6,VA,US,20,885
OUTLANDER 850,2020-03-09,6,14,VA,US,20,915
OUTLANDER 450,2020-03-09,11,0,VA,US,11,942
OUTLANDER 1000,2020-03-16,1,9,VA,US,10,895
OUTLANDER 850,2020-03-16,7,14,VA,US,21,936
OUTLANDER 450,2020-03-16,0,9,VA,US,9,951
OUTLANDER 1000,2020-03-23,1,11,VA,US,12,907
OUTLANDER 850,2020-03-23,7,1,VA,US,8,944
OUTLANDER 450,2020-03-23,8,15,VA,US,23,974
OUTLANDER 1000,2020-03-30,2,10,VA,US,12,919
OUTLANDER 850,2020-03-30,9,9,VA,US,18,962
OUTLANDER 450,2020-03-30,6,8,VA,US,14,988
OUTLANDER 1000,2020-04-06,8,10,VA,US,18,937
OUTLANDER 850,2020-04-06,4,13,VA,US,17,979
OUTLANDER 450,2020-04-06,6,12,VA,US,18,1006
OUTLANDER 1000,2020-04-13,13,5,VA,US,18,955
OUTLANDER 850,2020-04-13,3,0,VA,US,3,982
OUTLANDER 450,2020-04-13,9,3,VA,US,12,1018
OUTLANDER 1000,2020-04-20,2,3,VA,US,5,960
OUTLANDER 850,2020-04-20,11,6,VA,US,17,999
OUTLANDER 450,2020-04-20,11,11,VA,US,22,1040
OUTLANDER 1000,2020-04-27,1,4,VA,US,5,965
OUTLANDER 850,2020-04-27,14,13,VA,US,27,1026
OUTLANDER 450,2020-04-27,8,5,VA,US,13,1053
OUTLANDER 1000,2020-05-04,10,0,VA,US,10,975
OUTLANDER 850,2020-05-04,1,9,VA,US,10,1036
OUTLANDER 450,2020-05-04,1,5,VA,US,6,1059
OUTLANDER 1000,2020-05-11,6,13,VA,US,19,994
OUTLANDER 850,2020-05-11,12,9,VA,US,21,1057
OUTLANDER 450,2020-05-11,3,2,VA,US,5,1064
OUTLANDER 1000,2020-05-18,13,14,VA,US,27,1021
OUTLANDER 850,2020-05-18,6,12,VA,US,18,1075
OUTLANDER 450,2020-05-18,6,13,VA,US,19,1083
OUTLANDER 1000,2020-05-25,7,5,VA,US,12,1033
OUTLANDER 850,2020-05-25,5,12,VA,US,17,1092
OUTLANDER 450,2020-05-25,4,7,VA,US,11,1094
OUTLANDER 1000,2020-06-01,11,3,VA,US,14,1047
OUTLANDER 850,2020-06-01,14,4,VA,US,18,1110
OUTLANDER 450,2020-06-01,14,2,VA,US,16,1110
OUTLANDER 1000,2020-06-08,4,7,VA,US,11,1058
OUTLANDER 850,2020-06-08,1,5,VA,US,6,1116
OUTLANDER 450,2020-06-08,11,2,VA,US,13,1123
OUTLANDER 1000,2020-06-15,15,5,VA,US,20,1078
OUTLANDER 850,2020-06-15,2,13,VA,US,15,1131
OUTLANDER 450,2020-06-15,0,8,VA,US,8,1131
OUTLANDER 1000,2020-06-22,8,5,VA,US,13,1091
OUTLANDER 850,2020-06-22,0,0,VA,US,0,1131
OUTLANDER 450,2020-06-22,14,15,VA,US,29,1160
OUTLANDER 1000,2020-06-29,13,13,VA,US,26,1117
OUTLANDER 850,2020-06-29,3,11,VA,US,14,1145
OUTLANDER 450,2020-06-29,10,14,VA,US,24,1184
OUTLANDER 1000,2020-07-06,13,3,VA,US,16,1133
OUTLANDER 850,2020-07-06,10,2,VA,US,12,1157
OUTLANDER 450,2020-07-06,6,9,VA,US,15,1199
OUTLANDER 1000,2020-07-13,10,3,VA,US,13,1146
OUTLANDER 850,2020-07-13,7,13,VA,US,20,1177
OUTLANDER 450,2020-07-13,12,1,VA,US,13,1212
OUTLANDER 1000,2020-07-20,14,4,VA,US,18,1164
OUTLANDER 850,2020-07-20,3,6,VA,US,9,1186
OUTLANDER 450,2020-07-20,3,8,VA,US,11,1223
OUTLANDER 1000,2020-07-27,13,14,VA,US,27,1191
OUTLANDER 850,2020-07-27,15,2,VA,US,17,1203
OUTLANDER 450,2020-07-27,1,8,VA,US,9,1232
OUTLANDER 1000,2020-08-03,15,13,VA,US,28,1219
OUTLANDER 850,2020-08-03,10,10,VA,US,20,1223
OUTLANDER 450,2020-08-03,2,4,VA,US,6,1238
OUTLANDER 1000,2020-08-10,9,7,VA,US,16,1235
OUTLANDER 850,2020-08-10,7,2,VA,US,9,1232
OUTLANDER 450,2020-08-10,3,5,VA,US,8,1246
OUTLANDER 1000,2020-08-17,11,10,VA,US,21,1256
OUTLANDER 850,2020-08-17,8,13,VA,US,21,1253
OUTLANDER 450,2020-08-17,9,6,VA,US,15,1261
OUTLANDER 1000,2020-08-24,1,15,VA,US,16,1272
OUTLANDER 850,2020-08-24,5,7,VA,US,12,1265
OUTLANDER 450,2020-08-24,12,13,VA,US,25,1286
OUTLANDER 1000,2020-08-31,13,3,VA,US,16,1288
OUTLANDER 850,2020-08-31,13,11,VA,US,24,1289
OUTLANDER 450,2020-08-31,3,1,VA,US,4,1290
OUTLANDER 1000,2020-09-07,6,1,VA,US,7,1295
OUTLANDER 850,2020-09-07,10,10,VA,US,20,1309
OUTLANDER 450,2020-09-07,3,8,VA,US,11,1301
OUTLANDER 1000,2020-09-14,14,7,VA,US,21,1316
OUTLANDER 850,2020-09-14,4,13,VA,US,17,1326
OUTLANDER 450,2020-09-14,2,4,VA,US,6,1307
OUTLANDER 1000,2020-09-21,7,3,VA,US,10,1326
OUTLANDER 850,2020-09-21,15,8,VA,US,23,1349
OUTLANDER 450,2020-09-21,9,1,VA,US,10,1317
OUTLANDER 1000,2020-09-28,10,6,VA,US,16,1342
OUTLANDER 850,2020-09-28,6,13,VA,US,19,1368
OUTLANDER 450,2020-09-28,12,2,VA,US,14,1331
OUTLANDER 1000,2020-10-05,13,12,VA,US,25,1367
OUTLANDER 850,2020-10-05,4,9,VA,US,13,1381
OUTLANDER 450,2020-10-05,12,14,VA,US,26,1357
OUTLANDER 1000,2020-10-12,1,13,VA,US,14,1381
OUTLANDER 850,2020-10-12,1,10,VA,US,11,1392
OUTLANDER 450,2020-10-12,2,15,VA,US,17,1374
OUTLANDER 1000,2020-10-19,7,1,VA,US,8,1389
OUTLANDER 850,2020-10-19,6,13,VA,US,19,1411
OUTLANDER 450,2020-10-19,4,1,VA,US,5,1379
OUTLANDER 1000,2020-10-26,5,4,VA,US,9,1398
OUTLANDER 850,2020-10-26,6,9,VA,US,15,1426
OUTLANDER 450,2020-10-26,15,12,VA,US,27,1406
OUTLANDER 1000,2020-11-02,2,11,VA,US,13,1411
OUTLANDER 850,2020-11-02,13,9,VA,US,22,1448
OUTLANDER 450,2020-11-02,8,4,VA,US,12,1418
OUTLANDER 1000,2020-11-09,5,14,VA,US,19,1430
OUTLANDER 850,2020-11-09,1,8,VA,US,9,1457
OUTLANDER 450,2020-11-09,11,4,VA,US,15,1433
OUTLANDER 1000,2020-11-16,0,14,VA,US,14,1444
OUTLANDER 850,2020-11-16,6,9,VA,US,15,1472
OUTLANDER 450,2020-11-16,5,15,VA,US,20,1453
OUTLANDER 1000,2020-11-23,13,8,VA,US,21,1465
OUTLANDER 850,2020-11-23,12,7,VA,US,19,1491
OUTLANDER 450,2020-11-23,7,9,VA,US,16,1469
OUTLANDER 1000,2020-11-30,1,7,VA,US,8,1473
OUTLANDER 850,2020-11-30,9,9,VA,US,18,1509
OUTLANDER 450,2020-11-30,9,3,VA,US,12,1481
OUTLANDER 1000,2020-12-07,4,0,VA,US,4,1477
OUTLANDER 850,2020-12-07,14,12,VA,US,26,1535
OUTLANDER 450,2020-12-07,13,13,VA,US,26,1507
OUTLANDER 1000,2020-12-14,11,7,VA,US,18,1495
OUTLANDER 850,2020-12-14,12,4,VA,US,16,1551
OUTLANDER 450,2020-12-14,13,1,VA,US,14,1521
OUTLANDER 1000,2020-12-21,2,14,VA,US,16,1511
OUTLANDER 850,2020-12-21,11,10,VA,US,21,1572
OUTLANDER 450,2020-12-21,1,7,VA,US,8,1529
OUTLANDER 1000,2020-12-28,9,5,VA,US,14,1525
OUTLANDER 850,2020-12-28,0,0,VA,US,0,1572
OUTLANDER 450,2020-12-28,2,2,VA,US,4,1533
OUTLANDER 1000,2021-01-04,12,8,VA,US,20,1545
OUTLANDER 850,2021-01-04,4,12,VA,US,16,1588
OUTLANDER 450,2021-01-04,14,7,VA,US,21,1554
OUTLANDER 1000,2021-01-11,12,1,VA,US,13,1558
OUTLANDER 850,2021-01-11,3,11,VA,US,14,1602
OUTLANDER 450,2021-01-11,10,7,VA,US,17,1571
OUTLANDER 1000,2021-01-18,0,3,VA,US,3,1561
OUTLANDER 850,2021-01-18,4,6,VA,US,10,1612
OUTLANDER 450,2021-01-18,2,11,VA,US,13,1584
OUTLANDER 1000,2021-01-25,0,15,VA,US,15,1576
OUTLANDER 850,2021-01-25,1,12,VA,US,13,1625
OUTLANDER 450,2021-01-25,2,6,VA,US,8,1592
OUTLANDER 1000,2021-02-01,2,7,VA,US,9,1585
OUTLANDER 850,2021-02-01,5,5,VA,US,10,1635
OUTLANDER 450,2021-02-01,13,12,VA,US,25,1617
OUTLANDER 1000,2021-02-08,14,3,VA,US,17,1602
OUTLANDER 850,2021-02-08,13,11,VA,US,24,1659
OUTLANDER 450,2021-02-08,2,11,VA,US,13,1630
OUTLANDER 1000,2021-02-15,4,8,VA,US,12,1614
OUTLANDER 850,2021-02-15,7,5,VA,US,12,1671
OUTLANDER 450,2021-02-15,4,12,VA,US,16,1646
OUTLANDER 1000,2021-02-22,3,11,VA,US,14,1628
OUTLANDER 850,2021-02-22,14,11,VA,US,25,1696
OUTLANDER 450,2021-02-22,9,10,VA,US,19,1665
OUTLANDER 1000,2021-03-01,12,0,VA,US,12,1640
OUTLANDER 850,2021-03-01,4,14,VA,US,18,1714
OUTLANDER 450,2021-03-01,11,7,VA,US,18,1683
OUTLANDER 1000,2021-03-08,7,10,VA,US,17,1657
OUTLANDER 850,2021-03-08,14,7,VA,US,21,1735
OUTLANDER 450,2021-03-08,14,10,VA,US,24,1707
OUTLANDER 1000,2021-03-15,3,3,VA,US,6,1663
OUTLANDER 850,2021-03-15,13,2,VA,US,15,1750
OUTLANDER 450,2021-03-15,15,2,VA,US,17,1724
OUTLANDER 1000,2021-03-22,1,10,VA,US,11,1674
OUTLANDER 850,2021-03-22,13,3,VA,US,16,1766
OUTLANDER 450,2021-03-22,12,11,VA,US,23,1747
OUTLANDER 1000,2021-03-29,8,9,VA,US,17,1691
OUTLANDER 850,2021-03-29,11,11,VA,US,22,1788
OUTLANDER 450,2021-03-29,8,1,VA,US,9,1756
OUTLANDER 1000,2021-04-05,13,2,VA,US,15,1706
OUTLANDER 850,2021-04-05,12,12,VA,US,24,1812
OUTLANDER 450,2021-04-05,1,11,VA,US,12,1768
OUTLANDER 1000,2021-04-12,13,9,VA,US,22,1728
OUTLANDER 850,2021-04-12,14,1,VA,US,15,1827
OUTLANDER 450,2021-04-12,3,1,VA,US,4,1772
OUTLANDER 1000,2021-04-19,12,10,VA,US,22,1750
OUTLANDER 850,2021-04-19,9,6,VA,US,15,1842
OUTLANDER 450,2021-04-19,8,12,VA,US,20,1792
OUTLANDER 1000,2021-04-26,14,7,VA,US,21,1771
OUTLANDER 850,2021-04-26,14,14,VA,US,28,1870
OUTLANDER 450,2021-04-26,9,1,VA,US,10,1802
OUTLANDER 1000,2021-05-03,7,8,VA,US,15,1786
OUTLANDER 850,2021-05-03,12,1,VA,US,13,1883
OUTLANDER 450,2021-05-03,10,5,VA,US,15,1817
OUTLANDER 1000,2021-05-10,3,14,VA,US,17,1803
OUTLANDER 850,2021-05-10,9,2,VA,US,11,1894
OUTLANDER 450,2021-05-10,12,15,VA,US,27,1844
OUTLANDER 1000,2021-05-17,8,1,VA,US,9,1812
OUTLANDER 850,2021-05-17,12,15,VA,US,27,1921
OUTLANDER 450,2021-05-17,11,0,VA,US,11,1855
OUTLANDER 1000,2021-05-24,5,14,VA,US,19,1831
OUTLANDER 850,2021-05-24,7,1,VA,US,8,1929
OUTLANDER 450,2021-05-24,11,11,VA,US,22,1877
OUTLANDER 1000,2021-05-31,2,3,VA,US,5,1836
OUTLANDER 850,2021-05-31,8,1,VA,US,9,1938
OUTLANDER 450,2021-05-31,5,3,VA,US,8,1885
OUTLANDER 1000,2021-06-07,2,4,VA,US,6,1842
OUTLANDER 850,2021-06-07,13,14,VA,US,27,1965
OUTLANDER 450,2021-06-07,3,13,VA,US,16,1901
OUTLANDER 1000,2021-06-14,12,11,VA,US,23,1865
OUTLANDER 850,2021-06-14,10,8,VA,US,18,1983
OUTLANDER 450,2021-06-14,3,9,VA,US,12,1913
OUTLANDER 1000,2021-06-21,7,11,VA,US,18,1883
OUTLANDER 850,2021-06-21,9,10,VA,US,19,2002
OUTLANDER 450,2021-06-21,8,9,VA,US,17,1930
OUTLANDER 1000,2021-06-28,12,9,VA,US,21,1904
OUTLANDER 850,2021-06-28,10,8,VA,US,18,2020
OUTLANDER 450,2021-06-28,14,7,VA,US,21,1951
OUTLANDER 1000,2021-07-05,12,9,VA,US,21,1925
OUTLANDER 850,2021-07-05,7,4,VA,US,11,2031
OUTLANDER 450,2021-07-05,11,5,VA,US,16,1967
OUTLANDER 1000,2021-07-12,3,11,VA,US,14,1939
OUTLANDER 850,2021-07-12,12,15,VA,US,27,2058
OUTLANDER 450,2021-07-12,14,12,VA,US,26,1993
OUTLANDER 1000,2021-07-19,6,14,VA,US,20,1959
OUTLANDER 850,2021-07-19,12,1,VA,US,13,2071
OUTLANDER 450,2021-07-19,6,4,VA,US,10,2003
OUTLANDER 1000,2021-07-26,7,8,VA,US,15,1974
OUTLANDER 850,2021-07-26,2,4,VA,US,6,2077
OUTLANDER 450,2021-07-26,13,1,VA,US,14,2017
OUTLANDER 1000,2021-08-02,11,8,VA,US,19,1993
OUTLANDER 850,2021-08-02,6,8,VA,US,14,2091
OUTLANDER 450,2021-08-02,11,5,VA,US,16,2033
OUTLANDER 1000,2021-08-09,14,7,VA,US,21,2014
OUTLANDER 850,2021-08-09,6,7,VA,US,13,2104
OUTLANDER 450,2021-08-09,14,1,VA,US,15,2048
OUTLANDER 1000,2021-08-16,7,6,VA,US,13,2027
OUTLANDER 850,2021-08-16,11,5,VA,US,16,2120
OUTLANDER 450,2021-08-16,0,15,VA,US,15,2063
OUTLANDER 1000,2021-08-23,3,5,VA,US,8,2035
OUTLANDER 850,2021-08-23,4,12,VA,US,16,2136
OUTLANDER 450,2021-08-23,12,14,VA,US,26,2089
OUTLANDER 1000,2021-08-30,9,11,VA,US,20,2055
OUTLANDER 850,2021-08-30,4,8,VA,US,12,2148
OUTLANDER 450,2021-08-30,7,0,VA,US,7,2096
OUTLANDER 1000,2021-09-06,1,7,VA,US,8,2063
OUTLANDER 850,2021-09-06,10,4,VA,US,14,2162
OUTLANDER 450,2021-09-06,8,2,VA,US,10,2106
OUTLANDER 1000,2021-09-13,5,14,VA,US,19,2082
OUTLANDER 850,2021-09-13,14,1,VA,US,15,2177
OUTLANDER 450,2021-09-13,6,8,VA,US,14,2120
OUTLANDER 1000,2021-09-20,1,12,VA,US,13,2095
OUTLANDER 850,2021-09-20,15,6,VA,US,21,2198
OUTLANDER 450,2021-09-20,10,1,VA,US,11,2131
OUTLANDER 1000,2021-09-27,9,14,VA,US,23,2118
OUTLANDER 850,2021-09-27,12,8,VA,US,20,2218
OUTLANDER 450,2021-09-27,6,12,VA,US,18,2149
OUTLANDER 1000,2021-10-04,5,5,VA,US,10,2128
OUTLANDER 850,2021-10-04,10,11,VA,US,21,2239
OUTLANDER 450,2021-10-04,14,1,VA,US,15,2164
OUTLANDER 1000,2021-10-11,0,5,VA,US,5,2133
OUTLANDER 850,2021-10-11,8,7,VA,US,15,2254
OUTLANDER 450,2021-10-11,13,2,VA,US,15,2179
OUTLANDER 1000,2021-10-18,8,8,VA,US,16,2149
OUTLANDER 850,2021-10-18,7,11,VA,US,18,2272
OUTLANDER 450,2021-10-18,6,13,VA,US,19,2198
OUTLANDER 1000,2021-10-25,3,4,VA,US,7,2156
OUTLANDER 850,2021-10-25,2,6,VA,US,8,2280
OUTLANDER 450,2021-10-25,6,14,VA,US,20,2218
OUTLANDER 1000,2021-11-01,15,0,VA,US,15,2171
OUTLANDER 850,2021-11-01,14,12,VA,US,26,2306
OUTLANDER 450,2021-11-01,8,13,VA,US,21,2239
OUTLANDER 1000,2021-11-08,1,15,VA,US,16,2187
OUTLANDER 850,2021-11-08,8,1,VA,US,9,2315
OUTLANDER 450,2021-11-08,12,4,VA,US,16,2255
OUTLANDER 1000,2021-11-15,6,1,VA,US,7,2194
OUTLANDER 850,2021-11-15,2,15,VA,US,17,2332
OUTLANDER 450,2021-11-15,13,7,VA,US,20,2275
OUTLANDER 1000,2021-11-22,4,10,VA,US,14,2208
OUTLANDER 850,2021-11-22,15,12,VA,US,27,2359
OUTLANDER 450,2021-11-22,5,1,VA,US,6,2281
OUTLANDER 1000,2021-11-29,14,1,VA,US,15,2223
OUTLANDER 850,2021-11-29,8,15,VA,US,23,2382
OUTLANDER 450,2021-11-29,1,10,VA,US,11,2292
OUTLANDER 1000,2021-12-06,13,8,VA,US,21,2244
OUTLANDER 850,2021-12-06,8,1,VA,US,9,2391
OUTLANDER 450,2021-12-06,4,3,VA,US,7,2299
OUTLANDER 1000,2021-12-13,8,6,VA,US,14,2258
OUTLANDER 850,2021-12-13,13,0,VA,US,13,2404
OUTLANDER 450,2021-12-13,4,13,VA,US,17,2316
OUTLANDER 1000,2021-12-20,15,8,VA,US,23,2281
OUTLANDER 850,2021-12-20,3,1,VA,US,4,2408
OUTLANDER 450,2021-12-20,10,9,VA,US,19,2335
OUTLANDER 1000,2021-12-27,2,2,VA,US,4,2285
OUTLANDER 850,2021-12-27,5,10,VA,US,15,2423
OUTLANDER 450,2021-12-27,2,10,VA,US,12,2347
OUTLANDER 1000,2019-01-07,11,4,WA,US,15,15
OUTLANDER 850,2019-01-07,12,6,WA,US,18,18
OUTLANDER 450,2019-01-07,5,2,WA,US,7,7
OUTLANDER 1000,2019-01-14,11,3,WA,US,14,29
OUTLANDER 850,2019-01-14,5,14,WA,US,19,37
OUTLANDER 450,2019-01-14,4,1,WA,US,5,12
OUTLANDER 1000,2019-01-21,1,9,WA,US,10,39
OUTLANDER 850,2019-01-21,4,12,WA,US,16,53
OUTLANDER 450,2019-01-21,13,3,WA,US,16,28
OUTLANDER 1000,2019-01-28,12,11,WA,US,23,62
OUTLANDER 850,2019-01-28,4,2,WA,US,6,59
OUTLANDER 450,2019-01-28,13,2,WA,US,15,43
OUTLANDER 1000,2019-02-04,8,1,WA,US,9,71
OUTLANDER 850,2019-02-04,10,1,WA,US,11,70
OUTLANDER 450,2019-02-04,14,3,WA,US,17,60
OUTLANDER 1000,2019-02-11,13,11,WA,US,24,95
OUTLANDER 850,2019-02-11,12,0,WA,US,12,82
OUTLANDER 450,2019-02-11,8,8,WA,US,16,76
OUTLANDER 1000,2019-02-18,13,7,WA,US,20,115
OUTLANDER 850,2019-02-18,1,2,WA,US,3,85
OUTLANDER 450,2019-02-18,12,1,WA,US,13,89
OUTLANDER 1000,2019-02-25,13,3,WA,US,16,131
OUTLANDER 850,2019-02-25,2,0,WA,US,2,87
OUTLANDER 450,2019-02-25,15,9,WA,US,24,113
OUTLANDER 1000,2019-03-04,13,8,WA,US,21,152
OUTLANDER 850,2019-03-04,6,7,WA,US,13,100
OUTLANDER 450,2019-03-04,1,12,WA,US,13,126
OUTLANDER 1000,2019-03-11,4,9,WA,US,13,165
OUTLANDER 850,2019-03-11,13,12,WA,US,25,125
OUTLANDER 450,2019-03-11,10,12,WA,US,22,148
OUTLANDER 1000,2019-03-18,11,13,WA,US,24,189
OUTLANDER 850,2019-03-18,7,14,WA,US,21,146
OUTLANDER 450,2019-03-18,13,10,WA,US,23,171
OUTLANDER 1000,2019-03-25,15,11,WA,US,26,215
OUTLANDER 850,2019-03-25,12,8,WA,US,20,166
OUTLANDER 450,2019-03-25,3,7,WA,US,10,181
OUTLANDER 1000,2019-04-01,15,3,WA,US,18,233
OUTLANDER 850,2019-04-01,2,1,WA,US,3,169
OUTLANDER 450,2019-04-01,9,7,WA,US,16,197
OUTLANDER 1000,2019-04-08,4,3,WA,US,7,240
OUTLANDER 850,2019-04-08,2,13,WA,US,15,184
OUTLANDER 450,2019-04-08,3,8,WA,US,11,208
OUTLANDER 1000,2019-04-15,1,12,WA,US,13,253
OUTLANDER 850,2019-04-15,6,4,WA,US,10,194
OUTLANDER 450,2019-04-15,7,4,WA,US,11,219
OUTLANDER 1000,2019-04-22,4,15,WA,US,19,272
OUTLANDER 850,2019-04-22,0,13,WA,US,13,207
OUTLANDER 450,2019-04-22,11,2,WA,US,13,232
OUTLANDER 1000,2019-04-29,3,10,WA,US,13,285
OUTLANDER 850,2019-04-29,13,15,WA,US,28,235
OUTLANDER 450,2019-04-29,2,5,WA,US,7,239
OUTLANDER 1000,2019-05-06,4,2,WA,US,6,291
OUTLANDER 850,2019-05-06,4,10,WA,US,14,249
OUTLANDER 450,2019-05-06,5,4,WA,US,9,248
OUTLANDER 1000,2019-05-13,7,10,WA,US,17,308
OUTLANDER 850,2019-05-13,1,13,WA,US,14,263
OUTLANDER 450,2019-05-13,1,12,WA,US,13,261
OUTLANDER 1000,2019-05-20,9,7,WA,US,16,324
OUTLANDER 850,2019-05-20,12,8,WA,US,20,283
OUTLANDER 450,2019-05-20,2,9,WA,US,11,272
OUTLANDER 1000,2019-05-27,9,3,WA,US,12,336
OUTLANDER 850,2019-05-27,12,1,WA,US,13,296
OUTLANDER 450,2019-05-27,8,15,WA,US,23,295
OUTLANDER 1000,2019-06-03,5,14,WA,US,19,355
OUTLANDER 850,2019-06-03,10,6,WA,US,16,312
OUTLANDER 450,2019-06-03,0,9,WA,US,9,304
OUTLANDER 1000,2019-06-10,7,13,WA,US,20,375
OUTLANDER 850,2019-06-10,4,2,WA,US,6,318
OUTLANDER 450,2019-06-10,2,7,WA,US,9,313
OUTLANDER 1000,2019-06-17,7,12,WA,US,19,394
OUTLANDER 850,2019-06-17,13,7,WA,US,20,338
OUTLANDER 450,2019-06-17,15,6,WA,US,21,334
OUTLANDER 1000,2019-06-24,8,2,WA,US,10,404
OUTLANDER 850,2019-06-24,11,6,WA,US,17,355
OUTLANDER 450,2019-06-24,9,5,WA,US,14,348
OUTLANDER 1000,2019-07-01,5,9,WA,US,14,418
OUTLANDER 850,2019-07-01,9,4,WA,US,13,368
OUTLANDER 450,2019-07-01,3,11,WA,US,14,362
OUTLANDER 1000,2019-07-08,15,4,WA,US,19,437
OUTLANDER 850,2019-07-08,11,10,WA,US,21,389
OUTLANDER 450,2019-07-08,7,1,WA,US,8,370
OUTLANDER 1000,2019-07-15,2,13,WA,US,15,452
OUTLANDER 850,2019-07-15,2,8,WA,US,10,399
OUTLANDER 450,2019-07-15,1,6,WA,US,7,377
OUTLANDER 1000,2019-07-22,9,6,WA,US,15,467
OUTLANDER 850,2019-07-22,13,8,WA,US,21,420
OUTLANDER 450,2019-07-22,9,1,WA,US,10,387
OUTLANDER 1000,2019-07-29,14,13,WA,US,27,494
OUTLANDER 850,2019-07-29,14,13,WA,US,27,447
OUTLANDER 450,2019-07-29,0,7,WA,US,7,394
OUTLANDER 1000,2019-08-05,11,2,WA,US,13,507
OUTLANDER 850,2019-08-05,1,8,WA,US,9,456
OUTLANDER 450,2019-08-05,2,14,WA,US,16,410
OUTLANDER 1000,2019-08-12,4,3,WA,US,7,514
OUTLANDER 850,2019-08-12,2,14,WA,US,16,472
OUTLANDER 450,2019-08-12,5,4,WA,US,9,419
OUTLANDER 1000,2019-08-19,1,15,WA,US,16,530
OUTLANDER 850,2019-08-19,5,2,WA,US,7,479
OUTLANDER 450,2019-08-19,12,2,WA,US,14,433
OUTLANDER 1000,2019-08-26,14,6,WA,US,20,550
OUTLANDER 850,2019-08-26,8,15,WA,US,23,502
OUTLANDER 450,2019-08-26,6,4,WA,US,10,443
OUTLANDER 1000,2019-09-02,14,10,WA,US,24,574
OUTLANDER 850,2019-09-02,13,14,WA,US,27,529
OUTLANDER 450,2019-09-02,0,4,WA,US,4,447
OUTLANDER 1000,2019-09-09,4,11,WA,US,15,589
OUTLANDER 850,2019-09-09,3,1,WA,US,4,533
OUTLANDER 450,2019-09-09,8,3,WA,US,11,458
OUTLANDER 1000,2019-09-16,7,14,WA,US,21,610
OUTLANDER 850,2019-09-16,2,9,WA,US,11,544
OUTLANDER 450,2019-09-16,11,11,WA,US,22,480
OUTLANDER 1000,2019-09-23,13,1,WA,US,14,624
OUTLANDER 850,2019-09-23,13,12,WA,US,25,569
OUTLANDER 450,2019-09-23,14,0,WA,US,14,494
OUTLANDER 1000,2019-09-30,3,7,WA,US,10,634
OUTLANDER 850,2019-09-30,10,4,WA,US,14,583
OUTLANDER 450,2019-09-30,9,13,WA,US,22,516
OUTLANDER 1000,2019-10-07,11,12,WA,US,23,657
OUTLANDER 850,2019-10-07,9,11,WA,US,20,603
OUTLANDER 450,2019-10-07,10,13,WA,US,23,539
OUTLANDER 1000,2019-10-14,6,1,WA,US,7,664
OUTLANDER 850,2019-10-14,4,6,WA,US,10,613
OUTLANDER 450,2019-10-14,14,1,WA,US,15,554
OUTLANDER 1000,2019-10-21,3,10,WA,US,13,677
OUTLANDER 850,2019-10-21,6,12,WA,US,18,631
OUTLANDER 450,2019-10-21,10,7,WA,US,17,571
OUTLANDER 1000,2019-10-28,9,9,WA,US,18,695
OUTLANDER 850,2019-10-28,4,11,WA,US,15,646
OUTLANDER 450,2019-10-28,10,2,WA,US,12,583
OUTLANDER 1000,2019-11-04,10,6,WA,US,16,711
OUTLANDER 850,2019-11-04,5,2,WA,US,7,653
OUTLANDER 450,2019-11-04,12,9,WA,US,21,604
OUTLANDER 1000,2019-11-11,5,11,WA,US,16,727
OUTLANDER 850,2019-11-11,5,10,WA,US,15,668
OUTLANDER 450,2019-11-11,2,12,WA,US,14,618
OUTLANDER 1000,2019-11-18,5,12,WA,US,17,744
OUTLANDER 850,2019-11-18,10,3,WA,US,13,681
OUTLANDER 450,2019-11-18,3,10,WA,US,13,631
OUTLANDER 1000,2019-11-25,8,3,WA,US,11,755
OUTLANDER 850,2019-11-25,3,13,WA,US,16,697
OUTLANDER 450,2019-11-25,10,11,WA,US,21,652
OUTLANDER 1000,2019-12-02,2,6,WA,US,8,763
OUTLANDER 850,2019-12-02,12,6,WA,US,18,715
OUTLANDER 450,2019-12-02,13,11,WA,US,24,676
OUTLANDER 1000,2019-12-09,5,9,WA,US,14,777
OUTLANDER 850,2019-12-09,7,6,WA,US,13,728
OUTLANDER 450,2019-12-09,7,2,WA,US,9,685
OUTLANDER 1000,2019-12-16,1,11,WA,US,12,789
OUTLANDER 850,2019-12-16,5,2,WA,US,7,735
OUTLANDER 450,2019-12-16,1,3,WA,US,4,689
OUTLANDER 1000,2019-12-23,3,8,WA,US,11,800
OUTLANDER 850,2019-12-23,8,5,WA,US,13,748
OUTLANDER 450,2019-12-23,1,6,WA,US,7,696
OUTLANDER 1000,2019-12-30,7,3,WA,US,10,810
OUTLANDER 850,2019-12-30,13,1,WA,US,14,762
OUTLANDER 450,2019-12-30,11,15,WA,US,26,722
OUTLANDER 1000,2020-01-06,12,13,WA,US,25,835
OUTLANDER 850,2020-01-06,13,11,WA,US,24,786
OUTLANDER 450,2020-01-06,13,14,WA,US,27,749
OUTLANDER 1000,2020-01-13,8,5,WA,US,13,848
OUTLANDER 850,2020-01-13,9,12,WA,US,21,807
OUTLANDER 450,2020-01-13,10,4,WA,US,14,763
OUTLANDER 1000,2020-01-20,1,5,WA,US,6,854
OUTLANDER 850,2020-01-20,9,1,WA,US,10,817
OUTLANDER 450,2020-01-20,6,9,WA,US,15,778
OUTLANDER 1000,2020-01-27,9,6,WA,US,15,869
OUTLANDER 850,2020-01-27,13,15,WA,US,28,845
OUTLANDER 450,2020-01-27,6,9,WA,US,15,793
OUTLANDER 1000,2020-02-03,15,11,WA,US,26,895
OUTLANDER 850,2020-02-03,0,12,WA,US,12,857
OUTLANDER 450,2020-02-03,5,5,WA,US,10,803
OUTLANDER 1000,2020-02-10,14,11,WA,US,25,920
OUTLANDER 850,2020-02-10,6,13,WA,US,19,876
OUTLANDER 450,2020-02-10,5,11,WA,US,16,819
OUTLANDER 1000,2020-02-17,11,13,WA,US,24,944
OUTLANDER 850,2020-02-17,10,3,WA,US,13,889
OUTLANDER 450,2020-02-17,12,13,WA,US,25,844
OUTLANDER 1000,2020-02-24,2,1,WA,US,3,947
OUTLANDER 850,2020-02-24,2,14,WA,US,16,905
OUTLANDER 450,2020-02-24,2,1,WA,US,3,847
OUTLANDER 1000,2020-03-02,7,7,WA,US,14,961
OUTLANDER 850,2020-03-02,6,7,WA,US,13,918
OUTLANDER 450,2020-03-02,7,1,WA,US,8,855
OUTLANDER 1000,2020-03-09,12,14,WA,US,26,987
OUTLANDER 850,2020-03-09,8,6,WA,US,14,932
OUTLANDER 450,2020-03-09,3,12,WA,US,15,870
OUTLANDER 1000,2020-03-16,7,14,WA,US,21,1008
OUTLANDER 850,2020-03-16,10,11,WA,US,21,953
OUTLANDER 450,2020-03-16,5,6,WA,US,11,881
OUTLANDER 1000,2020-03-23,14,12,WA,US,26,1034
OUTLANDER 850,2020-03-23,0,1,WA,US,1,954
OUTLANDER 450,2020-03-23,9,13,WA,US,22,903
OUTLANDER 1000,2020-03-30,3,10,WA,US,13,1047
OUTLANDER 850,2020-03-30,2,13,WA,US,15,969
OUTLANDER 450,2020-03-30,10,6,WA,US,16,919
OUTLANDER 1000,2020-04-06,8,10,WA,US,18,1065
OUTLANDER 850,2020-04-06,6,9,WA,US,15,984
OUTLANDER 450,2020-04-06,4,1,WA,US,5,924
OUTLANDER 1000,2020-04-13,14,1,WA,US,15,1080
OUTLANDER 850,2020-04-13,2,12,WA,US,14,998
OUTLANDER 450,2020-04-13,11,5,WA,US,16,940
OUTLANDER 1000,2020-04-20,10,10,WA,US,20,1100
OUTLANDER 850,2020-04-20,12,12,WA,US,24,1022
OUTLANDER 450,2020-04-20,7,6,WA,US,13,953
OUTLANDER 1000,2020-04-27,4,7,WA,US,11,1111
OUTLANDER 850,2020-04-27,14,12,WA,US,26,1048
OUTLANDER 450,2020-04-27,12,6,WA,US,18,971
OUTLANDER 1000,2020-05-04,13,6,WA,US,19,1130
OUTLANDER 850,2020-05-04,3,1,WA,US,4,1052
OUTLANDER 450,2020-05-04,2,12,WA,US,14,985
OUTLANDER 1000,2020-05-11,0,11,WA,US,11,1141
OUTLANDER 850,2020-05-11,5,2,WA,US,7,1059
OUTLANDER 450,2020-05-11,0,9,WA,US,9,994
OUTLANDER 1000,2020-05-18,3,10,WA,US,13,1154
OUTLANDER 850,2020-05-18,7,9,WA,US,16,1075
OUTLANDER 450,2020-05-18,1,12,WA,US,13,1007
OUTLANDER 1000,2020-05-25,15,6,WA,US,21,1175
OUTLANDER 850,2020-05-25,15,5,WA,US,20,1095
OUTLANDER 450,2020-05-25,6,13,WA,US,19,1026
OUTLANDER 1000,2020-06-01,2,1,WA,US,3,1178
OUTLANDER 850,2020-06-01,8,11,WA,US,19,1114
OUTLANDER 450,2020-06-01,4,0,WA,US,4,1030
OUTLANDER 1000,2020-06-08,5,4,WA,US,9,1187
OUTLANDER 850,2020-06-08,11,14,WA,US,25,1139
OUTLANDER 450,2020-06-08,6,12,WA,US,18,1048
OUTLANDER 1000,2020-06-15,12,4,WA,US,16,1203
OUTLANDER 850,2020-06-15,1,11,WA,US,12,1151
OUTLANDER 450,2020-06-15,5,2,WA,US,7,1055
OUTLANDER 1000,2020-06-22,2,14,WA,US,16,1219
OUTLANDER 850,2020-06-22,12,9,WA,US,21,1172
OUTLANDER 450,2020-06-22,8,9,WA,US,17,1072
OUTLANDER 1000,2020-06-29,8,7,WA,US,15,1234
OUTLANDER 850,2020-06-29,15,10,WA,US,25,1197
OUTLANDER 450,2020-06-29,1,3,WA,US,4,1076
OUTLANDER 1000,2020-07-06,14,13,WA,US,27,1261
OUTLANDER 850,2020-07-06,6,2,WA,US,8,1205
OUTLANDER 450,2020-07-06,7,9,WA,US,16,1092
OUTLANDER 1000,2020-07-13,13,2,WA,US,15,1276
OUTLANDER 850,2020-07-13,9,15,WA,US,24,1229
OUTLANDER 450,2020-07-13,12,7,WA,US,19,1111
OUTLANDER 1000,2020-07-20,1,5,WA,US,6,1282
OUTLANDER 850,2020-07-20,9,6,WA,US,15,1244
OUTLANDER 450,2020-07-20,9,14,WA,US,23,1134
OUTLANDER 1000,2020-07-27,13,12,WA,US,25,1307
OUTLANDER 850,2020-07-27,8,14,WA,US,22,1266
OUTLANDER 450,2020-07-27,12,6,WA,US,18,1152
OUTLANDER 1000,2020-08-03,12,15,WA,US,27,1334
OUTLANDER 850,2020-08-03,6,8,WA,US,14,1280
OUTLANDER 450,2020-08-03,10,2,WA,US,12,1164
OUTLANDER 1000,2020-08-10,14,7,WA,US,21,1355
OUTLANDER 850,2020-08-10,1,6,WA,US,7,1287
OUTLANDER 450,2020-08-10,2,4,WA,US,6,1170
OUTLANDER 1000,2020-08-17,9,5,WA,US,14,1369
OUTLANDER 850,2020-08-17,12,0,WA,US,12,1299
OUTLANDER 450,2020-08-17,9,11,WA,US,20,1190
OUTLANDER 1000,2020-08-24,1,12,WA,US,13,1382
OUTLANDER 850,2020-08-24,11,5,WA,US,16,1315
OUTLANDER 450,2020-08-24,1,8,WA,US,9,1199
OUTLANDER 1000,2020-08-31,11,8,WA,US,19,1401
OUTLANDER 850,2020-08-31,0,8,WA,US,8,1323
OUTLANDER 450,2020-08-31,11,11,WA,US,22,1221
OUTLANDER 1000,2020-09-07,5,15,WA,US,20,1421
OUTLANDER 850,2020-09-07,9,0,WA,US,9,1332
OUTLANDER 450,2020-09-07,1,8,WA,US,9,1230
OUTLANDER 1000,2020-09-14,7,6,WA,US,13,1434
OUTLANDER 850,2020-09-14,2,2,WA,US,4,1336
OUTLANDER 450,2020-09-14,14,3,WA,US,17,1247
OUTLANDER 1000,2020-09-21,14,0,WA,US,14,1448
OUTLANDER 850,2020-09-21,5,11,WA,US,16,1352
OUTLANDER 450,2020-09-21,1,6,WA,US,7,1254
OUTLANDER 1000,2020-09-28,12,4,WA,US,16,1464
OUTLANDER 850,2020-09-28,8,6,WA,US,14,1366
OUTLANDER 450,2020-09-28,14,1,WA,US,15,1269
OUTLANDER 1000,2020-10-05,9,11,WA,US,20,1484
OUTLANDER 850,2020-10-05,12,3,WA,US,15,1381
OUTLANDER 450,2020-10-05,6,6,WA,US,12,1281
OUTLANDER 1000,2020-10-12,1,6,WA,US,7,1491
OUTLANDER 850,2020-10-12,3,1,WA,US,4,1385
OUTLANDER 450,2020-10-12,11,9,WA,US,20,1301
OUTLANDER 1000,2020-10-19,0,13,WA,US,13,1504
OUTLANDER 850,2020-10-19,10,3,WA,US,13,1398
OUTLANDER 450,2020-10-19,9,7,WA,US,16,1317
OUTLANDER 1000,2020-10-26,5,9,WA,US,14,1518
OUTLANDER 850,2020-10-26,13,3,WA,US,16,1414
OUTLANDER 450,2020-10-26,5,9,WA,US,14,1331
OUTLANDER 1000,2020-11-02,13,2,WA,US,15,1533
OUTLANDER 850,2020-11-02,10,14,WA,US,24,1438
OUTLANDER 450,2020-11-02,13,7,WA,US,20,1351
OUTLANDER 1000,2020-11-09,5,8,WA,US,13,1546
OUTLANDER 850,2020-11-09,10,1,WA,US,11,1449
OUTLANDER 450,2020-11-09,10,9,WA,US,19,1370
OUTLANDER 1000,2020-11-16,5,4,WA,US,9,1555
OUTLANDER 850,2020-11-16,7,8,WA,US,15,1464
OUTLANDER 450,2020-11-16,4,12,WA,US,16,1386
OUTLANDER 1000,2020-11-23,4,3,WA,US,7,1562
OUTLANDER 850,2020-11-23,14,5,WA,US,19,1483
OUTLANDER 450,2020-11-23,9,2,WA,US,11,1397
OUTLANDER 1000,2020-11-30,8,5,WA,US,13,1575
OUTLANDER 850,2020-11-30,3,10,WA,US,13,1496
OUTLANDER 450,2020-11-30,3,6,WA,US,9,1406
OUTLANDER 1000,2020-12-07,10,11,WA,US,21,1596
OUTLANDER 850,2020-12-07,3,3,WA,US,6,1502
OUTLANDER 450,2020-12-07,14,13,WA,US,27,1433
OUTLANDER 1000,2020-12-14,9,14,WA,US,23,1619
OUTLANDER 850,2020-12-14,6,2,WA,US,8,1510
OUTLANDER 450,2020-12-14,6,6,WA,US,12,1445
OUTLANDER 1000,2020-12-21,4,14,WA,US,18,1637
OUTLANDER 850,2020-12-21,2,3,WA,US,5,1515
OUTLANDER 450,2020-12-21,3,2,WA,US,5,1450
OUTLANDER 1000,2020-12-28,8,12,WA,US,20,1657
OUTLANDER 850,2020-12-28,10,7,WA,US,17,1532
OUTLANDER 450,2020-12-28,14,5,WA,US,19,1469
OUTLANDER 1000,2021-01-04,2,1,WA,US,3,1660
OUTLANDER 850,2021-01-04,9,13,WA,US,22,1554
OUTLANDER 450,2021-01-04,6,6,WA,US,12,1481
OUTLANDER 1000,2021-01-11,14,6,WA,US,20,1680
OUTLANDER 850,2021-01-11,1,13,WA,US,14,1568
OUTLANDER 450,2021-01-11,8,7,WA,US,15,1496
OUTLANDER 1000,2021-01-18,2,11,WA,US,13,1693
OUTLANDER 850,2021-01-18,7,6,WA,US,13,1581
OUTLANDER 450,2021-01-18,10,1,WA,US,11,1507
OUTLANDER 1000,2021-01-25,9,6,WA,US,15,1708
OUTLANDER 850,2021-01-25,7,11,WA,US,18,1599
OUTLANDER 450,2021-01-25,6,4,WA,US,10,1517
OUTLANDER 1000,2021-02-01,14,7,WA,US,21,1729
OUTLANDER 850,2021-02-01,10,14,WA,US,24,1623
OUTLANDER 450,2021-02-01,14,1,WA,US,15,1532
OUTLANDER 1000,2021-02-08,1,10,WA,US,11,1740
OUTLANDER 850,2021-02-08,4,10,WA,US,14,1637
OUTLANDER 450,2021-02-08,9,3,WA,US,12,1544
OUTLANDER 1000,2021-02-15,6,15,WA,US,21,1761
OUTLANDER 850,2021-02-15,8,4,WA,US,12,1649
OUTLANDER 450,2021-02-15,14,11,WA,US,25,1569
OUTLANDER 1000,2021-02-22,1,13,WA,US,14,1775
OUTLANDER 850,2021-02-22,15,6,WA,US,21,1670
OUTLANDER 450,2021-02-22,8,10,WA,US,18,1587
OUTLANDER 1000,2021-03-01,7,6,WA,US,13,1788
OUTLANDER 850,2021-03-01,13,14,WA,US,27,1697
OUTLANDER 450,2021-03-01,12,2,WA,US,14,1601
OUTLANDER 1000,2021-03-08,8,6,WA,US,14,1802
OUTLANDER 850,2021-03-08,3,2,WA,US,5,1702
OUTLANDER 450,2021-03-08,7,11,WA,US,18,1619
OUTLANDER 1000,2021-03-15,0,0,WA,US,0,1802
OUTLANDER 850,2021-03-15,5,1,WA,US,6,1708
OUTLANDER 450,2021-03-15,3,2,WA,US,5,1624
OUTLANDER 1000,2021-03-22,1,13,WA,US,14,1816
OUTLANDER 850,2021-03-22,10,6,WA,US,16,1724
OUTLANDER 450,2021-03-22,1,5,WA,US,6,1630
OUTLANDER 1000,2021-03-29,8,1,WA,US,9,1825
OUTLANDER 850,2021-03-29,10,3,WA,US,13,1737
OUTLANDER 450,2021-03-29,14,3,WA,US,17,1647
OUTLANDER 1000,2021-04-05,7,7,WA,US,14,1839
OUTLANDER 850,2021-04-05,0,1,WA,US,1,1738
OUTLANDER 450,2021-04-05,12,13,WA,US,25,1672
OUTLANDER 1000,2021-04-12,10,7,WA,US,17,1856
OUTLANDER 850,2021-04-12,5,4,WA,US,9,1747
OUTLANDER 450,2021-04-12,5,5,WA,US,10,1682
OUTLANDER 1000,2021-04-19,13,13,WA,US,26,1882
OUTLANDER 850,2021-04-19,11,4,WA,US,15,1762
OUTLANDER 450,2021-04-19,5,4,WA,US,9,1691
OUTLANDER 1000,2021-04-26,14,12,WA,US,26,1908
OUTLANDER 850,2021-04-26,9,11,WA,US,20,1782
OUTLANDER 450,2021-04-26,1,14,WA,US,15,1706
OUTLANDER 1000,2021-05-03,6,6,WA,US,12,1920
OUTLANDER 850,2021-05-03,3,2,WA,US,5,1787
OUTLANDER 450,2021-05-03,14,7,WA,US,21,1727
OUTLANDER 1000,2021-05-10,6,10,WA,US,16,1936
OUTLANDER 850,2021-05-10,5,1,WA,US,6,1793
OUTLANDER 450,2021-05-10,5,2,WA,US,7,1734
OUTLANDER 1000,2021-05-17,1,6,WA,US,7,1943
OUTLANDER 850,2021-05-17,3,7,WA,US,10,1803
OUTLANDER 450,2021-05-17,9,10,WA,US,19,1753
OUTLANDER 1000,2021-05-24,3,5,WA,US,8,1951
OUTLANDER 850,2021-05-24,3,0,WA,US,3,1806
OUTLANDER 450,2021-05-24,5,4,WA,US,9,1762
OUTLANDER 1000,2021-05-31,11,11,WA,US,22,1973
OUTLANDER 850,2021-05-31,3,1,WA,US,4,1810
OUTLANDER 450,2021-05-31,14,14,WA,US,28,1790
OUTLANDER 1000,2021-06-07,4,13,WA,US,17,1990
OUTLANDER 850,2021-06-07,6,9,WA,US,15,1825
OUTLANDER 450,2021-06-07,2,2,WA,US,4,1794
OUTLANDER 1000,2021-06-14,0,7,WA,US,7,1997
OUTLANDER 850,2021-06-14,4,9,WA,US,13,1838
OUTLANDER 450,2021-06-14,1,4,WA,US,5,1799
OUTLANDER 1000,2021-06-21,1,3,WA,US,4,2001
OUTLANDER 850,2021-06-21,12,9,WA,US,21,1859
OUTLANDER 450,2021-06-21,2,7,WA,US,9,1808
OUTLANDER 1000,2021-06-28,10,12,WA,US,22,2023
OUTLANDER 850,2021-06-28,14,11,WA,US,25,1884
OUTLANDER 450,2021-06-28,2,2,WA,US,4,1812
OUTLANDER 1000,2021-07-05,12,4,WA,US,16,2039
OUTLANDER 850,2021-07-05,14,10,WA,US,24,1908
OUTLANDER 450,2021-07-05,11,10,WA,US,21,1833
OUTLANDER 1000,2021-07-12,2,0,WA,US,2,2041
OUTLANDER 850,2021-07-12,4,2,WA,US,6,1914
OUTLANDER 450,2021-07-12,3,1,WA,US,4,1837
OUTLANDER 1000,2021-07-19,12,13,WA,US,25,2066
OUTLANDER 850,2021-07-19,9,2,WA,US,11,1925
OUTLANDER 450,2021-07-19,13,12,WA,US,25,1862
OUTLANDER 1000,2021-07-26,7,8,WA,US,15,2081
OUTLANDER 850,2021-07-26,1,13,WA,US,14,1939
OUTLANDER 450,2021-07-26,10,5,WA,US,15,1877
OUTLANDER 1000,2021-08-02,8,2,WA,US,10,2091
OUTLANDER 850,2021-08-02,6,2,WA,US,8,1947
OUTLANDER 450,2021-08-02,9,1,WA,US,10,1887
OUTLANDER 1000,2021-08-09,15,5,WA,US,20,2111
OUTLANDER 850,2021-08-09,8,0,WA,US,8,1955
OUTLANDER 450,2021-08-09,5,4,WA,US,9,1896
OUTLANDER 1000,2021-08-16,6,12,WA,US,18,2129
OUTLANDER 850,2021-08-16,11,12,WA,US,23,1978
OUTLANDER 450,2021-08-16,7,12,WA,US,19,1915
OUTLANDER 1000,2021-08-23,5,14,WA,US,19,2148
OUTLANDER 850,2021-08-23,5,5,WA,US,10,1988
OUTLANDER 450,2021-08-23,5,10,WA,US,15,1930
OUTLANDER 1000,2021-08-30,0,7,WA,US,7,2155
OUTLANDER 850,2021-08-30,7,5,WA,US,12,2000
OUTLANDER 450,2021-08-30,11,6,WA,US,17,1947
OUTLANDER 1000,2021-09-06,4,8,WA,US,12,2167
OUTLANDER 850,2021-09-06,13,1,WA,US,14,2014
OUTLANDER 450,2021-09-06,9,3,WA,US,12,1959
OUTLANDER 1000,2021-09-13,4,1,WA,US,5,2172
OUTLANDER 850,2021-09-13,4,14,WA,US,18,2032
OUTLANDER 450,2021-09-13,11,2,WA,US,13,1972
OUTLANDER 1000,2021-09-20,12,1,WA,US,13,2185
OUTLANDER 850,2021-09-20,1,8,WA,US,9,2041
OUTLANDER 450,2021-09-20,3,14,WA,US,17,1989
OUTLANDER 1000,2021-09-27,11,11,WA,US,22,2207
OUTLANDER 850,2021-09-27,12,3,WA,US,15,2056
OUTLANDER 450,2021-09-27,8,12,WA,US,20,2009
OUTLANDER 1000,2021-10-04,6,4,WA,US,10,2217
OUTLANDER 850,2021-10-04,0,8,WA,US,8,2064
OUTLANDER 450,2021-10-04,8,6,WA,US,14,2023
OUTLANDER 1000,2021-10-11,10,7,WA,US,17,2234
OUTLANDER 850,2021-10-11,3,1,WA,US,4,2068
OUTLANDER 450,2021-10-11,2,4,WA,US,6,2029
OUTLANDER 1000,2021-10-18,3,5,WA,US,8,2242
OUTLANDER 850,2021-10-18,9,1,WA,US,10,2078
OUTLANDER 450,2021-10-18,13,9,WA,US,22,2051
OUTLANDER 1000,2021-10-25,12,9,WA,US,21,2263
OUTLANDER 850,2021-10-25,7,1,WA,US,8,2086
OUTLANDER 450,2021-10-25,4,15,WA,US,19,2070
OUTLANDER 1000,2021-11-01,15,8,WA,US,23,2286
OUTLANDER 850,2021-11-01,6,1,WA,US,7,2093
OUTLANDER 450,2021-11-01,6,5,WA,US,11,2081
OUTLANDER 1000,2021-11-08,5,1,WA,US,6,2292
OUTLANDER 850,2021-11-08,11,1,WA,US,12,2105
OUTLANDER 450,2021-11-08,10,5,WA,US,15,2096
OUTLANDER 1000,2021-11-15,13,12,WA,US,25,2317
OUTLANDER 850,2021-11-15,1,12,WA,US,13,2118
OUTLANDER 450,2021-11-15,3,2,WA,US,5,2101
OUTLANDER 1000,2021-11-22,12,0,WA,US,12,2329
OUTLANDER 850,2021-11-22,12,12,WA,US,24,2142
OUTLANDER 450,2021-11-22,7,14,WA,US,21,2122
OUTLANDER 1000,2021-11-29,5,2,WA,US,7,2336
OUTLANDER 850,2021-11-29,6,3,WA,US,9,2151
OUTLANDER 450,2021-11-29,5,14,WA,US,19,2141
OUTLANDER 1000,2021-12-06,3,15,WA,US,18,2354
OUTLANDER 850,2021-12-06,14,10,WA,US,24,2175
OUTLANDER 450,2021-12-06,3,5,WA,US,8,2149
OUTLANDER 1000,2021-12-13,2,14,WA,US,16,2370
OUTLANDER 850,2021-12-13,5,10,WA,US,15,2190
OUTLANDER 450,2021-12-13,9,15,WA,US,24,2173
OUTLANDER 1000,2021-12-20,3,7,WA,US,10,2380
OUTLANDER 850,2021-12-20,11,5,WA,US,16,2206
OUTLANDER 450,2021-12-20,7,7,WA,US,14,2187
OUTLANDER 1000,2021-12-27,14,8,WA,US,22,2402
OUTLANDER 850,2021-12-27,6,5,WA,US,11,2217
OUTLANDER 450,2021-12-27,10,14,WA,US,24,2211
OUTLANDER 1000,2019-01-07,0,12,WV,US,12,12
OUTLANDER 850,2019-01-07,4,10,WV,US,14,14
OUTLANDER 450,2019-01-07,12,11,WV,US,23,23
OUTLANDER 1000,2019-01-14,3,9,WV,US,12,24
OUTLANDER 850,2019-01-14,2,14,WV,US,16,30
OUTLANDER 450,2019-01-14,12,11,WV,US,23,46
OUTLANDER 1000,2019-01-21,9,1,WV,US,10,34
OUTLANDER 850,2019-01-21,12,14,WV,US,26,56
OUTLANDER 450,2019-01-21,5,3,WV,US,8,54
OUTLANDER 1000,2019-01-28,14,2,WV,US,16,50
OUTLANDER 850,2019-01-28,6,9,WV,US,15,71
OUTLANDER 450,2019-01-28,3,11,WV,US,14,68
OUTLANDER 1000,2019-02-04,9,7,WV,US,16,66
OUTLANDER 850,2019-02-04,1,3,WV,US,4,75
OUTLANDER 450,2019-02-04,14,15,WV,US,29,97
OUTLANDER 1000,2019-02-11,12,0,WV,US,12,78
OUTLANDER 850,2019-02-11,14,8,WV,US,22,97
OUTLANDER 450,2019-02-11,14,13,WV,US,27,124
OUTLANDER 1000,2019-02-18,1,11,WV,US,12,90
OUTLANDER 850,2019-02-18,14,0,WV,US,14,111
OUTLANDER 450,2019-02-18,13,6,WV,US,19,143
OUTLANDER 1000,2019-02-25,14,12,WV,US,26,116
OUTLANDER 850,2019-02-25,10,1,WV,US,11,122
OUTLANDER 450,2019-02-25,8,12,WV,US,20,163
OUTLANDER 1000,2019-03-04,6,8,WV,US,14,130
OUTLANDER 850,2019-03-04,0,14,WV,US,14,136
OUTLANDER 450,2019-03-04,5,4,WV,US,9,172
OUTLANDER 1000,2019-03-11,9,2,WV,US,11,141
OUTLANDER 850,2019-03-11,10,6,WV,US,16,152
OUTLANDER 450,2019-03-11,12,7,WV,US,19,191
OUTLANDER 1000,2019-03-18,0,0,WV,US,0,141
OUTLANDER 850,2019-03-18,11,14,WV,US,25,177
OUTLANDER 450,2019-03-18,10,6,WV,US,16,207
OUTLANDER 1000,2019-03-25,2,3,WV,US,5,146
OUTLANDER 850,2019-03-25,4,2,WV,US,6,183
OUTLANDER 450,2019-03-25,6,2,WV,US,8,215
OUTLANDER 1000,2019-04-01,13,4,WV,US,17,163
OUTLANDER 850,2019-04-01,7,11,WV,US,18,201
OUTLANDER 450,2019-04-01,9,13,WV,US,22,237
OUTLANDER 1000,2019-04-08,2,14,WV,US,16,179
OUTLANDER 850,2019-04-08,3,1,WV,US,4,205
OUTLANDER 450,2019-04-08,14,12,WV,US,26,263
OUTLANDER 1000,2019-04-15,4,13,WV,US,17,196
OUTLANDER 850,2019-04-15,2,5,WV,US,7,212
OUTLANDER 450,2019-04-15,7,9,WV,US,16,279
OUTLANDER 1000,2019-04-22,3,2,WV,US,5,201
OUTLANDER 850,2019-04-22,4,2,WV,US,6,218
OUTLANDER 450,2019-04-22,10,13,WV,US,23,302
OUTLANDER 1000,2019-04-29,8,9,WV,US,17,218
OUTLANDER 850,2019-04-29,12,7,WV,US,19,237
OUTLANDER 450,2019-04-29,7,1,WV,US,8,310
OUTLANDER 1000,2019-05-06,5,13,WV,US,18,236
OUTLANDER 850,2019-05-06,5,3,WV,US,8,245
OUTLANDER 450,2019-05-06,6,9,WV,US,15,325
OUTLANDER 1000,2019-05-13,3,9,WV,US,12,248
OUTLANDER 850,2019-05-13,13,3,WV,US,16,261
OUTLANDER 450,2019-05-13,10,3,WV,US,13,338
OUTLANDER 1000,2019-05-20,11,1,WV,US,12,260
OUTLANDER 850,2019-05-20,10,0,WV,US,10,271
OUTLANDER 450,2019-05-20,8,6,WV,US,14,352
OUTLANDER 1000,2019-05-27,2,9,WV,US,11,271
OUTLANDER 850,2019-05-27,7,1,WV,US,8,279
OUTLANDER 450,2019-05-27,8,12,WV,US,20,372
OUTLANDER 1000,2019-06-03,3,1,WV,US,4,275
OUTLANDER 850,2019-06-03,5,4,WV,US,9,288
OUTLANDER 450,2019-06-03,13,11,WV,US,24,396
OUTLANDER 1000,2019-06-10,10,4,WV,US,14,289
OUTLANDER 850,2019-06-10,3,1,WV,US,4,292
OUTLANDER 450,2019-06-10,13,5,WV,US,18,414
OUTLANDER 1000,2019-06-17,8,1,WV,US,9,298
OUTLANDER 850,2019-06-17,13,12,WV,US,25,317
OUTLANDER 450,2019-06-17,13,6,WV,US,19,433
OUTLANDER 1000,2019-06-24,2,9,WV,US,11,309
OUTLANDER 850,2019-06-24,10,4,WV,US,14,331
OUTLANDER 450,2019-06-24,14,11,WV,US,25,458
OUTLANDER 1000,2019-07-01,4,11,WV,US,15,324
OUTLANDER 850,2019-07-01,11,3,WV,US,14,345
OUTLANDER 450,2019-07-01,8,13,WV,US,21,479
OUTLANDER 1000,2019-07-08,15,10,WV,US,25,349
OUTLANDER 850,2019-07-08,5,2,WV,US,7,352
OUTLANDER 450,2019-07-08,13,8,WV,US,21,500
OUTLANDER 1000,2019-07-15,14,8,WV,US,22,371
OUTLANDER 850,2019-07-15,2,11,WV,US,13,365
OUTLANDER 450,2019-07-15,1,7,WV,US,8,508
OUTLANDER 1000,2019-07-22,4,8,WV,US,12,383
OUTLANDER 850,2019-07-22,11,1,WV,US,12,377
OUTLANDER 450,2019-07-22,8,8,WV,US,16,524
OUTLANDER 1000,2019-07-29,14,12,WV,US,26,409
OUTLANDER 850,2019-07-29,12,9,WV,US,21,398
OUTLANDER 450,2019-07-29,4,5,WV,US,9,533
OUTLANDER 1000,2019-08-05,15,13,WV,US,28,437
OUTLANDER 850,2019-08-05,11,2,WV,US,13,411
OUTLANDER 450,2019-08-05,6,4,WV,US,10,543
OUTLANDER 1000,2019-08-12,10,9,WV,US,19,456
OUTLANDER 850,2019-08-12,7,5,WV,US,12,423
OUTLANDER 450,2019-08-12,12,5,WV,US,17,560
OUTLANDER 1000,2019-08-19,8,3,WV,US,11,467
OUTLANDER 850,2019-08-19,7,0,WV,US,7,430
OUTLANDER 450,2019-08-19,9,13,WV,US,22,582
OUTLANDER 1000,2019-08-26,13,9,WV,US,22,489
OUTLANDER 850,2019-08-26,6,14,WV,US,20,450
OUTLANDER 450,2019-08-26,13,2,WV,US,15,597
OUTLANDER 1000,2019-09-02,3,11,WV,US,14,503
OUTLANDER 850,2019-09-02,3,7,WV,US,10,460
OUTLANDER 450,2019-09-02,10,1,WV,US,11,608
OUTLANDER 1000,2019-09-09,14,12,WV,US,26,529
OUTLANDER 850,2019-09-09,5,2,WV,US,7,467
OUTLANDER 450,2019-09-09,4,9,WV,US,13,621
OUTLANDER 1000,2019-09-16,11,8,WV,US,19,548
OUTLANDER 850,2019-09-16,15,7,WV,US,22,489
OUTLANDER 450,2019-09-16,9,2,WV,US,11,632
OUTLANDER 1000,2019-09-23,13,10,WV,US,23,571
OUTLANDER 850,2019-09-23,2,15,WV,US,17,506
OUTLANDER 450,2019-09-23,6,13,WV,US,19,651
OUTLANDER 1000,2019-09-30,13,1,WV,US,14,585
OUTLANDER 850,2019-09-30,12,6,WV,US,18,524
OUTLANDER 450,2019-09-30,6,8,WV,US,14,665
OUTLANDER 1000,2019-10-07,4,11,WV,US,15,600
OUTLANDER 850,2019-10-07,9,15,WV,US,24,548
OUTLANDER 450,2019-10-07,13,8,WV,US,21,686
OUTLANDER 1000,2019-10-14,8,7,WV,US,15,615
OUTLANDER 850,2019-10-14,8,0,WV,US,8,556
OUTLANDER 450,2019-10-14,6,3,WV,US,9,695
OUTLANDER 1000,2019-10-21,7,13,WV,US,20,635
OUTLANDER 850,2019-10-21,1,14,WV,US,15,571
OUTLANDER 450,2019-10-21,11,4,WV,US,15,710
OUTLANDER 1000,2019-10-28,4,7,WV,US,11,646
OUTLANDER 850,2019-10-28,6,7,WV,US,13,584
OUTLANDER 450,2019-10-28,12,3,WV,US,15,725
OUTLANDER 1000,2019-11-04,14,11,WV,US,25,671
OUTLANDER 850,2019-11-04,13,10,WV,US,23,607
OUTLANDER 450,2019-11-04,11,8,WV,US,19,744
OUTLANDER 1000,2019-11-11,6,2,WV,US,8,679
OUTLANDER 850,2019-11-11,11,9,WV,US,20,627
OUTLANDER 450,2019-11-11,1,12,WV,US,13,757
OUTLANDER 1000,2019-11-18,5,13,WV,US,18,697
OUTLANDER 850,2019-11-18,1,12,WV,US,13,640
OUTLANDER 450,2019-11-18,14,4,WV,US,18,775
OUTLANDER 1000,2019-11-25,15,10,WV,US,25,722
OUTLANDER 850,2019-11-25,1,3,WV,US,4,644
OUTLANDER 450,2019-11-25,10,8,WV,US,18,793
OUTLANDER 1000,2019-12-02,15,8,WV,US,23,745
OUTLANDER 850,2019-12-02,7,9,WV,US,16,660
OUTLANDER 450,2019-12-02,5,1,WV,US,6,799
OUTLANDER 1000,2019-12-09,12,8,WV,US,20,765
OUTLANDER 850,2019-12-09,13,14,WV,US,27,687
OUTLANDER 450,2019-12-09,10,7,WV,US,17,816
OUTLANDER 1000,2019-12-16,5,5,WV,US,10,775
OUTLANDER 850,2019-12-16,5,15,WV,US,20,707
OUTLANDER 450,2019-12-16,3,13,WV,US,16,832
OUTLANDER 1000,2019-12-23,0,8,WV,US,8,783
OUTLANDER 850,2019-12-23,14,7,WV,US,21,728
OUTLANDER 450,2019-12-23,6,10,WV,US,16,848
OUTLANDER 1000,2019-12-30,13,11,WV,US,24,807
OUTLANDER 850,2019-12-30,2,1,WV,US,3,731
OUTLANDER 450,2019-12-30,1,2,WV,US,3,851
OUTLANDER 1000,2020-01-06,8,7,WV,US,15,822
OUTLANDER 850,2020-01-06,12,4,WV,US,16,747
OUTLANDER 450,2020-01-06,6,7,WV,US,13,864
OUTLANDER 1000,2020-01-13,5,0,WV,US,5,827
OUTLANDER 850,2020-01-13,14,13,WV,US,27,774
OUTLANDER 450,2020-01-13,2,11,WV,US,13,877
OUTLANDER 1000,2020-01-20,8,3,WV,US,11,838
OUTLANDER 850,2020-01-20,11,14,WV,US,25,799
OUTLANDER 450,2020-01-20,15,0,WV,US,15,892
OUTLANDER 1000,2020-01-27,8,1,WV,US,9,847
OUTLANDER 850,2020-01-27,10,5,WV,US,15,814
OUTLANDER 450,2020-01-27,4,3,WV,US,7,899
OUTLANDER 1000,2020-02-03,7,0,WV,US,7,854
OUTLANDER 850,2020-02-03,0,5,WV,US,5,819
OUTLANDER 450,2020-02-03,1,7,WV,US,8,907
OUTLANDER 1000,2020-02-10,4,15,WV,US,19,873
OUTLANDER 850,2020-02-10,5,7,WV,US,12,831
OUTLANDER 450,2020-02-10,6,1,WV,US,7,914
OUTLANDER 1000,2020-02-17,3,9,WV,US,12,885
OUTLANDER 850,2020-02-17,6,13,WV,US,19,850
OUTLANDER 450,2020-02-17,7,8,WV,US,15,929
OUTLANDER 1000,2020-02-24,10,8,WV,US,18,903
OUTLANDER 850,2020-02-24,7,6,WV,US,13,863
OUTLANDER 450,2020-02-24,10,5,WV,US,15,944
OUTLANDER 1000,2020-03-02,11,6,WV,US,17,920
OUTLANDER 850,2020-03-02,1,14,WV,US,15,878
OUTLANDER 450,2020-03-02,6,4,WV,US,10,954
OUTLANDER 1000,2020-03-09,13,6,WV,US,19,939
OUTLANDER 850,2020-03-09,4,2,WV,US,6,884
OUTLANDER 450,2020-03-09,13,2,WV,US,15,969
OUTLANDER 1000,2020-03-16,5,13,WV,US,18,957
OUTLANDER 850,2020-03-16,4,3,WV,US,7,891
OUTLANDER 450,2020-03-16,6,7,WV,US,13,982
OUTLANDER 1000,2020-03-23,14,11,WV,US,25,982
OUTLANDER 850,2020-03-23,9,13,WV,US,22,913
OUTLANDER 450,2020-03-23,6,5,WV,US,11,993
OUTLANDER 1000,2020-03-30,9,3,WV,US,12,994
OUTLANDER 850,2020-03-30,9,15,WV,US,24,937
OUTLANDER 450,2020-03-30,9,4,WV,US,13,1006
OUTLANDER 1000,2020-04-06,14,3,WV,US,17,1011
OUTLANDER 850,2020-04-06,13,11,WV,US,24,961
OUTLANDER 450,2020-04-06,10,6,WV,US,16,1022
OUTLANDER 1000,2020-04-13,7,3,WV,US,10,1021
OUTLANDER 850,2020-04-13,6,5,WV,US,11,972
OUTLANDER 450,2020-04-13,3,4,WV,US,7,1029
OUTLANDER 1000,2020-04-20,7,9,WV,US,16,1037
OUTLANDER 850,2020-04-20,11,10,WV,US,21,993
OUTLANDER 450,2020-04-20,11,5,WV,US,16,1045
OUTLANDER 1000,2020-04-27,4,14,WV,US,18,1055
OUTLANDER 850,2020-04-27,9,12,WV,US,21,1014
OUTLANDER 450,2020-04-27,0,8,WV,US,8,1053
OUTLANDER 1000,2020-05-04,7,5,WV,US,12,1067
OUTLANDER 850,2020-05-04,3,12,WV,US,15,1029
OUTLANDER 450,2020-05-04,0,10,WV,US,10,1063
OUTLANDER 1000,2020-05-11,1,2,WV,US,3,1070
OUTLANDER 850,2020-05-11,11,14,WV,US,25,1054
OUTLANDER 450,2020-05-11,12,1,WV,US,13,1076
OUTLANDER 1000,2020-05-18,6,8,WV,US,14,1084
OUTLANDER 850,2020-05-18,10,3,WV,US,13,1067
OUTLANDER 450,2020-05-18,9,3,WV,US,12,1088
OUTLANDER 1000,2020-05-25,4,12,WV,US,16,1100
OUTLANDER 850,2020-05-25,7,3,WV,US,10,1077
OUTLANDER 450,2020-05-25,9,8,WV,US,17,1105
OUTLANDER 1000,2020-06-01,9,15,WV,US,24,1124
OUTLANDER 850,2020-06-01,1,12,WV,US,13,1090
OUTLANDER 450,2020-06-01,1,7,WV,US,8,1113
OUTLANDER 1000,2020-06-08,12,10,WV,US,22,1146
OUTLANDER 850,2020-06-08,8,8,WV,US,16,1106
OUTLANDER 450,2020-06-08,1,3,WV,US,4,1117
OUTLANDER 1000,2020-06-15,8,3,WV,US,11,1157
OUTLANDER 850,2020-06-15,2,4,WV,US,6,1112
OUTLANDER 450,2020-06-15,5,13,WV,US,18,1135
OUTLANDER 1000,2020-06-22,4,9,WV,US,13,1170
OUTLANDER 850,2020-06-22,9,11,WV,US,20,1132
OUTLANDER 450,2020-06-22,13,4,WV,US,17,1152
OUTLANDER 1000,2020-06-29,1,14,WV,US,15,1185
OUTLANDER 850,2020-06-29,0,6,WV,US,6,1138
OUTLANDER 450,2020-06-29,1,8,WV,US,9,1161
OUTLANDER 1000,2020-07-06,11,7,WV,US,18,1203
OUTLANDER 850,2020-07-06,10,8,WV,US,18,1156
OUTLANDER 450,2020-07-06,9,6,WV,US,15,1176
OUTLANDER 1000,2020-07-13,5,6,WV,US,11,1214
OUTLANDER 850,2020-07-13,2,8,WV,US,10,1166
OUTLANDER 450,2020-07-13,11,15,WV,US,26,1202
OUTLANDER 1000,2020-07-20,8,6,WV,US,14,1228
OUTLANDER 850,2020-07-20,3,12,WV,US,15,1181
OUTLANDER 450,2020-07-20,5,3,WV,US,8,1210
OUTLANDER 1000,2020-07-27,2,9,WV,US,11,1239
OUTLANDER 850,2020-07-27,9,14,WV,US,23,1204
OUTLANDER 450,2020-07-27,9,0,WV,US,9,1219
OUTLANDER 1000,2020-08-03,3,3,WV,US,6,1245
OUTLANDER 850,2020-08-03,5,4,WV,US,9,1213
OUTLANDER 450,2020-08-03,11,8,WV,US,19,1238
OUTLANDER 1000,2020-08-10,7,3,WV,US,10,1255
OUTLANDER 850,2020-08-10,1,0,WV,US,1,1214
OUTLANDER 450,2020-08-10,6,8,WV,US,14,1252
OUTLANDER 1000,2020-08-17,9,14,WV,US,23,1278
OUTLANDER 850,2020-08-17,0,10,WV,US,10,1224
OUTLANDER 450,2020-08-17,9,4,WV,US,13,1265
OUTLANDER 1000,2020-08-24,12,11,WV,US,23,1301
OUTLANDER 850,2020-08-24,1,8,WV,US,9,1233
OUTLANDER 450,2020-08-24,8,9,WV,US,17,1282
OUTLANDER 1000,2020-08-31,9,6,WV,US,15,1316
OUTLANDER 850,2020-08-31,8,7,WV,US,15,1248
OUTLANDER 450,2020-08-31,5,14,WV,US,19,1301
OUTLANDER 1000,2020-09-07,5,8,WV,US,13,1329
OUTLANDER 850,2020-09-07,14,14,WV,US,28,1276
OUTLANDER 450,2020-09-07,4,9,WV,US,13,1314
OUTLANDER 1000,2020-09-14,4,9,WV,US,13,1342
OUTLANDER 850,2020-09-14,13,9,WV,US,22,1298
OUTLANDER 450,2020-09-14,8,12,WV,US,20,1334
OUTLANDER 1000,2020-09-21,11,12,WV,US,23,1365
OUTLANDER 850,2020-09-21,2,4,WV,US,6,1304
OUTLANDER 450,2020-09-21,5,10,WV,US,15,1349
OUTLANDER 1000,2020-09-28,6,14,WV,US,20,1385
OUTLANDER 850,2020-09-28,1,5,WV,US,6,1310
OUTLANDER 450,2020-09-28,5,12,WV,US,17,1366
OUTLANDER 1000,2020-10-05,7,15,WV,US,22,1407
OUTLANDER 850,2020-10-05,10,2,WV,US,12,1322
OUTLANDER 450,2020-10-05,6,11,WV,US,17,1383
OUTLANDER 1000,2020-10-12,2,7,WV,US,9,1416
OUTLANDER 850,2020-10-12,13,3,WV,US,16,1338
OUTLANDER 450,2020-10-12,11,10,WV,US,21,1404
OUTLANDER 1000,2020-10-19,3,8,WV,US,11,1427
OUTLANDER 850,2020-10-19,6,4,WV,US,10,1348
OUTLANDER 450,2020-10-19,2,3,WV,US,5,1409
OUTLANDER 1000,2020-10-26,9,4,WV,US,13,1440
OUTLANDER 850,2020-10-26,10,1,WV,US,11,1359
OUTLANDER 450,2020-10-26,8,13,WV,US,21,1430
OUTLANDER 1000,2020-11-02,11,2,WV,US,13,1453
OUTLANDER 850,2020-11-02,12,9,WV,US,21,1380
OUTLANDER 450,2020-11-02,4,15,WV,US,19,1449
OUTLANDER 1000,2020-11-09,14,13,WV,US,27,1480
OUTLANDER 850,2020-11-09,7,11,WV,US,18,1398
OUTLANDER 450,2020-11-09,14,2,WV,US,16,1465
OUTLANDER 1000,2020-11-16,3,5,WV,US,8,1488
OUTLANDER 850,2020-11-16,5,10,WV,US,15,1413
OUTLANDER 450,2020-11-16,2,9,WV,US,11,1476
OUTLANDER 1000,2020-11-23,5,4,WV,US,9,1497
OUTLANDER 850,2020-11-23,13,5,WV,US,18,1431
OUTLANDER 450,2020-11-23,7,8,WV,US,15,1491
OUTLANDER 1000,2020-11-30,14,12,WV,US,26,1523
OUTLANDER 850,2020-11-30,10,4,WV,US,14,1445
OUTLANDER 450,2020-11-30,3,12,WV,US,15,1506
OUTLANDER 1000,2020-12-07,6,2,WV,US,8,1531
OUTLANDER 850,2020-12-07,11,12,WV,US,23,1468
OUTLANDER 450,2020-12-07,1,15,WV,US,16,1522
OUTLANDER 1000,2020-12-14,13,11,WV,US,24,1555
OUTLANDER 850,2020-12-14,2,4,WV,US,6,1474
OUTLANDER 450,2020-12-14,14,4,WV,US,18,1540
OUTLANDER 1000,2020-12-21,10,12,WV,US,22,1577
OUTLANDER 850,2020-12-21,1,9,WV,US,10,1484
OUTLANDER 450,2020-12-21,1,9,WV,US,10,1550
OUTLANDER 1000,2020-12-28,13,9,WV,US,22,1599
OUTLANDER 850,2020-12-28,10,13,WV,US,23,1507
OUTLANDER 450,2020-12-28,2,11,WV,US,13,1563
OUTLANDER 1000,2021-01-04,13,4,WV,US,17,1616
OUTLANDER 850,2021-01-04,13,7,WV,US,20,1527
OUTLANDER 450,2021-01-04,11,11,WV,US,22,1585
OUTLANDER 1000,2021-01-11,10,14,WV,US,24,1640
OUTLANDER 850,2021-01-11,2,5,WV,US,7,1534
OUTLANDER 450,2021-01-11,9,4,WV,US,13,1598
OUTLANDER 1000,2021-01-18,9,12,WV,US,21,1661
OUTLANDER 850,2021-01-18,8,2,WV,US,10,1544
OUTLANDER 450,2021-01-18,1,6,WV,US,7,1605
OUTLANDER 1000,2021-01-25,8,6,WV,US,14,1675
OUTLANDER 850,2021-01-25,15,10,WV,US,25,1569
OUTLANDER 450,2021-01-25,12,15,WV,US,27,1632
OUTLANDER 1000,2021-02-01,12,1,WV,US,13,1688
OUTLANDER 850,2021-02-01,3,8,WV,US,11,1580
OUTLANDER 450,2021-02-01,14,13,WV,US,27,1659
OUTLANDER 1000,2021-02-08,8,5,WV,US,13,1701
OUTLANDER 850,2021-02-08,9,0,WV,US,9,1589
OUTLANDER 450,2021-02-08,7,6,WV,US,13,1672
OUTLANDER 1000,2021-02-15,4,15,WV,US,19,1720
OUTLANDER 850,2021-02-15,5,3,WV,US,8,1597
OUTLANDER 450,2021-02-15,8,3,WV,US,11,1683
OUTLANDER 1000,2021-02-22,10,10,WV,US,20,1740
OUTLANDER 850,2021-02-22,3,14,WV,US,17,1614
OUTLANDER 450,2021-02-22,6,10,WV,US,16,1699
OUTLANDER 1000,2021-03-01,12,13,WV,US,25,1765
OUTLANDER 850,2021-03-01,6,12,WV,US,18,1632
OUTLANDER 450,2021-03-01,1,14,WV,US,15,1714
OUTLANDER 1000,2021-03-08,13,0,WV,US,13,1778
OUTLANDER 850,2021-03-08,6,10,WV,US,16,1648
OUTLANDER 450,2021-03-08,4,14,WV,US,18,1732
OUTLANDER 1000,2021-03-15,5,8,WV,US,13,1791
OUTLANDER 850,2021-03-15,1,12,WV,US,13,1661
OUTLANDER 450,2021-03-15,2,13,WV,US,15,1747
OUTLANDER 1000,2021-03-22,15,10,WV,US,25,1816
OUTLANDER 850,2021-03-22,9,1,WV,US,10,1671
OUTLANDER 450,2021-03-22,6,6,WV,US,12,1759
OUTLANDER 1000,2021-03-29,2,15,WV,US,17,1833
OUTLANDER 850,2021-03-29,3,10,WV,US,13,1684
OUTLANDER 450,2021-03-29,11,11,WV,US,22,1781
OUTLANDER 1000,2021-04-05,9,8,WV,US,17,1850
OUTLANDER 850,2021-04-05,5,4,WV,US,9,1693
OUTLANDER 450,2021-04-05,5,12,WV,US,17,1798
OUTLANDER 1000,2021-04-12,3,13,WV,US,16,1866
OUTLANDER 850,2021-04-12,3,6,WV,US,9,1702
OUTLANDER 450,2021-04-12,15,3,WV,US,18,1816
OUTLANDER 1000,2021-04-19,4,11,WV,US,15,1881
OUTLANDER 850,2021-04-19,10,5,WV,US,15,1717
OUTLANDER 450,2021-04-19,2,12,WV,US,14,1830
OUTLANDER 1000,2021-04-26,1,4,WV,US,5,1886
OUTLANDER 850,2021-04-26,13,13,WV,US,26,1743
OUTLANDER 450,2021-04-26,13,1,WV,US,14,1844
OUTLANDER 1000,2021-05-03,10,6,WV,US,16,1902
OUTLANDER 850,2021-05-03,13,7,WV,US,20,1763
OUTLANDER 450,2021-05-03,3,13,WV,US,16,1860
OUTLANDER 1000,2021-05-10,2,2,WV,US,4,1906
OUTLANDER 850,2021-05-10,5,12,WV,US,17,1780
OUTLANDER 450,2021-05-10,6,1,WV,US,7,1867
OUTLANDER 1000,2021-05-17,6,12,WV,US,18,1924
OUTLANDER 850,2021-05-17,10,10,WV,US,20,1800
OUTLANDER 450,2021-05-17,15,15,WV,US,30,1897
OUTLANDER 1000,2021-05-24,9,9,WV,US,18,1942
OUTLANDER 850,2021-05-24,6,7,WV,US,13,1813
OUTLANDER 450,2021-05-24,15,12,WV,US,27,1924
OUTLANDER 1000,2021-05-31,7,4,WV,US,11,1953
OUTLANDER 850,2021-05-31,14,13,WV,US,27,1840
OUTLANDER 450,2021-05-31,9,11,WV,US,20,1944
OUTLANDER 1000,2021-06-07,6,8,WV,US,14,1967
OUTLANDER 850,2021-06-07,5,1,WV,US,6,1846
OUTLANDER 450,2021-06-07,15,10,WV,US,25,1969
OUTLANDER 1000,2021-06-14,11,0,WV,US,11,1978
OUTLANDER 850,2021-06-14,1,6,WV,US,7,1853
OUTLANDER 450,2021-06-14,2,5,WV,US,7,1976
OUTLANDER 1000,2021-06-21,10,15,WV,US,25,2003
OUTLANDER 850,2021-06-21,9,8,WV,US,17,1870
OUTLANDER 450,2021-06-21,1,8,WV,US,9,1985
OUTLANDER 1000,2021-06-28,10,12,WV,US,22,2025
OUTLANDER 850,2021-06-28,9,15,WV,US,24,1894
OUTLANDER 450,2021-06-28,4,6,WV,US,10,1995
OUTLANDER 1000,2021-07-05,8,13,WV,US,21,2046
OUTLANDER 850,2021-07-05,7,1,WV,US,8,1902
OUTLANDER 450,2021-07-05,4,7,WV,US,11,2006
OUTLANDER 1000,2021-07-12,6,9,WV,US,15,2061
OUTLANDER 850,2021-07-12,13,13,WV,US,26,1928
OUTLANDER 450,2021-07-12,11,15,WV,US,26,2032
OUTLANDER 1000,2021-07-19,7,1,WV,US,8,2069
OUTLANDER 850,2021-07-19,0,2,WV,US,2,1930
OUTLANDER 450,2021-07-19,1,12,WV,US,13,2045
OUTLANDER 1000,2021-07-26,7,7,WV,US,14,2083
OUTLANDER 850,2021-07-26,5,4,WV,US,9,1939
OUTLANDER 450,2021-07-26,14,10,WV,US,24,2069
OUTLANDER 1000,2021-08-02,9,9,WV,US,18,2101
OUTLANDER 850,2021-08-02,9,7,WV,US,16,1955
OUTLANDER 450,2021-08-02,14,6,WV,US,20,2089
OUTLANDER 1000,2021-08-09,0,6,WV,US,6,2107
OUTLANDER 850,2021-08-09,0,12,WV,US,12,1967
OUTLANDER 450,2021-08-09,7,0,WV,US,7,2096
OUTLANDER 1000,2021-08-16,2,7,WV,US,9,2116
OUTLANDER 850,2021-08-16,14,1,WV,US,15,1982
OUTLANDER 450,2021-08-16,7,9,WV,US,16,2112
OUTLANDER 1000,2021-08-23,12,4,WV,US,16,2132
OUTLANDER 850,2021-08-23,15,2,WV,US,17,1999
OUTLANDER 450,2021-08-23,5,12,WV,US,17,2129
OUTLANDER 1000,2021-08-30,3,9,WV,US,12,2144
OUTLANDER 850,2021-08-30,6,10,WV,US,16,2015
OUTLANDER 450,2021-08-30,3,3,WV,US,6,2135
OUTLANDER 1000,2021-09-06,6,13,WV,US,19,2163
OUTLANDER 850,2021-09-06,5,13,WV,US,18,2033
OUTLANDER 450,2021-09-06,4,8,WV,US,12,2147
OUTLANDER 1000,2021-09-13,0,13,WV,US,13,2176
OUTLANDER 850,2021-09-13,4,1,WV,US,5,2038
OUTLANDER 450,2021-09-13,6,9,WV,US,15,2162
OUTLANDER 1000,2021-09-20,6,10,WV,US,16,2192
OUTLANDER 850,2021-09-20,7,3,WV,US,10,2048
OUTLANDER 450,2021-09-20,12,12,WV,US,24,2186
OUTLANDER 1000,2021-09-27,15,8,WV,US,23,2215
OUTLANDER 850,2021-09-27,6,13,WV,US,19,2067
OUTLANDER 450,2021-09-27,7,14,WV,US,21,2207
OUTLANDER 1000,2021-10-04,2,9,WV,US,11,2226
OUTLANDER 850,2021-10-04,9,6,WV,US,15,2082
OUTLANDER 450,2021-10-04,15,1,WV,US,16,2223
OUTLANDER 1000,2021-10-11,5,5,WV,US,10,2236
OUTLANDER 850,2021-10-11,9,5,WV,US,14,2096
OUTLANDER 450,2021-10-11,12,14,WV,US,26,2249
OUTLANDER 1000,2021-10-18,10,13,WV,US,23,2259
OUTLANDER 850,2021-10-18,6,11,WV,US,17,2113
OUTLANDER 450,2021-10-18,9,13,WV,US,22,2271
OUTLANDER 1000,2021-10-25,7,8,WV,US,15,2274
OUTLANDER 850,2021-10-25,11,13,WV,US,24,2137
OUTLANDER 450,2021-10-25,10,9,WV,US,19,2290
OUTLANDER 1000,2021-11-01,9,11,WV,US,20,2294
OUTLANDER 850,2021-11-01,12,14,WV,US,26,2163
OUTLANDER 450,2021-11-01,11,13,WV,US,24,2314
OUTLANDER 1000,2021-11-08,3,11,WV,US,14,2308
OUTLANDER 850,2021-11-08,3,3,WV,US,6,2169
OUTLANDER 450,2021-11-08,12,15,WV,US,27,2341
OUTLANDER 1000,2021-11-15,4,12,WV,US,16,2324
OUTLANDER 850,2021-11-15,11,2,WV,US,13,2182
OUTLANDER 450,2021-11-15,5,3,WV,US,8,2349
OUTLANDER 1000,2021-11-22,4,5,WV,US,9,2333
OUTLANDER 850,2021-11-22,4,9,WV,US,13,2195
OUTLANDER 450,2021-11-22,6,5,WV,US,11,2360
OUTLANDER 1000,2021-11-29,12,14,WV,US,26,2359
OUTLANDER 850,2021-11-29,8,5,WV,US,13,2208
OUTLANDER 450,2021-11-29,12,3,WV,US,15,2375
OUTLANDER 1000,2021-12-06,10,7,WV,US,17,2376
OUTLANDER 850,2021-12-06,10,4,WV,US,14,2222
OUTLANDER 450,2021-12-06,8,14,WV,US,22,2397
OUTLANDER 1000,2021-12-13,8,7,WV,US,15,2391
OUTLANDER 850,2021-12-13,3,7,WV,US,10,2232
OUTLANDER 450,2021-12-13,9,10,WV,US,19,2416
OUTLANDER 1000,2021-12-20,6,10,WV,US,16,2407
OUTLANDER 850,2021-12-20,6,3,WV,US,9,2241
OUTLANDER 450,2021-12-20,14,0,WV,US,14,2430
OUTLANDER 1000,2021-12-27,3,11,WV,US,14,2421
OUTLANDER 850,2021-12-27,4,14,WV,US,18,2259
OUTLANDER 450,2021-12-27,7,2,WV,US,9,2439
OUTLANDER 1000,2019-01-07,3,5,WI,US,8,8
OUTLANDER 850,2019-01-07,0,10,WI,US,10,10
OUTLANDER 450,2019-01-07,10,13,WI,US,23,23
OUTLANDER 1000,2019-01-14,8,9,WI,US,17,25
OUTLANDER 850,2019-01-14,9,7,WI,US,16,26
OUTLANDER 450,2019-01-14,0,10,WI,US,10,33
OUTLANDER 1000,2019-01-21,2,12,WI,US,14,39
OUTLANDER 850,2019-01-21,8,15,WI,US,23,49
OUTLANDER 450,2019-01-21,4,3,WI,US,7,40
OUTLANDER 1000,2019-01-28,3,4,WI,US,7,46
OUTLANDER 850,2019-01-28,8,12,WI,US,20,69
OUTLANDER 450,2019-01-28,2,1,WI,US,3,43
OUTLANDER 1000,2019-02-04,14,2,WI,US,16,62
OUTLANDER 850,2019-02-04,7,1,WI,US,8,77
OUTLANDER 450,2019-02-04,7,8,WI,US,15,58
OUTLANDER 1000,2019-02-11,8,8,WI,US,16,78
OUTLANDER 850,2019-02-11,3,1,WI,US,4,81
OUTLANDER 450,2019-02-11,1,11,WI,US,12,70
OUTLANDER 1000,2019-02-18,9,11,WI,US,20,98
OUTLANDER 850,2019-02-18,11,8,WI,US,19,100
OUTLANDER 450,2019-02-18,3,13,WI,US,16,86
OUTLANDER 1000,2019-02-25,10,14,WI,US,24,122
OUTLANDER 850,2019-02-25,11,12,WI,US,23,123
OUTLANDER 450,2019-02-25,7,13,WI,US,20,106
OUTLANDER 1000,2019-03-04,0,12,WI,US,12,134
OUTLANDER 850,2019-03-04,2,13,WI,US,15,138
OUTLANDER 450,2019-03-04,6,5,WI,US,11,117
OUTLANDER 1000,2019-03-11,13,4,WI,US,17,151
OUTLANDER 850,2019-03-11,14,5,WI,US,19,157
OUTLANDER 450,2019-03-11,7,6,WI,US,13,130
OUTLANDER 1000,2019-03-18,9,6,WI,US,15,166
OUTLANDER 850,2019-03-18,7,3,WI,US,10,167
OUTLANDER 450,2019-03-18,14,4,WI,US,18,148
OUTLANDER 1000,2019-03-25,12,7,WI,US,19,185
OUTLANDER 850,2019-03-25,0,11,WI,US,11,178
OUTLANDER 450,2019-03-25,5,6,WI,US,11,159
OUTLANDER 1000,2019-04-01,1,3,WI,US,4,189
OUTLANDER 850,2019-04-01,3,10,WI,US,13,191
OUTLANDER 450,2019-04-01,8,8,WI,US,16,175
OUTLANDER 1000,2019-04-08,10,7,WI,US,17,206
OUTLANDER 850,2019-04-08,8,13,WI,US,21,212
OUTLANDER 450,2019-04-08,6,7,WI,US,13,188
OUTLANDER 1000,2019-04-15,8,14,WI,US,22,228
OUTLANDER 850,2019-04-15,12,4,WI,US,16,228
OUTLANDER 450,2019-04-15,14,9,WI,US,23,211
OUTLANDER 1000,2019-04-22,4,7,WI,US,11,239
OUTLANDER 850,2019-04-22,3,2,WI,US,5,233
OUTLANDER 450,2019-04-22,0,0,WI,US,0,211
OUTLANDER 1000,2019-04-29,5,4,WI,US,9,248
OUTLANDER 850,2019-04-29,9,14,WI,US,23,256
OUTLANDER 450,2019-04-29,13,7,WI,US,20,231
OUTLANDER 1000,2019-05-06,14,12,WI,US,26,274
OUTLANDER 850,2019-05-06,14,7,WI,US,21,277
OUTLANDER 450,2019-05-06,10,6,WI,US,16,247
OUTLANDER 1000,2019-05-13,6,3,WI,US,9,283
OUTLANDER 850,2019-05-13,6,9,WI,US,15,292
OUTLANDER 450,2019-05-13,13,7,WI,US,20,267
OUTLANDER 1000,2019-05-20,7,3,WI,US,10,293
OUTLANDER 850,2019-05-20,8,15,WI,US,23,315
OUTLANDER 450,2019-05-20,4,8,WI,US,12,279
OUTLANDER 1000,2019-05-27,9,5,WI,US,14,307
OUTLANDER 850,2019-05-27,6,4,WI,US,10,325
OUTLANDER 450,2019-05-27,12,14,WI,US,26,305
OUTLANDER 1000,2019-06-03,11,5,WI,US,16,323
OUTLANDER 850,2019-06-03,3,12,WI,US,15,340
OUTLANDER 450,2019-06-03,6,9,WI,US,15,320
OUTLANDER 1000,2019-06-10,7,11,WI,US,18,341
OUTLANDER 850,2019-06-10,11,13,WI,US,24,364
OUTLANDER 450,2019-06-10,5,7,WI,US,12,332
OUTLANDER 1000,2019-06-17,9,10,WI,US,19,360
OUTLANDER 850,2019-06-17,1,6,WI,US,7,371
OUTLANDER 450,2019-06-17,13,7,WI,US,20,352
OUTLANDER 1000,2019-06-24,10,7,WI,US,17,377
OUTLANDER 850,2019-06-24,7,5,WI,US,12,383
OUTLANDER 450,2019-06-24,3,8,WI,US,11,363
OUTLANDER 1000,2019-07-01,15,2,WI,US,17,394
OUTLANDER 850,2019-07-01,12,2,WI,US,14,397
OUTLANDER 450,2019-07-01,5,14,WI,US,19,382
OUTLANDER 1000,2019-07-08,6,8,WI,US,14,408
OUTLANDER 850,2019-07-08,1,4,WI,US,5,402
OUTLANDER 450,2019-07-08,14,10,WI,US,24,406
OUTLANDER 1000,2019-07-15,7,1,WI,US,8,416
OUTLANDER 850,2019-07-15,1,4,WI,US,5,407
OUTLANDER 450,2019-07-15,2,9,WI,US,11,417
OUTLANDER 1000,2019-07-22,2,6,WI,US,8,424
OUTLANDER 850,2019-07-22,5,8,WI,US,13,420
OUTLANDER 450,2019-07-22,2,3,WI,US,5,422
OUTLANDER 1000,2019-07-29,10,0,WI,US,10,434
OUTLANDER 850,2019-07-29,13,2,WI,US,15,435
OUTLANDER 450,2019-07-29,4,14,WI,US,18,440
OUTLANDER 1000,2019-08-05,12,12,WI,US,24,458
OUTLANDER 850,2019-08-05,2,15,WI,US,17,452
OUTLANDER 450,2019-08-05,12,13,WI,US,25,465
OUTLANDER 1000,2019-08-12,14,1,WI,US,15,473
OUTLANDER 850,2019-08-12,11,3,WI,US,14,466
OUTLANDER 450,2019-08-12,12,8,WI,US,20,485
OUTLANDER 1000,2019-08-19,1,9,WI,US,10,483
OUTLANDER 850,2019-08-19,10,9,WI,US,19,485
OUTLANDER 450,2019-08-19,15,9,WI,US,24,509
OUTLANDER 1000,2019-08-26,6,3,WI,US,9,492
OUTLANDER 850,2019-08-26,9,12,WI,US,21,506
OUTLANDER 450,2019-08-26,8,7,WI,US,15,524
OUTLANDER 1000,2019-09-02,8,6,WI,US,14,506
OUTLANDER 850,2019-09-02,10,10,WI,US,20,526
OUTLANDER 450,2019-09-02,14,3,WI,US,17,541
OUTLANDER 1000,2019-09-09,11,10,WI,US,21,527
OUTLANDER 850,2019-09-09,14,12,WI,US,26,552
OUTLANDER 450,2019-09-09,7,15,WI,US,22,563
OUTLANDER 1000,2019-09-16,12,7,WI,US,19,546
OUTLANDER 850,2019-09-16,12,8,WI,US,20,572
OUTLANDER 450,2019-09-16,14,1,WI,US,15,578
OUTLANDER 1000,2019-09-23,0,2,WI,US,2,548
OUTLANDER 850,2019-09-23,11,4,WI,US,15,587
OUTLANDER 450,2019-09-23,5,9,WI,US,14,592
OUTLANDER 1000,2019-09-30,9,8,WI,US,17,565
OUTLANDER 850,2019-09-30,14,0,WI,US,14,601
OUTLANDER 450,2019-09-30,6,7,WI,US,13,605
OUTLANDER 1000,2019-10-07,0,5,WI,US,5,570
OUTLANDER 850,2019-10-07,10,4,WI,US,14,615
OUTLANDER 450,2019-10-07,1,10,WI,US,11,616
OUTLANDER 1000,2019-10-14,13,9,WI,US,22,592
OUTLANDER 850,2019-10-14,2,3,WI,US,5,620
OUTLANDER 450,2019-10-14,3,9,WI,US,12,628
OUTLANDER 1000,2019-10-21,7,2,WI,US,9,601
OUTLANDER 850,2019-10-21,12,0,WI,US,12,632
OUTLANDER 450,2019-10-21,2,10,WI,US,12,640
OUTLANDER 1000,2019-10-28,2,11,WI,US,13,614
OUTLANDER 850,2019-10-28,5,7,WI,US,12,644
OUTLANDER 450,2019-10-28,1,13,WI,US,14,654
OUTLANDER 1000,2019-11-04,7,11,WI,US,18,632
OUTLANDER 850,2019-11-04,14,14,WI,US,28,672
OUTLANDER 450,2019-11-04,4,0,WI,US,4,658
OUTLANDER 1000,2019-11-11,3,7,WI,US,10,642
OUTLANDER 850,2019-11-11,10,2,WI,US,12,684
OUTLANDER 450,2019-11-11,12,10,WI,US,22,680
OUTLANDER 1000,2019-11-18,12,6,WI,US,18,660
OUTLANDER 850,2019-11-18,10,13,WI,US,23,707
OUTLANDER 450,2019-11-18,9,14,WI,US,23,703
OUTLANDER 1000,2019-11-25,10,5,WI,US,15,675
OUTLANDER 850,2019-11-25,7,12,WI,US,19,726
OUTLANDER 450,2019-11-25,10,14,WI,US,24,727
OUTLANDER 1000,2019-12-02,14,12,WI,US,26,701
OUTLANDER 850,2019-12-02,13,0,WI,US,13,739
OUTLANDER 450,2019-12-02,15,7,WI,US,22,749
OUTLANDER 1000,2019-12-09,14,6,WI,US,20,721
OUTLANDER 850,2019-12-09,4,9,WI,US,13,752
OUTLANDER 450,2019-12-09,1,5,WI,US,6,755
OUTLANDER 1000,2019-12-16,13,0,WI,US,13,734
OUTLANDER 850,2019-12-16,6,11,WI,US,17,769
OUTLANDER 450,2019-12-16,1,2,WI,US,3,758
OUTLANDER 1000,2019-12-23,14,7,WI,US,21,755
OUTLANDER 850,2019-12-23,3,13,WI,US,16,785
OUTLANDER 450,2019-12-23,14,12,WI,US,26,784
OUTLANDER 1000,2019-12-30,5,7,WI,US,12,767
OUTLANDER 850,2019-12-30,6,14,WI,US,20,805
OUTLANDER 450,2019-12-30,3,12,WI,US,15,799
OUTLANDER 1000,2020-01-06,13,10,WI,US,23,790
OUTLANDER 850,2020-01-06,8,4,WI,US,12,817
OUTLANDER 450,2020-01-06,9,10,WI,US,19,818
OUTLANDER 1000,2020-01-13,2,7,WI,US,9,799
OUTLANDER 850,2020-01-13,10,1,WI,US,11,828
OUTLANDER 450,2020-01-13,15,2,WI,US,17,835
OUTLANDER 1000,2020-01-20,6,7,WI,US,13,812
OUTLANDER 850,2020-01-20,10,3,WI,US,13,841
OUTLANDER 450,2020-01-20,2,1,WI,US,3,838
OUTLANDER 1000,2020-01-27,8,10,WI,US,18,830
OUTLANDER 850,2020-01-27,11,14,WI,US,25,866
OUTLANDER 450,2020-01-27,2,14,WI,US,16,854
OUTLANDER 1000,2020-02-03,2,12,WI,US,14,844
OUTLANDER 850,2020-02-03,8,12,WI,US,20,886
OUTLANDER 450,2020-02-03,1,12,WI,US,13,867
OUTLANDER 1000,2020-02-10,7,9,WI,US,16,860
OUTLANDER 850,2020-02-10,0,6,WI,US,6,892
OUTLANDER 450,2020-02-10,5,15,WI,US,20,887
OUTLANDER 1000,2020-02-17,6,6,WI,US,12,872
OUTLANDER 850,2020-02-17,10,6,WI,US,16,908
OUTLANDER 450,2020-02-17,13,14,WI,US,27,914
OUTLANDER 1000,2020-02-24,9,6,WI,US,15,887
OUTLANDER 850,2020-02-24,12,15,WI,US,27,935
OUTLANDER 450,2020-02-24,3,1,WI,US,4,918
OUTLANDER 1000,2020-03-02,7,9,WI,US,16,903
OUTLANDER 850,2020-03-02,4,12,WI,US,16,951
OUTLANDER 450,2020-03-02,4,4,WI,US,8,926
OUTLANDER 1000,2020-03-09,2,8,WI,US,10,913
OUTLANDER 850,2020-03-09,2,15,WI,US,17,968
OUTLANDER 450,2020-03-09,14,5,WI,US,19,945
OUTLANDER 1000,2020-03-16,14,1,WI,US,15,928
OUTLANDER 850,2020-03-16,8,13,WI,US,21,989
OUTLANDER 450,2020-03-16,1,3,WI,US,4,949
OUTLANDER 1000,2020-03-23,0,1,WI,US,1,929
OUTLANDER 850,2020-03-23,14,2,WI,US,16,1005
OUTLANDER 450,2020-03-23,8,15,WI,US,23,972
OUTLANDER 1000,2020-03-30,8,11,WI,US,19,948
OUTLANDER 850,2020-03-30,1,9,WI,US,10,1015
OUTLANDER 450,2020-03-30,3,14,WI,US,17,989
OUTLANDER 1000,2020-04-06,7,12,WI,US,19,967
OUTLANDER 850,2020-04-06,11,11,WI,US,22,1037
OUTLANDER 450,2020-04-06,10,12,WI,US,22,1011
OUTLANDER 1000,2020-04-13,0,12,WI,US,12,979
OUTLANDER 850,2020-04-13,11,11,WI,US,22,1059
OUTLANDER 450,2020-04-13,9,8,WI,US,17,1028
OUTLANDER 1000,2020-04-20,1,14,WI,US,15,994
OUTLANDER 850,2020-04-20,12,5,WI,US,17,1076
OUTLANDER 450,2020-04-20,4,7,WI,US,11,1039
OUTLANDER 1000,2020-04-27,12,6,WI,US,18,1012
OUTLANDER 850,2020-04-27,8,7,WI,US,15,1091
OUTLANDER 450,2020-04-27,13,13,WI,US,26,1065
OUTLANDER 1000,2020-05-04,3,5,WI,US,8,1020
OUTLANDER 850,2020-05-04,5,4,WI,US,9,1100
OUTLANDER 450,2020-05-04,7,8,WI,US,15,1080
OUTLANDER 1000,2020-05-11,8,4,WI,US,12,1032
OUTLANDER 850,2020-05-11,3,3,WI,US,6,1106
OUTLANDER 450,2020-05-11,14,7,WI,US,21,1101
OUTLANDER 1000,2020-05-18,13,10,WI,US,23,1055
OUTLANDER 850,2020-05-18,15,12,WI,US,27,1133
OUTLANDER 450,2020-05-18,8,2,WI,US,10,1111
OUTLANDER 1000,2020-05-25,12,4,WI,US,16,1071
OUTLANDER 850,2020-05-25,4,5,WI,US,9,1142
OUTLANDER 450,2020-05-25,11,5,WI,US,16,1127
OUTLANDER 1000,2020-06-01,8,2,WI,US,10,1081
OUTLANDER 850,2020-06-01,13,10,WI,US,23,1165
OUTLANDER 450,2020-06-01,9,7,WI,US,16,1143
OUTLANDER 1000,2020-06-08,7,6,WI,US,13,1094
OUTLANDER 850,2020-06-08,4,7,WI,US,11,1176
OUTLANDER 450,2020-06-08,8,9,WI,US,17,1160
OUTLANDER 1000,2020-06-15,1,9,WI,US,10,1104
OUTLANDER 850,2020-06-15,10,1,WI,US,11,1187
OUTLANDER 450,2020-06-15,3,12,WI,US,15,1175
OUTLANDER 1000,2020-06-22,10,8,WI,US,18,1122
OUTLANDER 850,2020-06-22,8,6,WI,US,14,1201
OUTLANDER 450,2020-06-22,11,11,WI,US,22,1197
OUTLANDER 1000,2020-06-29,12,4,WI,US,16,1138
OUTLANDER 850,2020-06-29,4,7,WI,US,11,1212
OUTLANDER 450,2020-06-29,2,15,WI,US,17,1214
OUTLANDER 1000,2020-07-06,10,1,WI,US,11,1149
OUTLANDER 850,2020-07-06,13,14,WI,US,27,1239
OUTLANDER 450,2020-07-06,14,3,WI,US,17,1231
OUTLANDER 1000,2020-07-13,7,11,WI,US,18,1167
OUTLANDER 850,2020-07-13,13,9,WI,US,22,1261
OUTLANDER 450,2020-07-13,13,3,WI,US,16,1247
OUTLANDER 1000,2020-07-20,6,9,WI,US,15,1182
OUTLANDER 850,2020-07-20,13,12,WI,US,25,1286
OUTLANDER 450,2020-07-20,4,4,WI,US,8,1255
OUTLANDER 1000,2020-07-27,7,4,WI,US,11,1193
OUTLANDER 850,2020-07-27,8,6,WI,US,14,1300
OUTLANDER 450,2020-07-27,8,7,WI,US,15,1270
OUTLANDER 1000,2020-08-03,7,5,WI,US,12,1205
OUTLANDER 850,2020-08-03,11,13,WI,US,24,1324
OUTLANDER 450,2020-08-03,0,3,WI,US,3,1273
OUTLANDER 1000,2020-08-10,9,13,WI,US,22,1227
OUTLANDER 850,2020-08-10,15,14,WI,US,29,1353
OUTLANDER 450,2020-08-10,2,9,WI,US,11,1284
OUTLANDER 1000,2020-08-17,12,6,WI,US,18,1245
OUTLANDER 850,2020-08-17,4,8,WI,US,12,1365
OUTLANDER 450,2020-08-17,14,9,WI,US,23,1307
OUTLANDER 1000,2020-08-24,14,7,WI,US,21,1266
OUTLANDER 850,2020-08-24,9,10,WI,US,19,1384
OUTLANDER 450,2020-08-24,8,6,WI,US,14,1321
OUTLANDER 1000,2020-08-31,5,12,WI,US,17,1283
OUTLANDER 850,2020-08-31,4,5,WI,US,9,1393
OUTLANDER 450,2020-08-31,0,14,WI,US,14,1335
OUTLANDER 1000,2020-09-07,12,8,WI,US,20,1303
OUTLANDER 850,2020-09-07,14,14,WI,US,28,1421
OUTLANDER 450,2020-09-07,10,2,WI,US,12,1347
OUTLANDER 1000,2020-09-14,1,7,WI,US,8,1311
OUTLANDER 850,2020-09-14,4,13,WI,US,17,1438
OUTLANDER 450,2020-09-14,0,2,WI,US,2,1349
OUTLANDER 1000,2020-09-21,7,13,WI,US,20,1331
OUTLANDER 850,2020-09-21,9,6,WI,US,15,1453
OUTLANDER 450,2020-09-21,14,4,WI,US,18,1367
OUTLANDER 1000,2020-09-28,1,15,WI,US,16,1347
OUTLANDER 850,2020-09-28,9,4,WI,US,13,1466
OUTLANDER 450,2020-09-28,11,3,WI,US,14,1381
OUTLANDER 1000,2020-10-05,3,14,WI,US,17,1364
OUTLANDER 850,2020-10-05,5,2,WI,US,7,1473
OUTLANDER 450,2020-10-05,8,14,WI,US,22,1403
OUTLANDER 1000,2020-10-12,4,14,WI,US,18,1382
OUTLANDER 850,2020-10-12,13,4,WI,US,17,1490
OUTLANDER 450,2020-10-12,5,1,WI,US,6,1409
OUTLANDER 1000,2020-10-19,7,9,WI,US,16,1398
OUTLANDER 850,2020-10-19,12,8,WI,US,20,1510
OUTLANDER 450,2020-10-19,10,14,WI,US,24,1433
OUTLANDER 1000,2020-10-26,5,9,WI,US,14,1412
OUTLANDER 850,2020-10-26,6,3,WI,US,9,1519
OUTLANDER 450,2020-10-26,5,5,WI,US,10,1443
OUTLANDER 1000,2020-11-02,14,7,WI,US,21,1433
OUTLANDER 850,2020-11-02,1,6,WI,US,7,1526
OUTLANDER 450,2020-11-02,7,12,WI,US,19,1462
OUTLANDER 1000,2020-11-09,0,4,WI,US,4,1437
OUTLANDER 850,2020-11-09,3,5,WI,US,8,1534
OUTLANDER 450,2020-11-09,3,10,WI,US,13,1475
OUTLANDER 1000,2020-11-16,6,7,WI,US,13,1450
OUTLANDER 850,2020-11-16,0,8,WI,US,8,1542
OUTLANDER 450,2020-11-16,6,11,WI,US,17,1492
OUTLANDER 1000,2020-11-23,5,5,WI,US,10,1460
OUTLANDER 850,2020-11-23,9,1,WI,US,10,1552
OUTLANDER 450,2020-11-23,1,5,WI,US,6,1498
OUTLANDER 1000,2020-11-30,15,12,WI,US,27,1487
OUTLANDER 850,2020-11-30,4,5,WI,US,9,1561
OUTLANDER 450,2020-11-30,6,12,WI,US,18,1516
OUTLANDER 1000,2020-12-07,2,12,WI,US,14,1501
OUTLANDER 850,2020-12-07,15,14,WI,US,29,1590
OUTLANDER 450,2020-12-07,8,14,WI,US,22,1538
OUTLANDER 1000,2020-12-14,10,10,WI,US,20,1521
OUTLANDER 850,2020-12-14,14,13,WI,US,27,1617
OUTLANDER 450,2020-12-14,5,11,WI,US,16,1554
OUTLANDER 1000,2020-12-21,3,4,WI,US,7,1528
OUTLANDER 850,2020-12-21,4,6,WI,US,10,1627
OUTLANDER 450,2020-12-21,14,1,WI,US,15,1569
OUTLANDER 1000,2020-12-28,8,9,WI,US,17,1545
OUTLANDER 850,2020-12-28,3,11,WI,US,14,1641
OUTLANDER 450,2020-12-28,0,1,WI,US,1,1570
OUTLANDER 1000,2021-01-04,14,8,WI,US,22,1567
OUTLANDER 850,2021-01-04,10,2,WI,US,12,1653
OUTLANDER 450,2021-01-04,8,15,WI,US,23,1593
OUTLANDER 1000,2021-01-11,14,4,WI,US,18,1585
OUTLANDER 850,2021-01-11,4,4,WI,US,8,1661
OUTLANDER 450,2021-01-11,7,1,WI,US,8,1601
OUTLANDER 1000,2021-01-18,1,11,WI,US,12,1597
OUTLANDER 850,2021-01-18,13,1,WI,US,14,1675
OUTLANDER 450,2021-01-18,15,6,WI,US,21,1622
OUTLANDER 1000,2021-01-25,14,2,WI,US,16,1613
OUTLANDER 850,2021-01-25,15,5,WI,US,20,1695
OUTLANDER 450,2021-01-25,11,7,WI,US,18,1640
OUTLANDER 1000,2021-02-01,5,2,WI,US,7,1620
OUTLANDER 850,2021-02-01,4,10,WI,US,14,1709
OUTLANDER 450,2021-02-01,15,3,WI,US,18,1658
OUTLANDER 1000,2021-02-08,11,12,WI,US,23,1643
OUTLANDER 850,2021-02-08,11,9,WI,US,20,1729
OUTLANDER 450,2021-02-08,8,12,WI,US,20,1678
OUTLANDER 1000,2021-02-15,3,11,WI,US,14,1657
OUTLANDER 850,2021-02-15,4,7,WI,US,11,1740
OUTLANDER 450,2021-02-15,3,12,WI,US,15,1693
OUTLANDER 1000,2021-02-22,1,1,WI,US,2,1659
OUTLANDER 850,2021-02-22,4,11,WI,US,15,1755
OUTLANDER 450,2021-02-22,7,2,WI,US,9,1702
OUTLANDER 1000,2021-03-01,6,4,WI,US,10,1669
OUTLANDER 850,2021-03-01,11,10,WI,US,21,1776
OUTLANDER 450,2021-03-01,9,2,WI,US,11,1713
OUTLANDER 1000,2021-03-08,7,1,WI,US,8,1677
OUTLANDER 850,2021-03-08,9,6,WI,US,15,1791
OUTLANDER 450,2021-03-08,0,8,WI,US,8,1721
OUTLANDER 1000,2021-03-15,10,6,WI,US,16,1693
OUTLANDER 850,2021-03-15,12,13,WI,US,25,1816
OUTLANDER 450,2021-03-15,9,5,WI,US,14,1735
OUTLANDER 1000,2021-03-22,6,14,WI,US,20,1713
OUTLANDER 850,2021-03-22,4,14,WI,US,18,1834
OUTLANDER 450,2021-03-22,3,14,WI,US,17,1752
OUTLANDER 1000,2021-03-29,9,2,WI,US,11,1724
OUTLANDER 850,2021-03-29,9,12,WI,US,21,1855
OUTLANDER 450,2021-03-29,15,2,WI,US,17,1769
OUTLANDER 1000,2021-04-05,13,1,WI,US,14,1738
OUTLANDER 850,2021-04-05,9,11,WI,US,20,1875
OUTLANDER 450,2021-04-05,0,11,WI,US,11,1780
OUTLANDER 1000,2021-04-12,1,5,WI,US,6,1744
OUTLANDER 850,2021-04-12,4,1,WI,US,5,1880
OUTLANDER 450,2021-04-12,10,5,WI,US,15,1795
OUTLANDER 1000,2021-04-19,13,2,WI,US,15,1759
OUTLANDER 850,2021-04-19,13,13,WI,US,26,1906
OUTLANDER 450,2021-04-19,0,6,WI,US,6,1801
OUTLANDER 1000,2021-04-26,7,3,WI,US,10,1769
OUTLANDER 850,2021-04-26,2,14,WI,US,16,1922
OUTLANDER 450,2021-04-26,14,9,WI,US,23,1824
OUTLANDER 1000,2021-05-03,0,4,WI,US,4,1773
OUTLANDER 850,2021-05-03,14,0,WI,US,14,1936
OUTLANDER 450,2021-05-03,10,7,WI,US,17,1841
OUTLANDER 1000,2021-05-10,9,1,WI,US,10,1783
OUTLANDER 850,2021-05-10,0,10,WI,US,10,1946
OUTLANDER 450,2021-05-10,1,11,WI,US,12,1853
OUTLANDER 1000,2021-05-17,14,2,WI,US,16,1799
OUTLANDER 850,2021-05-17,3,6,WI,US,9,1955
OUTLANDER 450,2021-05-17,10,1,WI,US,11,1864
OUTLANDER 1000,2021-05-24,10,14,WI,US,24,1823
OUTLANDER 850,2021-05-24,1,1,WI,US,2,1957
OUTLANDER 450,2021-05-24,3,12,WI,US,15,1879
OUTLANDER 1000,2021-05-31,11,6,WI,US,17,1840
OUTLANDER 850,2021-05-31,10,15,WI,US,25,1982
OUTLANDER 450,2021-05-31,1,10,WI,US,11,1890
OUTLANDER 1000,2021-06-07,6,15,WI,US,21,1861
OUTLANDER 850,2021-06-07,6,14,WI,US,20,2002
OUTLANDER 450,2021-06-07,7,9,WI,US,16,1906
OUTLANDER 1000,2021-06-14,13,5,WI,US,18,1879
OUTLANDER 850,2021-06-14,5,13,WI,US,18,2020
OUTLANDER 450,2021-06-14,9,6,WI,US,15,1921
OUTLANDER 1000,2021-06-21,14,6,WI,US,20,1899
OUTLANDER 850,2021-06-21,12,8,WI,US,20,2040
OUTLANDER 450,2021-06-21,4,9,WI,US,13,1934
OUTLANDER 1000,2021-06-28,15,12,WI,US,27,1926
OUTLANDER 850,2021-06-28,14,10,WI,US,24,2064
OUTLANDER 450,2021-06-28,9,15,WI,US,24,1958
OUTLANDER 1000,2021-07-05,15,5,WI,US,20,1946
OUTLANDER 850,2021-07-05,14,4,WI,US,18,2082
OUTLANDER 450,2021-07-05,3,9,WI,US,12,1970
OUTLANDER 1000,2021-07-12,7,0,WI,US,7,1953
OUTLANDER 850,2021-07-12,8,15,WI,US,23,2105
OUTLANDER 450,2021-07-12,1,12,WI,US,13,1983
OUTLANDER 1000,2021-07-19,7,14,WI,US,21,1974
OUTLANDER 850,2021-07-19,4,3,WI,US,7,2112
OUTLANDER 450,2021-07-19,12,10,WI,US,22,2005
OUTLANDER 1000,2021-07-26,2,3,WI,US,5,1979
OUTLANDER 850,2021-07-26,5,13,WI,US,18,2130
OUTLANDER 450,2021-07-26,3,14,WI,US,17,2022
OUTLANDER 1000,2021-08-02,13,0,WI,US,13,1992
OUTLANDER 850,2021-08-02,3,11,WI,US,14,2144
OUTLANDER 450,2021-08-02,2,4,WI,US,6,2028
OUTLANDER 1000,2021-08-09,3,13,WI,US,16,2008
OUTLANDER 850,2021-08-09,9,2,WI,US,11,2155
OUTLANDER 450,2021-08-09,11,13,WI,US,24,2052
OUTLANDER 1000,2021-08-16,4,0,WI,US,4,2012
OUTLANDER 850,2021-08-16,14,14,WI,US,28,2183
OUTLANDER 450,2021-08-16,8,12,WI,US,20,2072
OUTLANDER 1000,2021-08-23,2,9,WI,US,11,2023
OUTLANDER 850,2021-08-23,2,4,WI,US,6,2189
OUTLANDER 450,2021-08-23,12,2,WI,US,14,2086
OUTLANDER 1000,2021-08-30,12,9,WI,US,21,2044
OUTLANDER 850,2021-08-30,2,12,WI,US,14,2203
OUTLANDER 450,2021-08-30,15,10,WI,US,25,2111
OUTLANDER 1000,2021-09-06,6,12,WI,US,18,2062
OUTLANDER 850,2021-09-06,1,11,WI,US,12,2215
OUTLANDER 450,2021-09-06,11,4,WI,US,15,2126
OUTLANDER 1000,2021-09-13,1,6,WI,US,7,2069
OUTLANDER 850,2021-09-13,3,6,WI,US,9,2224
OUTLANDER 450,2021-09-13,12,13,WI,US,25,2151
OUTLANDER 1000,2021-09-20,10,14,WI,US,24,2093
OUTLANDER 850,2021-09-20,6,9,WI,US,15,2239
OUTLANDER 450,2021-09-20,1,13,WI,US,14,2165
OUTLANDER 1000,2021-09-27,5,13,WI,US,18,2111
OUTLANDER 850,2021-09-27,2,3,WI,US,5,2244
OUTLANDER 450,2021-09-27,6,14,WI,US,20,2185
OUTLANDER 1000,2021-10-04,9,12,WI,US,21,2132
OUTLANDER 850,2021-10-04,11,11,WI,US,22,2266
OUTLANDER 450,2021-10-04,13,13,WI,US,26,2211
OUTLANDER 1000,2021-10-11,2,7,WI,US,9,2141
OUTLANDER 850,2021-10-11,2,5,WI,US,7,2273
OUTLANDER 450,2021-10-11,5,10,WI,US,15,2226
OUTLANDER 1000,2021-10-18,2,15,WI,US,17,2158
OUTLANDER 850,2021-10-18,14,2,WI,US,16,2289
OUTLANDER 450,2021-10-18,4,6,WI,US,10,2236
OUTLANDER 1000,2021-10-25,11,12,WI,US,23,2181
OUTLANDER 850,2021-10-25,9,11,WI,US,20,2309
OUTLANDER 450,2021-10-25,12,4,WI,US,16,2252
OUTLANDER 1000,2021-11-01,4,14,WI,US,18,2199
OUTLANDER 850,2021-11-01,13,0,WI,US,13,2322
OUTLANDER 450,2021-11-01,14,9,WI,US,23,2275
OUTLANDER 1000,2021-11-08,12,1,WI,US,13,2212
OUTLANDER 850,2021-11-08,12,6,WI,US,18,2340
OUTLANDER 450,2021-11-08,12,3,WI,US,15,2290
OUTLANDER 1000,2021-11-15,8,4,WI,US,12,2224
OUTLANDER 850,2021-11-15,4,10,WI,US,14,2354
OUTLANDER 450,2021-11-15,5,5,WI,US,10,2300
OUTLANDER 1000,2021-11-22,12,9,WI,US,21,2245
OUTLANDER 850,2021-11-22,13,2,WI,US,15,2369
OUTLANDER 450,2021-11-22,4,3,WI,US,7,2307
OUTLANDER 1000,2021-11-29,15,1,WI,US,16,2261
OUTLANDER 850,2021-11-29,4,15,WI,US,19,2388
OUTLANDER 450,2021-11-29,5,15,WI,US,20,2327
OUTLANDER 1000,2021-12-06,3,10,WI,US,13,2274
OUTLANDER 850,2021-12-06,15,10,WI,US,25,2413
OUTLANDER 450,2021-12-06,2,10,WI,US,12,2339
OUTLANDER 1000,2021-12-13,14,10,WI,US,24,2298
OUTLANDER 850,2021-12-13,7,1,WI,US,8,2421
OUTLANDER 450,2021-12-13,13,14,WI,US,27,2366
OUTLANDER 1000,2021-12-20,7,2,WI,US,9,2307
OUTLANDER 850,2021-12-20,11,4,WI,US,15,2436
OUTLANDER 450,2021-12-20,6,7,WI,US,13,2379
OUTLANDER 1000,2021-12-27,4,3,WI,US,7,2314
OUTLANDER 850,2021-12-27,12,2,WI,US,14,2450
OUTLANDER 450,2021-12-27,13,1,WI,US,14,2393
OUTLANDER 1000,2019-01-07,12,8,WY,US,20,20
OUTLANDER 850,2019-01-07,8,5,WY,US,13,13
OUTLANDER 450,2019-01-07,3,10,WY,US,13,13
OUTLANDER 1000,2019-01-14,14,3,WY,US,17,37
OUTLANDER 850,2019-01-14,7,2,WY,US,9,22
OUTLANDER 450,2019-01-14,11,1,WY,US,12,25
OUTLANDER 1000,2019-01-21,10,14,WY,US,24,61
OUTLANDER 850,2019-01-21,5,4,WY,US,9,31
OUTLANDER 450,2019-01-21,6,3,WY,US,9,34
OUTLANDER 1000,2019-01-28,13,12,WY,US,25,86
OUTLANDER 850,2019-01-28,14,0,WY,US,14,45
OUTLANDER 450,2019-01-28,12,8,WY,US,20,54
OUTLANDER 1000,2019-02-04,15,0,WY,US,15,101
OUTLANDER 850,2019-02-04,7,2,WY,US,9,54
OUTLANDER 450,2019-02-04,14,4,WY,US,18,72
OUTLANDER 1000,2019-02-11,4,10,WY,US,14,115
OUTLANDER 850,2019-02-11,10,12,WY,US,22,76
OUTLANDER 450,2019-02-11,5,8,WY,US,13,85
OUTLANDER 1000,2019-02-18,5,14,WY,US,19,134
OUTLANDER 850,2019-02-18,14,1,WY,US,15,91
OUTLANDER 450,2019-02-18,4,13,WY,US,17,102
OUTLANDER 1000,2019-02-25,8,9,WY,US,17,151
OUTLANDER 850,2019-02-25,6,3,WY,US,9,100
OUTLANDER 450,2019-02-25,11,5,WY,US,16,118
OUTLANDER 1000,2019-03-04,5,1,WY,US,6,157
OUTLANDER 850,2019-03-04,8,14,WY,US,22,122
OUTLANDER 450,2019-03-04,3,12,WY,US,15,133
OUTLANDER 1000,2019-03-11,9,5,WY,US,14,171
OUTLANDER 850,2019-03-11,4,9,WY,US,13,135
OUTLANDER 450,2019-03-11,13,11,WY,US,24,157
OUTLANDER 1000,2019-03-18,11,2,WY,US,13,184
OUTLANDER 850,2019-03-18,5,2,WY,US,7,142
OUTLANDER 450,2019-03-18,0,3,WY,US,3,160
OUTLANDER 1000,2019-03-25,2,3,WY,US,5,189
OUTLANDER 850,2019-03-25,5,5,WY,US,10,152
OUTLANDER 450,2019-03-25,8,10,WY,US,18,178
OUTLANDER 1000,2019-04-01,0,10,WY,US,10,199
OUTLANDER 850,2019-04-01,5,4,WY,US,9,161
OUTLANDER 450,2019-04-01,6,3,WY,US,9,187
OUTLANDER 1000,2019-04-08,14,7,WY,US,21,220
OUTLANDER 850,2019-04-08,14,9,WY,US,23,184
OUTLANDER 450,2019-04-08,11,9,WY,US,20,207
OUTLANDER 1000,2019-04-15,6,4,WY,US,10,230
OUTLANDER 850,2019-04-15,2,8,WY,US,10,194
OUTLANDER 450,2019-04-15,10,13,WY,US,23,230
OUTLANDER 1000,2019-04-22,9,0,WY,US,9,239
OUTLANDER 850,2019-04-22,4,6,WY,US,10,204
OUTLANDER 450,2019-04-22,7,5,WY,US,12,242
OUTLANDER 1000,2019-04-29,6,12,WY,US,18,257
OUTLANDER 850,2019-04-29,9,11,WY,US,20,224
OUTLANDER 450,2019-04-29,15,3,WY,US,18,260
OUTLANDER 1000,2019-05-06,7,12,WY,US,19,276
OUTLANDER 850,2019-05-06,11,8,WY,US,19,243
OUTLANDER 450,2019-05-06,6,7,WY,US,13,273
OUTLANDER 1000,2019-05-13,4,12,WY,US,16,292
OUTLANDER 850,2019-05-13,5,7,WY,US,12,255
OUTLANDER 450,2019-05-13,12,10,WY,US,22,295
OUTLANDER 1000,2019-05-20,8,0,WY,US,8,300
OUTLANDER 850,2019-05-20,0,11,WY,US,11,266
OUTLANDER 450,2019-05-20,4,6,WY,US,10,305
OUTLANDER 1000,2019-05-27,14,8,WY,US,22,322
OUTLANDER 850,2019-05-27,12,11,WY,US,23,289
OUTLANDER 450,2019-05-27,6,12,WY,US,18,323
OUTLANDER 1000,2019-06-03,15,2,WY,US,17,339
OUTLANDER 850,2019-06-03,15,11,WY,US,26,315
OUTLANDER 450,2019-06-03,1,6,WY,US,7,330
OUTLANDER 1000,2019-06-10,8,13,WY,US,21,360
OUTLANDER 850,2019-06-10,7,4,WY,US,11,326
OUTLANDER 450,2019-06-10,1,10,WY,US,11,341
OUTLANDER 1000,2019-06-17,3,14,WY,US,17,377
OUTLANDER 850,2019-06-17,5,14,WY,US,19,345
OUTLANDER 450,2019-06-17,10,13,WY,US,23,364
OUTLANDER 1000,2019-06-24,4,1,WY,US,5,382
OUTLANDER 850,2019-06-24,7,14,WY,US,21,366
OUTLANDER 450,2019-06-24,10,6,WY,US,16,380
OUTLANDER 1000,2019-07-01,11,0,WY,US,11,393
OUTLANDER 850,2019-07-01,0,1,WY,US,1,367
OUTLANDER 450,2019-07-01,15,6,WY,US,21,401
OUTLANDER 1000,2019-07-08,5,5,WY,US,10,403
OUTLANDER 850,2019-07-08,7,4,WY,US,11,378
OUTLANDER 450,2019-07-08,10,7,WY,US,17,418
OUTLANDER 1000,2019-07-15,11,10,WY,US,21,424
OUTLANDER 850,2019-07-15,8,6,WY,US,14,392
OUTLANDER 450,2019-07-15,14,8,WY,US,22,440
OUTLANDER 1000,2019-07-22,1,11,WY,US,12,436
OUTLANDER 850,2019-07-22,12,4,WY,US,16,408
OUTLANDER 450,2019-07-22,7,4,WY,US,11,451
OUTLANDER 1000,2019-07-29,0,3,WY,US,3,439
OUTLANDER 850,2019-07-29,4,14,WY,US,18,426
OUTLANDER 450,2019-07-29,4,13,WY,US,17,468
OUTLANDER 1000,2019-08-05,14,12,WY,US,26,465
OUTLANDER 850,2019-08-05,6,9,WY,US,15,441
OUTLANDER 450,2019-08-05,14,3,WY,US,17,485
OUTLANDER 1000,2019-08-12,4,9,WY,US,13,478
OUTLANDER 850,2019-08-12,14,2,WY,US,16,457
OUTLANDER 450,2019-08-12,15,5,WY,US,20,505
OUTLANDER 1000,2019-08-19,15,10,WY,US,25,503
OUTLANDER 850,2019-08-19,11,14,WY,US,25,482
OUTLANDER 450,2019-08-19,2,2,WY,US,4,509
OUTLANDER 1000,2019-08-26,10,4,WY,US,14,517
OUTLANDER 850,2019-08-26,10,4,WY,US,14,496
OUTLANDER 450,2019-08-26,10,3,WY,US,13,522
OUTLANDER 1000,2019-09-02,9,10,WY,US,19,536
OUTLANDER 850,2019-09-02,15,6,WY,US,21,517
OUTLANDER 450,2019-09-02,8,11,WY,US,19,541
OUTLANDER 1000,2019-09-09,6,6,WY,US,12,548
OUTLANDER 850,2019-09-09,12,8,WY,US,20,537
OUTLANDER 450,2019-09-09,11,0,WY,US,11,552
OUTLANDER 1000,2019-09-16,5,3,WY,US,8,556
OUTLANDER 850,2019-09-16,10,15,WY,US,25,562
OUTLANDER 450,2019-09-16,11,13,WY,US,24,576
OUTLANDER 1000,2019-09-23,14,12,WY,US,26,582
OUTLANDER 850,2019-09-23,0,14,WY,US,14,576
OUTLANDER 450,2019-09-23,5,4,WY,US,9,585
OUTLANDER 1000,2019-09-30,13,6,WY,US,19,601
OUTLANDER 850,2019-09-30,13,5,WY,US,18,594
OUTLANDER 450,2019-09-30,12,8,WY,US,20,605
OUTLANDER 1000,2019-10-07,9,4,WY,US,13,614
OUTLANDER 850,2019-10-07,14,9,WY,US,23,617
OUTLANDER 450,2019-10-07,3,10,WY,US,13,618
OUTLANDER 1000,2019-10-14,2,11,WY,US,13,627
OUTLANDER 850,2019-10-14,2,2,WY,US,4,621
OUTLANDER 450,2019-10-14,6,1,WY,US,7,625
OUTLANDER 1000,2019-10-21,10,12,WY,US,22,649
OUTLANDER 850,2019-10-21,4,4,WY,US,8,629
OUTLANDER 450,2019-10-21,7,10,WY,US,17,642
OUTLANDER 1000,2019-10-28,10,11,WY,US,21,670
OUTLANDER 850,2019-10-28,15,13,WY,US,28,657
OUTLANDER 450,2019-10-28,2,11,WY,US,13,655
OUTLANDER 1000,2019-11-04,1,7,WY,US,8,678
OUTLANDER 850,2019-11-04,15,3,WY,US,18,675
OUTLANDER 450,2019-11-04,1,7,WY,US,8,663
OUTLANDER 1000,2019-11-11,1,5,WY,US,6,684
OUTLANDER 850,2019-11-11,9,15,WY,US,24,699
OUTLANDER 450,2019-11-11,9,7,WY,US,16,679
OUTLANDER 1000,2019-11-18,5,14,WY,US,19,703
OUTLANDER 850,2019-11-18,1,13,WY,US,14,713
OUTLANDER 450,2019-11-18,4,6,WY,US,10,689
OUTLANDER 1000,2019-11-25,11,5,WY,US,16,719
OUTLANDER 850,2019-11-25,10,6,WY,US,16,729
OUTLANDER 450,2019-11-25,15,4,WY,US,19,708
OUTLANDER 1000,2019-12-02,0,8,WY,US,8,727
OUTLANDER 850,2019-12-02,12,10,WY,US,22,751
OUTLANDER 450,2019-12-02,9,7,WY,US,16,724
OUTLANDER 1000,2019-12-09,7,2,WY,US,9,736
OUTLANDER 850,2019-12-09,13,14,WY,US,27,778
OUTLANDER 450,2019-12-09,10,0,WY,US,10,734
OUTLANDER 1000,2019-12-16,7,12,WY,US,19,755
OUTLANDER 850,2019-12-16,8,14,WY,US,22,800
OUTLANDER 450,2019-12-16,5,5,WY,US,10,744
OUTLANDER 1000,2019-12-23,12,15,WY,US,27,782
OUTLANDER 850,2019-12-23,7,9,WY,US,16,816
OUTLANDER 450,2019-12-23,11,5,WY,US,16,760
OUTLANDER 1000,2019-12-30,12,11,WY,US,23,805
OUTLANDER 850,2019-12-30,15,11,WY,US,26,842
OUTLANDER 450,2019-12-30,1,9,WY,US,10,770
OUTLANDER 1000,2020-01-06,6,3,WY,US,9,814
OUTLANDER 850,2020-01-06,14,12,WY,US,26,868
OUTLANDER 450,2020-01-06,13,2,WY,US,15,785
OUTLANDER 1000,2020-01-13,3,9,WY,US,12,826
OUTLANDER 850,2020-01-13,5,3,WY,US,8,876
OUTLANDER 450,2020-01-13,10,8,WY,US,18,803
OUTLANDER 1000,2020-01-20,3,9,WY,US,12,838
OUTLANDER 850,2020-01-20,12,11,WY,US,23,899
OUTLANDER 450,2020-01-20,8,7,WY,US,15,818
OUTLANDER 1000,2020-01-27,14,8,WY,US,22,860
OUTLANDER 850,2020-01-27,9,11,WY,US,20,919
OUTLANDER 450,2020-01-27,0,12,WY,US,12,830
OUTLANDER 1000,2020-02-03,6,5,WY,US,11,871
OUTLANDER 850,2020-02-03,2,3,WY,US,5,924
OUTLANDER 450,2020-02-03,11,0,WY,US,11,841
OUTLANDER 1000,2020-02-10,1,12,WY,US,13,884
OUTLANDER 850,2020-02-10,1,7,WY,US,8,932
OUTLANDER 450,2020-02-10,13,8,WY,US,21,862
OUTLANDER 1000,2020-02-17,6,13,WY,US,19,903
OUTLANDER 850,2020-02-17,2,6,WY,US,8,940
OUTLANDER 450,2020-02-17,0,10,WY,US,10,872
OUTLANDER 1000,2020-02-24,9,10,WY,US,19,922
OUTLANDER 850,2020-02-24,6,2,WY,US,8,948
OUTLANDER 450,2020-02-24,9,1,WY,US,10,882
OUTLANDER 1000,2020-03-02,4,10,WY,US,14,936
OUTLANDER 850,2020-03-02,12,7,WY,US,19,967
OUTLANDER 450,2020-03-02,7,12,WY,US,19,901
OUTLANDER 1000,2020-03-09,2,13,WY,US,15,951
OUTLANDER 850,2020-03-09,5,7,WY,US,12,979
OUTLANDER 450,2020-03-09,6,3,WY,US,9,910
OUTLANDER 1000,2020-03-16,13,3,WY,US,16,967
OUTLANDER 850,2020-03-16,15,9,WY,US,24,1003
OUTLANDER 450,2020-03-16,11,2,WY,US,13,923
OUTLANDER 1000,2020-03-23,3,2,WY,US,5,972
OUTLANDER 850,2020-03-23,5,6,WY,US,11,1014
OUTLANDER 450,2020-03-23,6,0,WY,US,6,929
OUTLANDER 1000,2020-03-30,13,6,WY,US,19,991
OUTLANDER 850,2020-03-30,10,5,WY,US,15,1029
OUTLANDER 450,2020-03-30,4,14,WY,US,18,947
OUTLANDER 1000,2020-04-06,13,13,WY,US,26,1017
OUTLANDER 850,2020-04-06,6,8,WY,US,14,1043
OUTLANDER 450,2020-04-06,13,11,WY,US,24,971
OUTLANDER 1000,2020-04-13,6,12,WY,US,18,1035
OUTLANDER 850,2020-04-13,6,10,WY,US,16,1059
OUTLANDER 450,2020-04-13,7,9,WY,US,16,987
OUTLANDER 1000,2020-04-20,6,4,WY,US,10,1045
OUTLANDER 850,2020-04-20,3,8,WY,US,11,1070
OUTLANDER 450,2020-04-20,3,2,WY,US,5,992
OUTLANDER 1000,2020-04-27,8,12,WY,US,20,1065
OUTLANDER 850,2020-04-27,4,3,WY,US,7,1077
OUTLANDER 450,2020-04-27,6,0,WY,US,6,998
OUTLANDER 1000,2020-05-04,0,14,WY,US,14,1079
OUTLANDER 850,2020-05-04,15,11,WY,US,26,1103
OUTLANDER 450,2020-05-04,14,13,WY,US,27,1025
OUTLANDER 1000,2020-05-11,3,8,WY,US,11,1090
OUTLANDER 850,2020-05-11,0,13,WY,US,13,1116
OUTLANDER 450,2020-05-11,4,2,WY,US,6,1031
OUTLANDER 1000,2020-05-18,10,11,WY,US,21,1111
OUTLANDER 850,2020-05-18,8,15,WY,US,23,1139
OUTLANDER 450,2020-05-18,1,7,WY,US,8,1039
OUTLANDER 1000,2020-05-25,9,9,WY,US,18,1129
OUTLANDER 850,2020-05-25,15,7,WY,US,22,1161
OUTLANDER 450,2020-05-25,7,1,WY,US,8,1047
OUTLANDER 1000,2020-06-01,8,15,WY,US,23,1152
OUTLANDER 850,2020-06-01,1,2,WY,US,3,1164
OUTLANDER 450,2020-06-01,13,7,WY,US,20,1067
OUTLANDER 1000,2020-06-08,8,3,WY,US,11,1163
OUTLANDER 850,2020-06-08,3,4,WY,US,7,1171
OUTLANDER 450,2020-06-08,2,4,WY,US,6,1073
OUTLANDER 1000,2020-06-15,7,7,WY,US,14,1177
OUTLANDER 850,2020-06-15,2,12,WY,US,14,1185
OUTLANDER 450,2020-06-15,13,14,WY,US,27,1100
OUTLANDER 1000,2020-06-22,9,13,WY,US,22,1199
OUTLANDER 850,2020-06-22,10,5,WY,US,15,1200
OUTLANDER 450,2020-06-22,0,6,WY,US,6,1106
OUTLANDER 1000,2020-06-29,0,9,WY,US,9,1208
OUTLANDER 850,2020-06-29,0,12,WY,US,12,1212
OUTLANDER 450,2020-06-29,14,1,WY,US,15,1121
OUTLANDER 1000,2020-07-06,14,10,WY,US,24,1232
OUTLANDER 850,2020-07-06,5,5,WY,US,10,1222
OUTLANDER 450,2020-07-06,8,3,WY,US,11,1132
OUTLANDER 1000,2020-07-13,3,14,WY,US,17,1249
OUTLANDER 850,2020-07-13,1,1,WY,US,2,1224
OUTLANDER 450,2020-07-13,14,11,WY,US,25,1157
OUTLANDER 1000,2020-07-20,0,2,WY,US,2,1251
OUTLANDER 850,2020-07-20,10,5,WY,US,15,1239
OUTLANDER 450,2020-07-20,6,0,WY,US,6,1163
OUTLANDER 1000,2020-07-27,12,8,WY,US,20,1271
OUTLANDER 850,2020-07-27,8,4,WY,US,12,1251
OUTLANDER 450,2020-07-27,10,7,WY,US,17,1180
OUTLANDER 1000,2020-08-03,14,2,WY,US,16,1287
OUTLANDER 850,2020-08-03,9,14,WY,US,23,1274
OUTLANDER 450,2020-08-03,10,11,WY,US,21,1201
OUTLANDER 1000,2020-08-10,1,10,WY,US,11,1298
OUTLANDER 850,2020-08-10,7,13,WY,US,20,1294
OUTLANDER 450,2020-08-10,1,4,WY,US,5,1206
OUTLANDER 1000,2020-08-17,0,13,WY,US,13,1311
OUTLANDER 850,2020-08-17,1,13,WY,US,14,1308
OUTLANDER 450,2020-08-17,13,7,WY,US,20,1226
OUTLANDER 1000,2020-08-24,5,7,WY,US,12,1323
OUTLANDER 850,2020-08-24,7,9,WY,US,16,1324
OUTLANDER 450,2020-08-24,0,12,WY,US,12,1238
OUTLANDER 1000,2020-08-31,11,7,WY,US,18,1341
OUTLANDER 850,2020-08-31,10,9,WY,US,19,1343
OUTLANDER 450,2020-08-31,4,1,WY,US,5,1243
OUTLANDER 1000,2020-09-07,2,1,WY,US,3,1344
OUTLANDER 850,2020-09-07,12,1,WY,US,13,1356
OUTLANDER 450,2020-09-07,11,14,WY,US,25,1268
OUTLANDER 1000,2020-09-14,14,4,WY,US,18,1362
OUTLANDER 850,2020-09-14,3,6,WY,US,9,1365
OUTLANDER 450,2020-09-14,0,8,WY,US,8,1276
OUTLANDER 1000,2020-09-21,8,15,WY,US,23,1385
OUTLANDER 850,2020-09-21,5,1,WY,US,6,1371
OUTLANDER 450,2020-09-21,1,14,WY,US,15,1291
OUTLANDER 1000,2020-09-28,13,8,WY,US,21,1406
OUTLANDER 850,2020-09-28,10,13,WY,US,23,1394
OUTLANDER 450,2020-09-28,2,2,WY,US,4,1295
OUTLANDER 1000,2020-10-05,10,9,WY,US,19,1425
OUTLANDER 850,2020-10-05,11,10,WY,US,21,1415
OUTLANDER 450,2020-10-05,2,9,WY,US,11,1306
OUTLANDER 1000,2020-10-12,7,6,WY,US,13,1438
OUTLANDER 850,2020-10-12,7,5,WY,US,12,1427
OUTLANDER 450,2020-10-12,14,14,WY,US,28,1334
OUTLANDER 1000,2020-10-19,10,14,WY,US,24,1462
OUTLANDER 850,2020-10-19,4,14,WY,US,18,1445
OUTLANDER 450,2020-10-19,7,6,WY,US,13,1347
OUTLANDER 1000,2020-10-26,12,12,WY,US,24,1486
OUTLANDER 850,2020-10-26,14,1,WY,US,15,1460
OUTLANDER 450,2020-10-26,1,7,WY,US,8,1355
OUTLANDER 1000,2020-11-02,11,1,WY,US,12,1498
OUTLANDER 850,2020-11-02,7,13,WY,US,20,1480
OUTLANDER 450,2020-11-02,12,14,WY,US,26,1381
OUTLANDER 1000,2020-11-09,12,6,WY,US,18,1516
OUTLANDER 850,2020-11-09,2,6,WY,US,8,1488
OUTLANDER 450,2020-11-09,13,6,WY,US,19,1400
OUTLANDER 1000,2020-11-16,9,15,WY,US,24,1540
OUTLANDER 850,2020-11-16,1,6,WY,US,7,1495
OUTLANDER 450,2020-11-16,14,13,WY,US,27,1427
OUTLANDER 1000,2020-11-23,3,10,WY,US,13,1553
OUTLANDER 850,2020-11-23,4,7,WY,US,11,1506
OUTLANDER 450,2020-11-23,2,13,WY,US,15,1442
OUTLANDER 1000,2020-11-30,13,2,WY,US,15,1568
OUTLANDER 850,2020-11-30,10,7,WY,US,17,1523
OUTLANDER 450,2020-11-30,3,7,WY,US,10,1452
OUTLANDER 1000,2020-12-07,13,1,WY,US,14,1582
OUTLANDER 850,2020-12-07,9,5,WY,US,14,1537
OUTLANDER 450,2020-12-07,9,4,WY,US,13,1465
OUTLANDER 1000,2020-12-14,8,10,WY,US,18,1600
OUTLANDER 850,2020-12-14,13,5,WY,US,18,1555
OUTLANDER 450,2020-12-14,12,4,WY,US,16,1481
OUTLANDER 1000,2020-12-21,4,9,WY,US,13,1613
OUTLANDER 850,2020-12-21,2,14,WY,US,16,1571
OUTLANDER 450,2020-12-21,6,8,WY,US,14,1495
OUTLANDER 1000,2020-12-28,13,11,WY,US,24,1637
OUTLANDER 850,2020-12-28,6,1,WY,US,7,1578
OUTLANDER 450,2020-12-28,4,14,WY,US,18,1513
OUTLANDER 1000,2021-01-04,12,8,WY,US,20,1657
OUTLANDER 850,2021-01-04,3,14,WY,US,17,1595
OUTLANDER 450,2021-01-04,8,13,WY,US,21,1534
OUTLANDER 1000,2021-01-11,13,10,WY,US,23,1680
OUTLANDER 850,2021-01-11,11,9,WY,US,20,1615
OUTLANDER 450,2021-01-11,12,1,WY,US,13,1547
OUTLANDER 1000,2021-01-18,15,10,WY,US,25,1705
OUTLANDER 850,2021-01-18,11,8,WY,US,19,1634
OUTLANDER 450,2021-01-18,4,3,WY,US,7,1554
OUTLANDER 1000,2021-01-25,11,5,WY,US,16,1721
OUTLANDER 850,2021-01-25,4,7,WY,US,11,1645
OUTLANDER 450,2021-01-25,13,14,WY,US,27,1581
OUTLANDER 1000,2021-02-01,1,7,WY,US,8,1729
OUTLANDER 850,2021-02-01,15,8,WY,US,23,1668
OUTLANDER 450,2021-02-01,13,12,WY,US,25,1606
OUTLANDER 1000,2021-02-08,12,14,WY,US,26,1755
OUTLANDER 850,2021-02-08,8,14,WY,US,22,1690
OUTLANDER 450,2021-02-08,3,14,WY,US,17,1623
OUTLANDER 1000,2021-02-15,0,0,WY,US,0,1755
OUTLANDER 850,2021-02-15,14,8,WY,US,22,1712
OUTLANDER 450,2021-02-15,11,1,WY,US,12,1635
OUTLANDER 1000,2021-02-22,12,14,WY,US,26,1781
OUTLANDER 850,2021-02-22,4,10,WY,US,14,1726
OUTLANDER 450,2021-02-22,11,1,WY,US,12,1647
OUTLANDER 1000,2021-03-01,7,15,WY,US,22,1803
OUTLANDER 850,2021-03-01,11,9,WY,US,20,1746
OUTLANDER 450,2021-03-01,12,5,WY,US,17,1664
OUTLANDER 1000,2021-03-08,4,2,WY,US,6,1809
OUTLANDER 850,2021-03-08,14,10,WY,US,24,1770
OUTLANDER 450,2021-03-08,5,6,WY,US,11,1675
OUTLANDER 1000,2021-03-15,13,6,WY,US,19,1828
OUTLANDER 850,2021-03-15,3,3,WY,US,6,1776
OUTLANDER 450,2021-03-15,15,0,WY,US,15,1690
OUTLANDER 1000,2021-03-22,6,15,WY,US,21,1849
OUTLANDER 850,2021-03-22,0,13,WY,US,13,1789
OUTLANDER 450,2021-03-22,12,14,WY,US,26,1716
OUTLANDER 1000,2021-03-29,11,9,WY,US,20,1869
OUTLANDER 850,2021-03-29,12,7,WY,US,19,1808
OUTLANDER 450,2021-03-29,9,10,WY,US,19,1735
OUTLANDER 1000,2021-04-05,12,11,WY,US,23,1892
OUTLANDER 850,2021-04-05,10,0,WY,US,10,1818
OUTLANDER 450,2021-04-05,12,4,WY,US,16,1751
OUTLANDER 1000,2021-04-12,6,6,WY,US,12,1904
OUTLANDER 850,2021-04-12,1,7,WY,US,8,1826
OUTLANDER 450,2021-04-12,1,3,WY,US,4,1755
OUTLANDER 1000,2021-04-19,15,12,WY,US,27,1931
OUTLANDER 850,2021-04-19,4,11,WY,US,15,1841
OUTLANDER 450,2021-04-19,10,13,WY,US,23,1778
OUTLANDER 1000,2021-04-26,11,14,WY,US,25,1956
OUTLANDER 850,2021-04-26,14,12,WY,US,26,1867
OUTLANDER 450,2021-04-26,8,4,WY,US,12,1790
OUTLANDER 1000,2021-05-03,1,4,WY,US,5,1961
OUTLANDER 850,2021-05-03,7,9,WY,US,16,1883
OUTLANDER 450,2021-05-03,10,5,WY,US,15,1805
OUTLANDER 1000,2021-05-10,0,4,WY,US,4,1965
OUTLANDER 850,2021-05-10,1,5,WY,US,6,1889
OUTLANDER 450,2021-05-10,6,4,WY,US,10,1815
OUTLANDER 1000,2021-05-17,0,4,WY,US,4,1969
OUTLANDER 850,2021-05-17,8,15,WY,US,23,1912
OUTLANDER 450,2021-05-17,8,13,WY,US,21,1836
OUTLANDER 1000,2021-05-24,6,1,WY,US,7,1976
OUTLANDER 850,2021-05-24,13,4,WY,US,17,1929
OUTLANDER 450,2021-05-24,12,2,WY,US,14,1850
OUTLANDER 1000,2021-05-31,1,2,WY,US,3,1979
OUTLANDER 850,2021-05-31,2,11,WY,US,13,1942
OUTLANDER 450,2021-05-31,2,7,WY,US,9,1859
OUTLANDER 1000,2021-06-07,8,3,WY,US,11,1990
OUTLANDER 850,2021-06-07,2,11,WY,US,13,1955
OUTLANDER 450,2021-06-07,2,0,WY,US,2,1861
OUTLANDER 1000,2021-06-14,3,9,WY,US,12,2002
OUTLANDER 850,2021-06-14,11,1,WY,US,12,1967
OUTLANDER 450,2021-06-14,2,8,WY,US,10,1871
OUTLANDER 1000,2021-06-21,2,5,WY,US,7,2009
OUTLANDER 850,2021-06-21,8,4,WY,US,12,1979
OUTLANDER 450,2021-06-21,8,1,WY,US,9,1880
OUTLANDER 1000,2021-06-28,9,9,WY,US,18,2027
OUTLANDER 850,2021-06-28,7,5,WY,US,12,1991
OUTLANDER 450,2021-06-28,8,14,WY,US,22,1902
OUTLANDER 1000,2021-07-05,12,8,WY,US,20,2047
OUTLANDER 850,2021-07-05,4,7,WY,US,11,2002
OUTLANDER 450,2021-07-05,1,6,WY,US,7,1909
OUTLANDER 1000,2021-07-12,2,10,WY,US,12,2059
OUTLANDER 850,2021-07-12,12,13,WY,US,25,2027
OUTLANDER 450,2021-07-12,13,7,WY,US,20,1929
OUTLANDER 1000,2021-07-19,5,8,WY,US,13,2072
OUTLANDER 850,2021-07-19,9,11,WY,US,20,2047
OUTLANDER 450,2021-07-19,2,15,WY,US,17,1946
OUTLANDER 1000,2021-07-26,9,10,WY,US,19,2091
OUTLANDER 850,2021-07-26,9,12,WY,US,21,2068
OUTLANDER 450,2021-07-26,11,14,WY,US,25,1971
OUTLANDER 1000,2021-08-02,5,1,WY,US,6,2097
OUTLANDER 850,2021-08-02,3,2,WY,US,5,2073
OUTLANDER 450,2021-08-02,1,13,WY,US,14,1985
OUTLANDER 1000,2021-08-09,14,4,WY,US,18,2115
OUTLANDER 850,2021-08-09,7,14,WY,US,21,2094
OUTLANDER 450,2021-08-09,6,13,WY,US,19,2004
OUTLANDER 1000,2021-08-16,1,12,WY,US,13,2128
OUTLANDER 850,2021-08-16,4,6,WY,US,10,2104
OUTLANDER 450,2021-08-16,2,2,WY,US,4,2008
OUTLANDER 1000,2021-08-23,14,7,WY,US,21,2149
OUTLANDER 850,2021-08-23,2,11,WY,US,13,2117
OUTLANDER 450,2021-08-23,9,11,WY,US,20,2028
OUTLANDER 1000,2021-08-30,2,2,WY,US,4,2153
OUTLANDER 850,2021-08-30,7,3,WY,US,10,2127
OUTLANDER 450,2021-08-30,4,15,WY,US,19,2047
OUTLANDER 1000,2021-09-06,9,4,WY,US,13,2166
OUTLANDER 850,2021-09-06,13,10,WY,US,23,2150
OUTLANDER 450,2021-09-06,9,5,WY,US,14,2061
OUTLANDER 1000,2021-09-13,9,8,WY,US,17,2183
OUTLANDER 850,2021-09-13,2,15,WY,US,17,2167
OUTLANDER 450,2021-09-13,7,2,WY,US,9,2070
OUTLANDER 1000,2021-09-20,8,3,WY,US,11,2194
OUTLANDER 850,2021-09-20,5,3,WY,US,8,2175
OUTLANDER 450,2021-09-20,10,2,WY,US,12,2082
OUTLANDER 1000,2021-09-27,10,2,WY,US,12,2206
OUTLANDER 850,2021-09-27,14,9,WY,US,23,2198
OUTLANDER 450,2021-09-27,8,3,WY,US,11,2093
OUTLANDER 1000,2021-10-04,9,11,WY,US,20,2226
OUTLANDER 850,2021-10-04,15,10,WY,US,25,2223
OUTLANDER 450,2021-10-04,14,12,WY,US,26,2119
OUTLANDER 1000,2021-10-11,12,8,WY,US,20,2246
OUTLANDER 850,2021-10-11,7,9,WY,US,16,2239
OUTLANDER 450,2021-10-11,13,11,WY,US,24,2143
OUTLANDER 1000,2021-10-18,7,6,WY,US,13,2259
OUTLANDER 850,2021-10-18,6,2,WY,US,8,2247
OUTLANDER 450,2021-10-18,14,4,WY,US,18,2161
OUTLANDER 1000,2021-10-25,5,6,WY,US,11,2270
OUTLANDER 850,2021-10-25,13,13,WY,US,26,2273
OUTLANDER 450,2021-10-25,8,14,WY,US,22,2183
OUTLANDER 1000,2021-11-01,7,12,WY,US,19,2289
OUTLANDER 850,2021-11-01,4,7,WY,US,11,2284
OUTLANDER 450,2021-11-01,7,7,WY,US,14,2197
OUTLANDER 1000,2021-11-08,11,14,WY,US,25,2314
OUTLANDER 850,2021-11-08,3,9,WY,US,12,2296
OUTLANDER 450,2021-11-08,1,4,WY,US,5,2202
OUTLANDER 1000,2021-11-15,4,10,WY,US,14,2328
OUTLANDER 850,2021-11-15,7,7,WY,US,14,2310
OUTLANDER 450,2021-11-15,13,7,WY,US,20,2222
OUTLANDER 1000,2021-11-22,10,3,WY,US,13,2341
OUTLANDER 850,2021-11-22,13,7,WY,US,20,2330
OUTLANDER 450,2021-11-22,11,12,WY,US,23,2245
OUTLANDER 1000,2021-11-29,5,14,WY,US,19,2360
OUTLANDER 850,2021-11-29,11,0,WY,US,11,2341
OUTLANDER 450,2021-11-29,9,5,WY,US,14,2259
OUTLANDER 1000,2021-12-06,4,4,WY,US,8,2368
OUTLANDER 850,2021-12-06,9,13,WY,US,22,2363
OUTLANDER 450,2021-12-06,12,10,WY,US,22,2281
OUTLANDER 1000,2021-12-13,9,11,WY,US,20,2388
OUTLANDER 850,2021-12-13,13,10,WY,US,23,2386
OUTLANDER 450,2021-12-13,4,4,WY,US,8,2289
OUTLANDER 1000,2021-12-20,0,13,WY,US,13,2401
OUTLANDER 850,2021-12-20,13,6,WY,US,19,2405
OUTLANDER 450,2021-12-20,3,13,WY,US,16,2305
OUTLANDER 1000,2021-12-27,15,7,WY,US,22,2423
OUTLANDER 850,2021-12-27,4,13,WY,US,17,2422
OUTLANDER 450,2021-12-27,7,12,WY,US,19,2324
